"Mes","Año","Días funcionamiento","Clase","Región","Destino Turístico"," Total de Llegadas Chilenos"," Total de Pernoctaciones  Chilenos"," Total Llegadas Extranjeros"," Total Pernoctaciones Extranjeros","Total Llegadas","Total Pernoctación","Factor de Expansión"
"1","2017","31","Hotel","14","31","2114","3460","7503","10494","9617","13954","1"
"1","2017","31","Hotel","14","31","549","765","3315","7370","3864","8135","1"
"1","2017","31","Hotel","14","31","681","1661","2861","8368","3542","10029","1"
"1","2017","31","Hotel","11","32","0","0","0","0","0","0","1"
"1","2017","31","Hotel","14","27","2987","5242","612","1074","3599","6316","1"
"1","2017","31","Otros","11","32","50","107","10","25","60","132","2.2857142857143"
"1","2017","31","Hotel","14","31","358","475","2331","4585","2689","5060","5.4"
"1","2017","31","Hotel","15","16","1446","6223","281","1164","1727","7387","1"
"1","2017","31","Hotel","14","31","1119","1862","1167","3766","2286","5628","5.4"
"1","2017","31","Hotel","12","24","1592","2113","4503","7030","6095","9143","1"
"1","2017","31","Hotel","16","40","1152","2212","963","2315","2115","4527","1"
"1","2017","31","Hotel","6","12","1240","1788","139","359","1379","2147","1"
"1","2017","31","Hotel","10","23","1891","2347","937","1445","2828","3792","1"
"1","2017","31","Hotel","14","31","1746","3532","356","726","2102","4258","5.4"
"1","2017","31","Hotel","3","4","787","1838","299","1440","1086","3278","1"
"1","2017","31","","11","32","587","1032","182","283","769","1315","1"
"1","2017","31","Hotel","6","12","835","1537","133","431","968","1968","1"
"1","2017","31","Hotel","6","12","2494","3520","531","822","3025","4342","1"
"1","2017","31","Hotel","9","26","2734","5662","69","142","2803","5804","1"
"1","2017","31","Hotel","2","1","367","3254","73","712","440","3966","1"
"1","2017","31","Hotel","9","26","2077","5707","772","2345","2849","8052","1"
"1","2017","31","Hotel","6","12","531","952","70","162","601","1114","1"
"1","2017","31","Hotel","14","31","46","49","4687","8361","4733","8410","5.4"
"1","2017","31","Hotel","11","32","277","513","54","110","331","623","1"
"1","2017","31","Hotel","2","6","1315","2215","681","951","1996","3166","1"
"1","2017","31","Hotel","16","40","565","2581","1124","5126","1689","7707","1"
"1","2017","31","Hotel","14","27","994","2258","1303","3189","2297","5447","1"
"1","2017","31","Otros","11","36","256","724","16","80","272","804","1"
"1","2017","31","Hotel","10","23","1159","2328","1110","2545","2269","4873","1"
"1","2017","31","Hotel","14","31","181","543","719","3567","900","4110","7.8"
"1","2017","31","Hotel","7","17","301","881","1066","3191","1367","4072","1"
"1","2017","31","Hotel","2","1","2485","3079","314","390","2799","3469","2"
"1","2017","31","Hotel","2","1","2156","3191","498","1369","2654","4560","2"
"1","2017","31","Hotel","4","13","998","1660","353","538","1351","2198","1"
"1","2017","31","Hotel","2","1","1910","2084","285","372","2195","2456","2"
"1","2017","31","Hotel","10","27","1213","2253","637","1836","1850","4089","1"
"1","2017","31","Hotel","14","27","1089","1404","1576","1959","2665","3363","1"
"1","2017","31","Hotel","14","27","1661","2510","1366","2529","3027","5039","1"
"1","2017","31","Hotel","6","12","1308","2978","82","372","1390","3350","1"
"1","2017","31","Hotel","6","12","1260","2015","491","751","1751","2766","1"
"1","2017","31","Hotel","13","27","2488","6215","10","40","2498","6255","1"
"1","2017","31","Hotel","14","31","248","411","1834","4312","2082","4723","7.8"
"1","2017","31","Hotel","6","12","1290","2264","265","462","1555","2726","1"
"1","2017","31","Hotel","16","27","1252","3024","396","646","1648","3670","1"
"1","2017","31","","10","27","381","1425","172","270","553","1695","1"
"1","2017","31","Hotel","10","18","742","1866","1044","2451","1786","4317","1"
"1","2017","31","Hotel","9","37","1734","3040","469","783","2203","3823","1"
"1","2017","31","Hotel","16","27","1792","8964","0","0","1792","8964","1"
"1","2017","31","Hotel","15","16","867","2121","541","2238","1408","4359","2"
"1","2017","31","Hotel","2","1","1274","2238","261","458","1535","2696","2"
"1","2017","31","Hotel","3","4","699","1731","357","612","1056","2343","1"
"1","2017","31","Hotel","16","40","1188","1665","1900","3551","3088","5216","1"
"1","2017","31","Hotel","7","17","3108","3773","871","1131","3979","4904","1"
"1","2017","31","Hotel","12","24","752","1234","3247","4172","3999","5406","1"
"1","2017","31","Hotel","12","35","997","1907","1981","3962","2978","5869","1"
"1","2017","31","Hotel","2","6","429","605","459","467","888","1072","1"
"1","2017","31","Hotel","13","33","1325","1934","531","927","1856","2861","1"
"1","2017","31","Hotel","10","27","1780","2608","1273","1764","3053","4372","1"
"1","2017","31","Hotel","10","23","1182","1700","302","432","1484","2132","1"
"1","2017","31","Hotel","11","36","1504","2825","565","1274","2069","4099","1"
"1","2017","31","Hotel","8","34","1399","2600","88","554","1487","3154","1"
"1","2017","31","Hotel","2","6","501","1043","147","244","648","1287","1"
"1","2017","31","Hotel","14","31","676","1074","1370","2089","2046","3163","7.8"
"1","2017","31","Hotel","11","36","2311","3692","456","740","2767","4432","1"
"1","2017","31","","10","27","0","0","148","303","148","303","1"
"1","2017","31","Hotel","14","31","926","1042","3311","7909","4237","8951","5.4"
"1","2017","31","Hotel","4","13","2378","2392","4","8","2382","2400","1"
"1","2017","31","Hotel","6","28","1543","1757","84","112","1627","1869","1"
"1","2017","31","Otros","14","31","46","94","418","637","464","731","2.8"
"1","2017","31","Otros","16","27","60","60","0","0","60","60","2"
"1","2017","31","Hotel","2","1","838","1534","109","262","947","1796","2"
"1","2017","31","Hotel","10","18","2077","2446","1623","2351","3700","4797","1"
"1","2017","31","Hotel","7","17","909","2454","471","1512","1380","3966","1"
"1","2017","31","Hotel","12","24","560","1570","854","2397","1414","3967","1"
"1","2017","31","Hotel","10","18","1370","2808","1032","1976","2402","4784","1"
"1","2017","31","Hotel","2","1","1608","1734","9","15","1617","1749","1"
"1","2017","31","Hotel","10","18","804","1023","791","1556","1595","2579","1"
"1","2017","31","Hotel","6","28","1969","3136","295","535","2264","3671","1"
"1","2017","31","Hotel","5","5","361","1449","213","1480","574","2929","1"
"1","2017","31","Hotel","4","13","805","964","166","265","971","1229","1"
"1","2017","31","Hotel","10","18","1464","1647","2004","3059","3468","4706","1"
"1","2017","31","Hotel","16","40","1213","2279","1043","2013","2256","4292","1"
"1","2017","31","Hotel","8","3","2887","6998","838","1818","3725","8816","1"
"1","2017","31","Hotel","15","16","1349","2606","836","1865","2185","4471","2"
"1","2017","31","Hotel","14","31","146","308","256","1015","402","1323","7.8"
"1","2017","31","Hotel","13","33","72","79","968","1454","1040","1533","1"
"1","2017","31","Hotel","15","16","683","1422","485","2373","1168","3795","2"
"1","2017","31","Otros","4","21","618","866","64","178","682","1044","1"
"1","2017","31","Hotel","6","10","992","1755","19","43","1011","1798","1"
"1","2017","31","Hotel","16","19","741","1354","176","691","917","2045","1"
"1","2017","31","Hotel","16","27","971","2729","30","69","1001","2798","1"
"1","2017","31","Hotel","10","11","2411","3197","372","548","2783","3745","1"
"1","2017","31","Otros","10","23","417","1262","1","4","418","1266","1"
"1","2017","31","Hotel","12","35","136","312","354","847","490","1159","1"
"1","2017","31","Hotel","11","36","779","1543","517","1031","1296","2574","1"
"1","2017","31","Hotel","14","31","89","186","490","1579","579","1765","17.4"
"1","2017","31","Hotel","10","18","615","1664","948","2366","1563","4030","3.2"
"1","2017","31","Hotel","4","13","565","813","279","397","844","1210","1"
"1","2017","31","Hotel","6","12","323","677","159","421","482","1098","5"
"1","2017","31","Hotel","6","10","624","875","125","202","749","1077","1"
"1","2017","31","Otros","5","5","288","558","205","325","493","883","3.65625"
"1","2017","31","Hotel","12","24","1028","1122","1509","2288","2537","3410","1"
"1","2017","31","Hotel","8","3","1246","2639","538","1087","1784","3726","1"
"1","2017","31","Hotel","13","27","709","1620","0","0","709","1620","2.75"
"1","2017","31","Hotel","15","16","722","1510","375","1030","1097","2540","4"
"1","2017","31","Otros","15","16","267","1003","165","666","432","1669","2"
"1","2017","31","Otros","16","20","422","1169","690","2329","1112","3498","1"
"1","2017","31","Hotel","3","4","1495","1495","34","154","1529","1649","1"
"1","2017","30","Hotel","11","36","171","201","0","0","171","201","1"
"1","2017","31","Hotel","2","6","308","602","302","456","610","1058","1"
"1","2017","31","Hotel","8","34","897","1572","183","323","1080","1895","1"
"1","2017","31","Hotel","4","13","171","266","30","55","201","321","3.2"
"1","2017","31","Hotel","13","27","652","1494","0","0","652","1494","2.75"
"1","2017","31","Hotel","2","29","355","641","1030","2071","1385","2712","1"
"1","2017","31","Otros","11","36","83","315","0","0","83","315","1"
"1","2017","31","Otros","7","17","192","454","5","5","197","459","1"
"1","2017","31","","10","11","52","52","9","9","61","61","1"
"1","2017","31","Hotel","4","13","682","1006","98","183","780","1189","1"
"1","2017","31","Hotel","16","40","2053","3087","1228","1858","3281","4945","5.6666666666667"
"1","2017","31","Hotel","10","23","788","1423","1013","1804","1801","3227","2.8"
"1","2017","31","Hotel","8","34","449","687","843","1475","1292","2162","1"
"1","2017","31","Hotel","5","5","459","1187","220","850","679","2037","1"
"1","2017","31","Hotel","3","4","111","237","142","283","253","520","3"
"1","2017","31","Hotel","9","26","77","280","13","23","90","303","1"
"1","2017","31","Hotel","8","34","351","516","501","797","852","1313","1"
"1","2017","31","Hotel","7","17","329","597","342","1384","671","1981","4"
"1","2017","31","Hotel","4","13","229","622","111","307","340","929","3.2"
"1","2017","31","Hotel","12","35","19","76","712","2558","731","2634","1"
"1","2017","31","Hotel","16","40","808","1615","4646","9293","5454","10908","1"
"1","2017","31","Hotel","9","26","192","334","193","823","385","1157","1"
"1","2017","31","","6","27","219","381","35","106","254","487","1"
"1","2017","31","Hotel","9","26","222","300","12","15","234","315","1"
"1","2017","31","Hotel","4","13","144","212","127","179","271","391","3.2"
"1","2017","31","Hotel","6","28","1832","2068","173","321","2005","2389","1"
"1","2017","31","","2","29","78","249","747","2274","825","2523","1"
"1","2017","31","Hotel","16","19","343","510","0","0","343","510","1"
"1","2017","31","Hotel","13","33","1323","1743","274","426","1597","2169","1"
"1","2017","31","Hotel","8","3","511","1147","526","1234","1037","2381","1"
"1","2017","31","Hotel","14","27","363","544","1168","1242","1531","1786","1"
"1","2017","31","Hotel","16","40","686","1004","144","342","830","1346","5.6666666666667"
"1","2017","31","Hotel","12","24","210","320","451","831","661","1151","1"
"1","2017","31","Hotel","10","18","1512","2274","386","668","1898","2942","3.2"
"1","2017","31","Otros","15","16","200","215","53","53","253","268","9"
"1","2017","31","Hotel","6","10","825","927","10","24","835","951","1"
"1","2017","31","Hotel","10","11","603","1095","277","615","880","1710","1"
"1","2017","31","Otros","6","10","9","17","1","2","10","19","3.8518518518518"
"1","2017","31","Otros","10","23","100","662","0","0","100","662","1"
"1","2017","31","Otros","8","2","42","52","0","0","42","52","1"
"1","2017","31","Otros","10","11","46","72","91","133","137","205","1"
"1","2017","31","Hotel","10","23","306","501","720","1405","1026","1906","2.8"
"1","2017","31","Hotel","6","12","261","556","24","74","285","630","5"
"1","2017","31","Hotel","6","27","358","559","9","15","367","574","3"
"1","2017","31","Hotel","10","23","312","675","581","1431","893","2106","2.8"
"1","2017","31","","4","39","161","420","0","0","161","420","1"
"1","2017","31","Hotel","8","34","219","331","989","1631","1208","1962","1"
"1","2017","31","Hotel","8","34","535","800","821","1229","1356","2029","1"
"1","2017","31","Otros","4","39","17","20","0","0","17","20","2.2222222222222"
"1","2017","31","Otros","13","15","118","236","0","0","118","236","1"
"1","2017","31","Hotel","10","23","520","738","355","492","875","1230","2.8"
"1","2017","31","Otros","13","14","85","230","25","25","110","255","1"
"1","2017","31","Hotel","12","24","464","660","656","1117","1120","1777","1"
"1","2017","31","","6","25","548","584","0","0","548","584","1"
"1","2017","31","Hotel","15","27","620","1010","62","64","682","1074","1"
"1","2017","31","Hotel","12","35","163","214","1373","1734","1536","1948","1"
"1","2017","31","Hotel","16","40","0","0","1921","8115","1921","8115","1"
"1","2017","31","Hotel","16","27","97","97","105","130","202","227","1"
"1","2017","31","Hotel","9","30","215","366","0","0","215","366","1"
"1","2017","31","Hotel","4","13","242","455","252","385","494","840","3.2"
"1","2017","31","Hotel","2","29","34","114","326","1206","360","1320","1"
"1","2017","31","Hotel","16","20","1122","1219","677","734","1799","1953","1"
"1","2017","31","Hotel","5","5","516","1305","101","481","617","1786","1"
"1","2017","31","Hotel","13","33","910","1439","105","198","1015","1637","1"
"1","2017","31","Otros","16","19","358","584","0","0","358","584","1.3333333333333"
"1","2017","31","Hotel","12","24","99","453","430","875","529","1328","1"
"1","2017","31","","8","2","339","714","72","144","411","858","1"
"1","2017","31","Hotel","12","35","8","81","267","2051","275","2132","1"
"1","2017","31","Hotel","16","27","51","69","1299","1395","1350","1464","2.5"
"1","2017","31","Otros","9","37","80","160","0","0","80","160","2"
"1","2017","31","Otros","16","27","342","793","39","126","381","919","2"
"1","2017","31","Hotel","8","34","537","717","708","1286","1245","2003","1"
"1","2017","31","Otros","8","3","995","4726","73","304","1068","5030","1"
"1","2017","31","Hotel","7","27","295","438","16","36","311","474","1"
"1","2017","31","Hotel","4","39","354","513","15","19","369","532","1"
"1","2017","31","Hotel","15","16","386","659","447","977","833","1636","4"
"1","2017","31","Hotel","4","39","7","19","0","0","7","19","1"
"1","2017","31","Hotel","4","39","255","485","33","35","288","520","1"
"1","2017","29","Hotel","15","16","164","453","278","1344","442","1797","4"
"1","2017","31","Hotel","14","31","184","387","212","384","396","771","17.4"
"1","2017","31","Hotel","8","34","278","358","850","1219","1128","1577","1"
"1","2017","31","Hotel","6","28","313","429","263","321","576","750","1"
"1","2017","31","Hotel","7","17","510","695","535","842","1045","1537","4"
"1","2017","31","Otros","7","27","151","453","0","0","151","453","1"
"1","2017","31","Hotel","11","36","1366","1840","148","576","1514","2416","1"
"1","2017","31","Otros","7","17","564","1230","104","190","668","1420","1"
"1","2017","31","Otros","4","21","3","3","162","444","165","447","1"
"1","2017","31","Otros","15","16","219","312","104","265","323","577","2"
"1","2017","31","Otros","7","17","341","1095","349","2176","690","3271","3"
"1","2017","31","Hotel","7","38","227","314","26","37","253","351","1"
"1","2017","31","Hotel","16","27","145","431","23","107","168","538","2.5"
"1","2017","31","Hotel","2","6","71","340","69","71","140","411","2.2"
"1","2017","31","Hotel","11","36","451","816","290","558","741","1374","1"
"1","2017","31","Otros","13","14","5","8","5","20","10","28","1"
"1","2017","31","Hotel","6","28","143","171","48","52","191","223","1"
"1","2017","31","Hotel","6","12","62","105","0","0","62","105","5"
"1","2017","31","Otros","9","22","242","593","0","0","242","593","1"
"1","2017","31","","13","14","232","522","24","132","256","654","2"
"1","2017","31","Hotel","2","29","79","213","633","1379","712","1592","1"
"1","2017","31","Hotel","2","29","40","176","150","569","190","745","1"
"1","2017","31","Otros","4","13","377","397","38","38","415","435","1"
"1","2017","31","Hotel","15","16","187","309","39","81","226","390","4"
"1","2017","31","Hotel","2","1","143","346","8","10","151","356","6.4"
"1","2017","31","Otros","7","27","220","414","0","0","220","414","1"
"1","2017","31","Otros","13","33","159","175","2","2","161","177","5.125"
"1","2017","31","","4","21","933","1432","266","304","1199","1736","1"
"1","2017","31","Hotel","6","10","356","356","9","9","365","365","1"
"1","2017","31","Hotel","11","36","214","345","0","0","214","345","1"
"1","2017","31","Otros","14","31","95","400","200","620","295","1020","2.8"
"1","2017","31","Hotel","7","27","200","296","29","185","229","481","1"
"1","2017","31","Otros","6","10","0","0","20","400","20","400","3.8518518518518"
"1","2017","31","Hotel","4","39","56","83","36","43","92","126","2.6"
"1","2017","31","Otros","8","2","44","80","101","176","145","256","6.4285714285714"
"1","2017","31","Otros","11","36","104","216","25","36","129","252","5.1904761904762"
"1","2017","31","Hotel","13","33","71","122","0","0","71","122","1"
"1","2017","31","Hotel","10","18","62","62","78","78","140","140","1"
"1","2017","31","Otros","9","37","122","234","0","0","122","234","2"
"1","2017","31","","3","4","99","187","84","158","183","345","1"
"1","2017","31","Hotel","7","17","256","650","95","172","351","822","4"
"1","2017","31","Hotel","8","2","244","437","53","82","297","519","1"
"1","2017","31","Otros","9","37","44","59","0","0","44","59","2"
"1","2017","29","Otros","15","16","202","312","107","229","309","541","2"
"1","2017","29","Hotel","10","11","556","797","22","34","578","831","1"
"1","2017","31","Hotel","16","19","315","417","0","0","315","417","1"
"1","2017","31","Hotel","10","23","173","240","423","574","596","814","4"
"1","2017","31","","7","38","285","574","151","245","436","819","1"
"1","2017","31","Hotel","7","27","155","398","8","22","163","420","1"
"1","2017","31","Hotel","11","36","509","1220","210","434","719","1654","1"
"1","2017","31","Hotel","16","40","243","370","32","72","275","442","16.333333333333"
"1","2017","31","Hotel","16","19","70","168","0","0","70","168","1"
"1","2017","31","Hotel","12","35","176","366","380","739","556","1105","1"
"1","2017","31","Hotel","16","19","129","184","0","0","129","184","1"
"1","2017","31","Hotel","16","20","150","224","0","0","150","224","1"
"1","2017","31","Hotel","10","11","350","583","65","88","415","671","1"
"1","2017","31","Otros","7","27","150","298","12","40","162","338","4.8333333333333"
"1","2017","31","Otros","7","27","23","72","0","0","23","72","1"
"1","2017","31","Hotel","7","27","33","38","3","3","36","41","4.1666666666667"
"1","2017","31","Otros","16","19","283","398","0","0","283","398","1"
"1","2017","31","Otros","13","14","451","1096","16","24","467","1120","1"
"1","2017","31","Otros","11","15","68","168","0","0","68","168","2.3571428571429"
"1","2017","31","Otros","10","27","64","80","102","152","166","232","4.84"
"1","2017","31","Otros","14","31","153","153","2561","2561","2714","2714","2.8"
"1","2017","31","Otros","11","36","61","199","38","76","99","275","5.1904761904762"
"1","2017","31","Hotel","16","19","137","330","10","10","147","340","1"
"1","2017","31","","14","27","180","310","0","0","180","310","2.6666666666667"
"1","2017","31","Hotel","16","40","112","122","58","64","170","186","5.6666666666667"
"1","2017","31","Hotel","10","27","14","35","0","0","14","35","2.25"
"1","2017","31","Otros","2","29","115","137","428","607","543","744","3.28"
"1","2017","31","Hotel","13","27","0","0","105","136","105","136","1"
"1","2017","31","Otros","9","22","144","172","2","8","146","180","1"
"1","2017","31","Hotel","2","27","165","245","33","53","198","298","1"
"1","2017","31","Hotel","8","34","274","384","651","1021","925","1405","1"
"1","2017","31","Hotel","7","27","229","419","2","2","231","421","1"
"1","2017","31","Hotel","15","16","223","416","258","891","481","1307","4"
"1","2017","31","Hotel","16","20","217","401","5","13","222","414","1"
"1","2017","31","Otros","4","13","111","287","2","2","113","289","1"
"1","2017","31","Otros","5","9","306","483","205","337","511","820","1"
"1","2017","31","Hotel","2","1","155","424","12","31","167","455","6.4"
"1","2017","31","Otros","11","32","59","470","0","0","59","470","2.2857142857143"
"1","2017","31","Hotel","2","29","10","61","171","1667","181","1728","1"
"1","2017","31","Hotel","16","27","158","183","102","112","260","295","2.5"
"1","2017","31","Hotel","10","18","238","751","3","3","241","754","3.2"
"1","2017","31","Otros","11","36","544","641","48","66","592","707","1"
"1","2017","31","Otros","13","14","91","160","15","24","106","184","1"
"1","2017","31","Hotel","7","27","140","185","0","0","140","185","1"
"1","2017","31","Otros","7","17","158","158","11","11","169","169","3"
"1","2017","31","Otros","14","31","117","234","470","969","587","1203","2.8"
"1","2017","31","Hotel","12","35","87","136","339","684","426","820","1"
"1","2017","31","Hotel","2","29","51","142","488","1515","539","1657","1"
"1","2017","31","Hotel","8","3","251","717","350","824","601","1541","1"
"1","2017","31","Hotel","8","34","349","490","338","601","687","1091","2.5714285714286"
"1","2017","31","Hotel","8","34","199","268","318","519","517","787","2.5714285714286"
"1","2017","31","Hotel","12","35","105","274","476","786","581","1060","1"
"1","2017","31","Hotel","12","35","94","103","228","320","322","423","1"
"1","2017","31","Hotel","11","32","208","515","61","110","269","625","1"
"1","2017","31","Hotel","13","33","230","290","203","452","433","742","2"
"1","2017","31","Hotel","10","23","184","298","153","307","337","605","2.8"
"1","2017","31","Hotel","12","35","256","727","100","120","356","847","1"
"1","2017","31","","16","40","240","390","347","895","587","1285","3.0555555555556"
"1","2017","31","Otros","16","19","180","318","0","0","180","318","1.3333333333333"
"1","2017","31","Otros","16","20","102","306","72","432","174","738","1"
"1","2017","31","Hotel","6","12","145","311","11","22","156","333","5"
"1","2017","31","Hotel","16","19","326","499","0","0","326","499","4"
"1","2017","31","Hotel","12","24","125","390","297","661","422","1051","1"
"1","2017","31","Hotel","12","24","134","271","422","530","556","801","3"
"1","2017","0","Hotel","8","3","0","0","0","0","0","0","1"
"1","2017","31","Hotel","5","9","10","10","4","8","14","18","1"
"1","2017","31","Hotel","16","27","196","336","24","82","220","418","2.5"
"1","2017","31","Otros","10","23","51","51","0","0","51","51","7"
"1","2017","31","Otros","13","14","340","653","26","53","366","706","7.3846153846154"
"1","2017","31","Otros","2","6","112","566","27","61","139","627","1"
"1","2017","26","Hotel","15","16","17","19","293","334","310","353","7.8"
"1","2017","31","Hotel","8","3","750","1500","12","24","762","1524","1"
"1","2017","31","Hotel","8","34","253","492","392","803","645","1295","1"
"1","2017","31","Hotel","8","3","188","501","173","453","361","954","1"
"1","2017","31","","2","29","74","210","40","99","114","309","1"
"1","2017","31","Hotel","2","1","208","408","31","74","239","482","6.4"
"1","2017","31","Hotel","7","17","201","349","132","166","333","515","4"
"1","2017","31","Otros","7","17","187","1028","367","2422","554","3450","3"
"1","2017","31","Hotel","16","40","258","510","412","1018","670","1528","5.6666666666667"
"1","2017","31","Hotel","12","24","145","220","718","1030","863","1250","1"
"1","2017","31","Hotel","14","31","232","510","347","866","579","1376","17.4"
"1","2017","0","Hotel","9","26","0","0","0","0","0","0","1"
"1","2017","31","Hotel","6","12","44","76","0","0","44","76","5"
"1","2017","31","Otros","5","9","13","25","26","28","39","53","4.0454545454545"
"1","2017","31","Otros","5","9","26","26","6","6","32","32","4.0454545454545"
"1","2017","31","Otros","15","27","224","334","4","4","228","338","1.4222222222222"
"1","2017","31","Hotel","8","34","1","1","3","3","4","4","2.5714285714286"
"1","2017","31","Hotel","10","18","255","825","217","560","472","1385","7.75"
"1","2017","31","Hotel","15","16","475","714","167","605","642","1319","7.8"
"1","2017","31","Hotel","2","29","63","194","382","1247","445","1441","1"
"1","2017","31","Hotel","4","39","205","422","5","5","210","427","2.6"
"1","2017","31","Otros","4","39","101","106","5","8","106","114","2.2222222222222"
"1","2017","31","Hotel","4","13","675","832","294","975","969","1807","5.4"
"1","2017","31","Otros","10","23","41","82","9","18","50","100","7"
"1","2017","31","Otros","14","31","58","99","506","1094","564","1193","20.2"
"1","2017","31","Hotel","3","4","250","611","129","273","379","884","2.6"
"1","2017","31","Hotel","10","23","75","150","10","20","85","170","4"
"1","2017","31","Otros","9","22","498","1426","0","0","498","1426","1"
"1","2017","31","Hotel","12","24","54","117","443","687","497","804","3"
"1","2017","31","Hotel","13","14","38","43","4","6","42","49","1"
"1","2017","31","Hotel","12","35","212","384","287","420","499","804","1.7272727272727"
"1","2017","31","Hotel","6","28","465","669","0","0","465","669","1"
"1","2017","31","","6","28","68","381","0","0","68","381","1"
"1","2017","31","Hotel","12","24","315","796","254","717","569","1513","3"
"1","2017","31","Otros","5","9","13","24","14","16","27","40","4.0454545454545"
"1","2017","31","Hotel","16","20","70","80","1","1","71","81","1"
"1","2017","31","Hotel","4","21","343","734","80","194","423","928","3"
"1","2017","31","Otros","10","11","54","76","13","16","67","92","11.764705882353"
"1","2017","31","Otros","13","14","57","116","0","0","57","116","7.3846153846154"
"1","2017","31","Otros","6","27","380","1104","0","0","380","1104","1"
"1","2017","31","Otros","16","27","167","412","8","24","175","436","13.818181818182"
"1","2017","31","Hotel","9","26","580","580","0","0","580","580","1"
"1","2017","31","Hotel","16","27","901","1497","874","1124","1775","2621","2.5"
"1","2017","31","Hotel","3","4","909","1525","430","740","1339","2265","3"
"1","2017","31","Otros","16","27","220","370","3","3","223","373","2"
"1","2017","31","Otros","16","19","1046","5160","22","42","1068","5202","1.3333333333333"
"1","2017","31","Hotel","6","12","856","1100","56","56","912","1156","5"
"1","2017","31","Hotel","2","1","320","483","74","112","394","595","6.4"
"1","2017","31","Hotel","10","11","623","1176","136","309","759","1485","1"
"1","2017","31","Otros","10","23","128","273","11","20","139","293","1"
"1","2017","31","Otros","10","27","652","943","548","795","1200","1738","4.84"
"1","2017","31","Hotel","16","27","195","323","76","264","271","587","2.5"
"1","2017","31","Hotel","6","28","204","315","118","128","322","443","1"
"1","2017","31","Hotel","4","13","47","95","4","20","51","115","5.4"
"1","2017","31","Hotel","14","27","566","770","5","5","571","775","8.5"
"1","2017","31","Hotel","10","27","194","281","861","1143","1055","1424","1"
"1","2017","31","Hotel","13","27","153","230","72","99","225","329","4.2"
"1","2017","31","Hotel","3","4","641","924","71","139","712","1063","3"
"1","2017","31","Otros","4","13","244","251","27","27","271","278","3.4"
"1","2017","31","Otros","11","15","38","65","2","2","40","67","2.3571428571429"
"1","2017","31","Otros","6","10","132","792","0","0","132","792","3.8518518518518"
"1","2017","31","Otros","2","1","114","142","59","75","173","217","1"
"1","2017","31","","6","12","92","262","0","0","92","262","1"
"1","2017","31","Otros","10","23","317","803","43","125","360","928","1"
"1","2017","31","Hotel","16","19","206","329","0","0","206","329","4"
"1","2017","31","Hotel","10","11","29","123","25","81","54","204","5.6666666666667"
"1","2017","31","Hotel","10","23","146","176","26","26","172","202","4"
"1","2017","31","Otros","14","31","54","167","319","862","373","1029","2.8"
"1","2017","31","Otros","13","27","7","7","0","0","7","7","12.2"
"1","2017","31","Hotel","2","1","315","431","0","0","315","431","6.4"
"1","2017","31","Hotel","16","19","86","146","0","0","86","146","4"
"1","2017","31","Otros","12","35","97","152","64","98","161","250","3.5"
"1","2017","31","Otros","15","16","190","600","242","639","432","1239","2"
"1","2017","31","Otros","9","22","461","922","141","282","602","1204","1"
"1","2017","31","Hotel","10","27","263","381","780","1041","1043","1422","1"
"1","2017","31","Hotel","2","27","162","329","26","46","188","375","3.6"
"1","2017","31","Hotel","16","20","64","222","37","242","101","464","1"
"1","2017","31","Hotel","10","18","5","25","2","2","7","27","7.75"
"1","2017","31","Hotel","6","12","303","326","0","0","303","326","5"
"1","2017","31","Hotel","2","27","75","258","0","0","75","258","3.6"
"1","2017","31","Hotel","15","16","250","469","119","369","369","838","7.8"
"1","2017","31","Hotel","10","23","73","73","24","24","97","97","4"
"1","2017","31","Hotel","11","32","122","253","21","24","143","277","1"
"1","2017","31","Hotel","14","27","122","380","49","172","171","552","8.5"
"1","2017","31","Otros","16","19","59","96","0","0","59","96","4"
"1","2017","31","Otros","10","11","32","35","3","7","35","42","11.764705882353"
"1","2017","31","Otros","13","14","61","181","10","15","71","196","1"
"1","2017","31","Hotel","2","27","98","250","22","30","120","280","3.6"
"1","2017","31","Otros","13","14","198","987","16","86","214","1073","7.3846153846154"
"1","2017","31","Hotel","2","1","154","198","18","24","172","222","6.4"
"1","2017","31","Otros","7","17","113","581","296","1953","409","2534","17.166666666667"
"1","2017","31","Otros","10","23","58","312","15","60","73","372","7"
"1","2017","31","Hotel","13","27","272","272","58","58","330","330","2.75"
"1","2017","31","Otros","10","18","81","526","0","0","81","526","10.25"
"1","2017","31","Otros","5","9","20","620","0","0","20","620","4.0454545454545"
"1","2017","31","Hotel","4","39","101","134","16","18","117","152","2.6"
"1","2017","31","Otros","16","27","48","121","3","6","51","127","13.818181818182"
"1","2017","31","Hotel","14","27","29","59","75","270","104","329","8.5"
"1","2017","31","Hotel","10","11","184","320","88","142","272","462","5.6666666666667"
"1","2017","31","Hotel","10","18","136","433","0","0","136","433","7.75"
"1","2017","31","Otros","14","31","85","170","249","343","334","513","20.2"
"1","2017","31","Otros","11","32","88","248","4","4","92","252","2.2857142857143"
"1","2017","31","Otros","5","5","28","64","9","90","37","154","3.65625"
"1","2017","31","Otros","6","25","130","312","0","0","130","312","2.3846153846154"
"1","2017","31","Hotel","3","4","80","183","19","54","99","237","2.6"
"1","2017","31","Otros","7","27","383","969","41","165","424","1134","4.8333333333333"
"1","2017","31","Otros","2","29","119","171","230","319","349","490","3.28"
"1","2017","31","Hotel","2","29","49","61","236","695","285","756","1"
"1","2017","31","Otros","4","21","136","342","12","20","148","362","1"
"1","2017","13","Hotel","7","27","3","9","0","0","3","9","4.1666666666667"
"1","2017","31","Otros","5","5","15","27","26","59","41","86","3.65625"
"1","2017","31","Otros","11","36","189","503","276","632","465","1135","5.1904761904762"
"1","2017","31","Otros","6","27","62","158","2","2","64","160","1"
"1","2017","31","Hotel","7","27","378","378","0","0","378","378","4.1666666666667"
"1","2017","31","Hotel","16","20","241","356","45","57","286","413","1"
"1","2017","31","Hotel","12","24","156","293","670","974","826","1267","3"
"1","2017","31","Hotel","9","26","83","123","43","47","126","170","1.5"
"1","2017","31","Hotel","7","17","291","764","242","1059","533","1823","10"
"1","2017","31","Hotel","9","37","183","279","21","91","204","370","3.4"
"1","2017","31","Hotel","5","5","352","495","288","350","640","845","2.1428571428571"
"1","2017","31","Otros","6","27","92","259","25","50","117","309","3.960088691796"
"1","2017","31","Hotel","9","37","69","105","21","50","90","155","3.4"
"1","2017","31","Otros","10","27","59","89","0","0","59","89","4.84"
"1","2017","31","Otros","8","3","249","599","18","31","267","630","10"
"1","2017","31","Otros","16","20","88","119","0","0","88","119","3.0769230769231"
"1","2017","31","Otros","9","22","132","301","0","0","132","301","7.6428571428571"
"1","2017","31","Otros","10","27","262","415","146","159","408","574","4.84"
"1","2017","31","Otros","10","23","147","209","13","41","160","250","7"
"1","2017","31","Otros","2","6","222","232","87","97","309","329","1"
"1","2017","31","Otros","5","5","95","154","50","131","145","285","4"
"1","2017","31","Otros","4","39","12","23","2","5","14","28","2.2222222222222"
"1","2017","31","Hotel","2","27","146","270","145","152","291","422","1"
"1","2017","31","Hotel","14","31","33","54","142","489","175","543","24"
"1","2017","31","Otros","12","35","8","13","94","159","102","172","2.6666666666667"
"1","2017","31","Otros","2","29","120","192","128","240","248","432","3.28"
"1","2017","31","Otros","8","3","790","2370","200","600","990","2970","10"
"1","2017","31","Hotel","7","27","58","170","0","0","58","170","1"
"1","2017","31","","13","14","28","50","0","0","28","50","1"
"1","2017","31","Hotel","6","10","288","319","91","97","379","416","6.6"
"1","2017","31","Hotel","8","34","174","247","184","316","358","563","2.5714285714286"
"1","2017","31","Hotel","9","22","58","86","0","0","58","86","2.5555555555556"
"1","2017","31","Hotel","2","6","95","331","276","804","371","1135","2.2"
"1","2017","31","Hotel","10","27","142","277","387","481","529","758","2.25"
"1","2017","31","Otros","14","27","318","458","0","0","318","458","11.833333333333"
"1","2017","31","Otros","6","12","119","233","0","0","119","233","1.8256578947368"
"1","2017","31","Hotel","6","27","184","187","0","0","184","187","3"
"1","2017","31","Hotel","5","5","51","113","44","119","95","232","2.1428571428571"
"1","2017","31","Hotel","5","5","102","207","57","105","159","312","2.1428571428571"
"1","2017","31","Hotel","13","27","225","225","0","0","225","225","4.2"
"1","2017","31","Hotel","2","27","151","285","0","0","151","285","3.6"
"1","2017","31","Hotel","8","3","65","65","75","75","140","140","4.1111111111111"
"1","2017","31","Otros","11","36","85","246","7","30","92","276","5.1904761904762"
"1","2017","31","Otros","9","30","542","1027","0","0","542","1027","2.3333333333333"
"1","2017","31","Otros","16","19","88","155","0","0","88","155","10.263157894737"
"1","2017","31","Hotel","14","31","41","83","343","1026","384","1109","17.4"
"1","2017","31","Hotel","2","1","335","386","7","10","342","396","6.4"
"1","2017","31","Hotel","16","40","588","1089","1243","2297","1831","3386","5.6666666666667"
"1","2017","31","Otros","7","17","145","374","169","1127","314","1501","17.166666666667"
"1","2017","31","Hotel","13","27","500","663","214","480","714","1143","2.75"
"1","2017","31","Hotel","14","31","128","145","196","334","324","479","24"
"1","2017","31","Otros","3","4","87","349","21","33","108","382","12.2"
"1","2017","31","Otros","8","34","208","318","426","627","634","945","5.75"
"1","2017","31","Hotel","9","22","215","333","20","55","235","388","2.5555555555556"
"1","2017","31","Hotel","4","21","235","301","61","86","296","387","3"
"1","2017","31","Hotel","6","27","171","245","0","0","171","245","3"
"1","2017","31","Hotel","12","35","118","224","182","258","300","482","1.7272727272727"
"1","2017","31","Hotel","2","29","24","71","140","277","164","348","2"
"1","2017","31","Otros","10","11","52","75","11","17","63","92","11.764705882353"
"1","2017","31","Hotel","6","10","187","198","15","15","202","213","6.6"
"1","2017","23","Hotel","13","14","39","103","10","50","49","153","2"
"1","2017","28","Otros","16","27","299","475","0","0","299","475","13.818181818182"
"1","2017","31","Otros","6","27","52","80","0","0","52","80","3.960088691796"
"1","2017","31","Hotel","16","40","87","175","733","1500","820","1675","5.6666666666667"
"1","2017","31","Otros","6","10","258","584","13","27","271","611","3.8518518518518"
"1","2017","31","Otros","10","23","56","222","8","16","64","238","7"
"1","2017","31","Hotel","6","28","281","326","72","80","353","406","1"
"1","2017","31","Otros","7","38","488","665","342","582","830","1247","2.75"
"1","2017","31","Hotel","6","12","154","265","20","26","174","291","5"
"1","2017","31","Hotel","13","27","391","651","18","24","409","675","4.2"
"1","2017","31","Otros","4","21","78","170","4","4","82","174","4.8333333333333"
"1","2017","31","Otros","13","14","100","155","0","0","100","155","1"
"1","2017","31","Hotel","16","27","85","165","12","12","97","177","5.8571428571429"
"1","2017","29","Hotel","5","5","40","81","84","202","124","283","2.1428571428571"
"1","2017","31","Otros","12","24","54","61","94","125","148","186","9.2"
"1","2017","31","Otros","15","16","100","183","84","102","184","285","9"
"1","2017","31","Hotel","8","27","194","194","53","53","247","247","4.5"
"1","2017","31","Hotel","9","22","42","50","0","0","42","50","2.5555555555556"
"1","2017","31","Hotel","10","11","123","229","93","195","216","424","5.6666666666667"
"1","2017","31","Hotel","8","3","142","296","153","347","295","643","4.1111111111111"
"1","2017","31","Hotel","6","10","588","1219","5","100","593","1319","6.6"
"1","2017","31","Otros","9","26","18","71","0","0","18","71","3.8888888888889"
"1","2017","31","Hotel","4","39","38","90","22","131","60","221","2.6"
"1","2017","31","Otros","6","27","20","27","0","0","20","27","3.960088691796"
"1","2017","31","Otros","6","12","80","124","0","0","80","124","1.8256578947368"
"1","2017","31","Hotel","6","27","54","112","0","0","54","112","3"
"1","2017","31","Otros","5","9","114","122","42","42","156","164","4.0454545454545"
"1","2017","31","Otros","5","9","96","152","84","137","180","289","1"
"1","2017","31","Hotel","2","27","137","177","8","39","145","216","3.6"
"1","2017","31","Hotel","2","29","16","32","170","604","186","636","1"
"1","2017","31","Hotel","4","13","63","173","9","11","72","184","5.4"
"1","2017","31","","11","15","14","280","0","0","14","280","1"
"1","2017","31","Hotel","6","10","399","503","39","66","438","569","6.6"
"1","2017","31","Otros","6","12","43","149","6","6","49","155","1.8256578947368"
"1","2017","31","Otros","10","18","48","194","38","95","86","289","10.25"
"1","2017","31","Otros","9","22","354","945","10","28","364","973","7.6428571428571"
"1","2017","31","Otros","7","27","185","1189","4","4","189","1193","1"
"1","2017","31","","14","27","244","488","0","0","244","488","1"
"1","2017","31","Hotel","16","27","59","324","4","4","63","328","5.8571428571429"
"1","2017","31","Otros","2","29","33","87","71","113","104","200","3.28"
"1","2017","31","Hotel","8","27","60","72","8","13","68","85","1"
"1","2017","31","Otros","13","33","63","72","0","0","63","72","5.125"
"1","2017","31","Hotel","9","22","31","67","3","9","34","76","1"
"1","2017","31","Otros","10","23","46","125","2","8","48","133","1"
"1","2017","31","Otros","13","33","15","17","8","16","23","33","5.125"
"1","2017","29","Otros","6","10","79","156","0","0","79","156","3.8518518518518"
"1","2017","31","Hotel","10","18","113","292","197","383","310","675","7.75"
"1","2017","31","Hotel","14","31","147","197","92","246","239","443","24"
"1","2017","31","Hotel","4","21","56","68","8","15","64","83","3"
"1","2017","31","Hotel","3","4","13","66","70","315","83","381","2.6"
"1","2017","31","Otros","8","27","251","420","17","55","268","475","1"
"1","2017","31","Otros","6","27","17","62","0","0","17","62","3.960088691796"
"1","2017","31","Hotel","6","25","440","515","0","0","440","515","1"
"1","2017","31","Otros","6","12","250","438","30","64","280","502","1.8256578947368"
"1","2017","31","Hotel","6","27","41","285","0","0","41","285","3"
"1","2017","31","Otros","6","27","39","78","0","0","39","78","3.960088691796"
"1","2017","31","Otros","6","10","117","290","0","0","117","290","3.8518518518518"
"1","2017","31","Otros","6","12","127","253","0","0","127","253","1.8256578947368"
"1","2017","31","Otros","5","5","34","45","17","36","51","81","3.65625"
"1","2017","31","Hotel","12","24","95","235","117","349","212","584","3"
"1","2017","31","Hotel","12","35","80","147","132","193","212","340","2"
"1","2017","31","Hotel","15","16","62","179","32","83","94","262","7.8"
"1","2017","31","Otros","4","13","120","155","27","27","147","182","3.4"
"1","2017","31","Hotel","2","29","140","494","162","547","302","1041","1"
"1","2017","31","Hotel","4","21","54","73","50","88","104","161","3"
"1","2017","31","Hotel","10","27","152","199","804","1057","956","1256","2.25"
"1","2017","31","Hotel","8","3","193","426","133","261","326","687","4.1111111111111"
"1","2017","31","Hotel","12","27","105","276","51","54","156","330","1"
"1","2017","31","Otros","5","5","195","454","48","124","243","578","3.65625"
"1","2017","31","Otros","13","14","52","59","0","0","52","59","7.3846153846154"
"1","2017","31","Otros","10","11","321","580","174","254","495","834","11.764705882353"
"1","2017","31","Otros","16","40","237","546","110","341","347","887","28.142857142857"
"1","2017","31","Hotel","11","36","375","821","156","175","531","996","1"
"1","2017","31","Otros","12","35","37","89","205","471","242","560","2.6666666666667"
"1","2017","31","Otros","8","34","90","126","182","233","272","359","5.75"
"1","2017","31","Hotel","7","17","119","176","56","168","175","344","10"
"1","2017","31","Otros","12","35","171","345","27","47","198","392","3.5"
"1","2017","31","Otros","5","9","31","37","5","6","36","43","4.0454545454545"
"1","2017","31","Hotel","9","22","100","158","4","14","104","172","2.5555555555556"
"1","2017","31","Otros","2","29","65","134","49","97","114","231","3.28"
"1","2017","31","Otros","2","29","71","161","54","124","125","285","3.28"
"1","2017","31","Otros","10","23","88","145","92","129","180","274","1"
"1","2017","31","Hotel","10","27","84","137","312","433","396","570","2.25"
"1","2017","31","Hotel","16","19","141","280","9","19","150","299","4"
"1","2017","31","Hotel","16","40","396","422","254","372","650","794","16.333333333333"
"1","2017","31","Hotel","8","27","281","335","86","112","367","447","4.5"
"1","2017","31","Otros","13","14","23","30","0","0","23","30","7.3846153846154"
"1","2017","31","Hotel","7","27","60","110","0","0","60","110","4.1666666666667"
"1","2017","31","Otros","2","6","1","1","0","0","1","1","5"
"1","2017","31","Hotel","7","17","164","683","171","1159","335","1842","10"
"1","2017","31","Hotel","3","4","96","193","56","112","152","305","2.6"
"1","2017","31","Otros","6","12","23","356","0","0","23","356","1.8256578947368"
"1","2017","31","Otros","6","10","39","39","0","0","39","39","3.8518518518518"
"1","2017","31","Hotel","16","40","16","36","28","84","44","120","16.333333333333"
"1","2017","31","Otros","4","39","64","105","18","25","82","130","2.2222222222222"
"1","2017","31","Otros","13","14","67","124","0","0","67","124","7.3846153846154"
"1","2017","31","Otros","7","38","172","294","63","108","235","402","2.75"
"1","2017","31","Hotel","11","32","60","107","0","0","60","107","1"
"1","2017","30","Otros","11","36","255","514","15","29","270","543","5.1904761904762"
"1","2017","15","Hotel","4","21","68","112","17","23","85","135","3"
"1","2017","31","Otros","3","4","16","31","14","15","30","46","12.2"
"1","2017","31","Otros","5","9","46","111","56","114","102","225","4.0454545454545"
"1","2017","31","Otros","16","19","18","34","0","0","18","34","4"
"1","2017","31","Hotel","8","27","85","133","9","42","94","175","4.5"
"1","2017","31","Otros","16","40","46","81","46","146","92","227","1"
"1","2017","31","","7","17","104","260","114","931","218","1191","1"
"1","2017","31","Otros","16","20","65","192","0","0","65","192","3.0769230769231"
"1","2017","31","Otros","4","21","34","95","23","97","57","192","4.8333333333333"
"1","2017","31","Otros","13","33","50","65","41","49","91","114","5.125"
"1","2017","31","","12","35","0","0","540","2009","540","2009","1"
"1","2017","31","Hotel","13","33","2","2","0","0","2","2","2"
"1","2017","31","Otros","4","39","18","22","2","3","20","25","2.2222222222222"
"1","2017","31","Otros","10","18","133","309","37","115","170","424","10.25"
"1","2017","31","Otros","6","27","95","131","5","5","100","136","3.960088691796"
"1","2017","31","Otros","12","35","19","35","326","562","345","597","2.6666666666667"
"1","2017","31","Hotel","4","39","60","189","0","0","60","189","2.6"
"1","2017","31","Otros","14","31","88","259","58","207","146","466","20.2"
"1","2017","31","Hotel","2","29","39","106","313","698","352","804","2"
"1","2017","31","Hotel","13","14","17","17","0","0","17","17","1"
"1","2017","31","Hotel","9","26","210","262","0","0","210","262","1.5"
"1","2017","31","Otros","8","2","54","248","28","60","82","308","1"
"1","2017","31","Otros","12","35","5","8","29","32","34","40","3.5"
"1","2017","31","Hotel","14","27","103","145","60","82","163","227","8.5"
"1","2017","31","Otros","11","36","260","709","77","245","337","954","5.1904761904762"
"1","2017","31","Otros","16","20","155","750","98","614","253","1364","3.0769230769231"
"1","2017","31","Otros","4","39","2","8","0","0","2","8","2.2222222222222"
"1","2017","31","Otros","7","27","288","433","6","10","294","443","4.8333333333333"
"1","2017","31","Otros","6","27","114","153","4","10","118","163","3.960088691796"
"1","2017","31","Otros","5","8","15","465","0","0","15","465","5"
"1","2017","31","Otros","9","37","150","234","23","38","173","272","4.5"
"1","2017","31","Hotel","2","6","59","151","0","0","59","151","5.5"
"1","2017","31","Hotel","10","27","262","330","116","155","378","485","2.25"
"1","2017","31","Hotel","9","30","118","215","41","89","159","304","1"
"1","2017","31","Otros","4","13","62","118","2","2","64","120","3.4"
"1","2017","31","Hotel","5","5","284","284","82","82","366","366","1"
"1","2017","31","Otros","7","38","189","414","19","34","208","448","2.75"
"1","2017","31","Hotel","13","14","15","19","0","0","15","19","1"
"1","2017","31","Otros","5","9","18","36","5","12","23","48","4.0454545454545"
"1","2017","31","Otros","5","8","4","7","0","0","4","7","5"
"1","2017","31","Otros","10","27","62","495","0","0","62","495","4.84"
"1","2017","31","Hotel","13","14","66","121","14","23","80","144","1"
"1","2017","31","Otros","11","15","2","4","0","0","2","4","2.3571428571429"
"1","2017","31","Hotel","9","22","250","345","0","0","250","345","2.5555555555556"
"1","2017","31","Otros","11","36","92","173","24","41","116","214","5.1904761904762"
"1","2017","31","Hotel","10","18","1438","3481","2758","5921","4196","9402","1"
"1","2017","31","Hotel","6","12","146","274","9","27","155","301","5"
"1","2017","31","","2","29","233","692","671","1927","904","2619","1"
"1","2017","31","Hotel","16","27","1224","2450","26","71","1250","2521","1"
"1","2017","31","","14","31","266","472","639","2777","905","3249","1"
"1","2017","31","Hotel","8","3","114","236","106","202","220","438","4.1111111111111"
"1","2017","31","Otros","13","33","63","125","157","239","220","364","5.125"
"1","2017","31","","14","27","89","152","0","0","89","152","2.6666666666667"
"1","2017","31","Otros","9","22","40","68","0","0","40","68","7.6428571428571"
"1","2017","31","Hotel","10","11","64","116","22","56","86","172","5.6666666666667"
"1","2017","31","Otros","6","12","23","47","5","5","28","52","1.8256578947368"
"1","2017","31","Hotel","8","3","240","441","131","188","371","629","4.1111111111111"
"1","2017","31","Otros","9","22","127","888","0","0","127","888","3.25"
"1","2017","31","Hotel","7","17","176","425","35","203","211","628","1"
"1","2017","29","Otros","6","12","349","807","18","84","367","891","1.8256578947368"
"1","2017","31","Hotel","8","27","240","280","8","8","248","288","4.5"
"1","2017","31","Hotel","6","28","240","285","70","102","310","387","2.4"
"1","2017","31","Otros","8","2","249","724","82","183","331","907","1"
"1","2017","31","Hotel","8","27","54","114","16","16","70","130","1"
"1","2017","31","Otros","6","25","157","1144","0","0","157","1144","2.3846153846154"
"1","2017","31","Otros","6","25","114","166","0","0","114","166","2.3846153846154"
"1","2017","31","Hotel","11","36","738","1247","0","0","738","1247","1"
"1","2017","31","Otros","16","20","75","105","6","15","81","120","1"
"1","2017","31","Otros","2","6","23","85","259","798","282","883","5"
"1","2017","31","Hotel","14","31","43","68","180","427","223","495","24"
"1","2017","31","Otros","4","21","80","101","31","93","111","194","4.8333333333333"
"1","2017","31","Otros","7","38","83","139","0","0","83","139","2.75"
"1","2017","31","Otros","13","14","188","311","0","0","188","311","7.3846153846154"
"1","2017","31","Otros","2","29","41","59","101","167","142","226","3.28"
"1","2017","31","Otros","3","4","131","171","66","71","197","242","12.2"
"1","2017","31","Hotel","3","4","372","916","79","184","451","1100","3"
"1","2017","31","Otros","7","27","447","674","99","131","546","805","1"
"1","2017","31","Otros","7","17","110","209","8","8","118","217","3"
"1","2017","31","Hotel","12","27","214","395","28","30","242","425","1"
"1","2017","31","Otros","5","5","81","115","34","92","115","207","3.65625"
"1","2017","31","Hotel","6","10","380","455","28","34","408","489","6.6"
"1","2017","31","Otros","10","18","119","348","101","297","220","645","10.25"
"1","2017","31","Otros","8","27","77","162","0","0","77","162","9.4"
"1","2017","31","Otros","8","3","116","341","35","74","151","415","10"
"1","2017","31","Hotel","16","27","3","60","0","0","3","60","5.8571428571429"
"1","2017","31","Otros","16","40","96","166","0","0","96","166","1"
"1","2017","31","Otros","8","27","91","167","25","54","116","221","1"
"1","2017","31","Otros","6","10","76","173","0","0","76","173","3.8518518518518"
"1","2017","31","Otros","7","17","52","131","37","95","89","226","3"
"1","2017","31","Otros","16","40","53","56","109","142","162","198","1"
"1","2017","31","Hotel","2","6","28","70","4","8","32","78","5.5"
"1","2017","31","Hotel","8","3","96","423","80","218","176","641","4.1111111111111"
"1","2017","31","Otros","7","38","377","927","16","28","393","955","1"
"1","2017","31","Otros","10","11","92","171","51","75","143","246","11.764705882353"
"1","2017","31","Otros","6","27","163","261","0","0","163","261","3.960088691796"
"1","2017","31","Otros","15","16","12","32","2","4","14","36","9"
"1","2017","31","Otros","6","25","54","162","0","0","54","162","1"
"1","2017","31","Otros","5","5","39","86","41","59","80","145","3.65625"
"1","2017","31","Otros","10","27","200","274","228","267","428","541","4.84"
"1","2017","31","Hotel","7","38","82","171","61","68","143","239","1"
"1","2017","31","Hotel","12","35","45","75","323","523","368","598","2"
"1","2017","31","Hotel","13","27","7","7","4","4","11","11","4.2"
"1","2017","31","Hotel","16","20","226","280","0","0","226","280","1"
"1","2017","31","Otros","10","27","58","76","0","0","58","76","4.84"
"1","2017","31","Otros","16","40","21","89","10","30","31","119","1"
"1","2017","31","Hotel","3","7","63","75","9","11","72","86","1"
"1","2017","31","Otros","2","29","186","269","54","67","240","336","3.28"
"1","2017","31","Otros","10","18","122","155","87","182","209","337","10.25"
"1","2017","31","Otros","5","5","113","279","84","282","197","561","4"
"1","2017","31","Otros","9","22","203","512","0","0","203","512","7.6428571428571"
"1","2017","31","Otros","15","27","171","201","0","0","171","201","1.4222222222222"
"1","2017","31","Otros","5","5","50","77","49","102","99","179","4"
"1","2017","31","Hotel","16","19","103","262","0","0","103","262","1"
"1","2017","31","Otros","11","36","14","31","3","6","17","37","5.1904761904762"
"1","2017","31","Otros","5","5","30","54","17","34","47","88","3.65625"
"1","2017","31","Otros","2","29","0","0","18","39","18","39","3.28"
"1","2017","31","Hotel","9","22","122","376","47","314","169","690","2.5555555555556"
"1","2017","31","Otros","11","32","16","23","0","0","16","23","2.2857142857143"
"1","2017","31","Hotel","10","27","347","673","534","823","881","1496","1"
"1","2017","31","Otros","16","27","320","648","3","18","323","666","2"
"1","2017","31","Otros","13","33","13","16","49","99","62","115","1"
"1","2017","31","Hotel","16","20","147","293","54","249","201","542","1"
"1","2017","31","Otros","11","15","26","48","0","0","26","48","2.3571428571429"
"1","2017","31","Otros","7","17","113","391","3","8","116","399","3"
"1","2017","31","Otros","5","8","66","110","23","39","89","149","5"
"1","2017","31","Otros","8","27","235","244","27","27","262","271","1"
"1","2017","31","Otros","8","3","10","30","89","270","99","300","14.75"
"1","2017","28","Otros","16","27","24","72","0","0","24","72","1"
"1","2017","0","Otros","13","14","0","0","0","0","0","0","1"
"1","2017","29","Hotel","13","33","81","117","23","43","104","160","2"
"1","2017","31","Otros","5","9","153","261","180","252","333","513","4.0454545454545"
"1","2017","31","Otros","10","27","131","269","173","203","304","472","4.84"
"1","2017","31","Otros","9","22","74","203","0","0","74","203","7.6428571428571"
"1","2017","31","Otros","16","40","9","132","0","0","9","132","28.142857142857"
"1","2017","31","Hotel","16","40","130","167","76","120","206","287","1"
"1","2017","31","Otros","15","16","9","68","19","88","28","156","9"
"1","2017","31","Hotel","8","2","56","84","68","68","124","152","3"
"1","2017","31","Otros","8","3","103","381","0","0","103","381","10"
"1","2017","31","Otros","7","17","43","90","20","60","63","150","17.166666666667"
"1","2017","31","Otros","16","20","148","194","20","38","168","232","3.0769230769231"
"1","2017","31","Otros","6","27","128","316","0","0","128","316","3.960088691796"
"1","2017","31","Otros","12","35","47","68","286","406","333","474","3.5"
"1","2017","31","Otros","6","28","146","457","53","64","199","521","4.65"
"1","2017","31","Otros","6","28","750","1357","160","215","910","1572","4.65"
"1","2017","31","Hotel","8","34","64","111","350","531","414","642","2.5714285714286"
"1","2017","31","Hotel","16","20","2388","3728","30","105","2418","3833","1"
"1","2017","31","Hotel","2","6","520","962","0","0","520","962","2.2"
"1","2017","31","Hotel","7","27","32","38","0","0","32","38","4.1666666666667"
"1","2017","31","Hotel","10","23","72","112","22","32","94","144","4"
"1","2017","31","Hotel","9","26","39","50","6","24","45","74","1.5"
"1","2017","31","Otros","13","14","121","165","0","0","121","165","1"
"1","2017","31","Otros","8","27","170","234","17","19","187","253","9.4"
"1","2017","31","Otros","10","27","95","120","27","27","122","147","4.84"
"1","2017","31","Otros","11","15","110","141","95","233","205","374","2.3571428571429"
"1","2017","31","Otros","16","20","21","36","0","0","21","36","3.0769230769231"
"1","2017","31","Otros","11","32","136","156","3","6","139","162","1"
"1","2017","31","Otros","16","27","111","111","13","13","124","124","13.818181818182"
"1","2017","11","Otros","7","38","39","123","0","0","39","123","1"
"1","2017","31","Otros","9","37","35","37","0","0","35","37","4.5"
"1","2017","31","Hotel","2","29","10","14","35","87","45","101","2"
"1","2017","31","Hotel","2","1","141","525","9","16","150","541","6.4"
"1","2017","31","Otros","5","8","30","41","52","56","82","97","5"
"1","2017","31","Otros","9","37","59","113","33","48","92","161","4.5"
"1","2017","31","Otros","7","38","256","735","8","34","264","769","2.75"
"1","2017","31","Otros","11","32","155","419","10","22","165","441","1"
"1","2017","31","Otros","4","39","76","96","11","39","87","135","2.2222222222222"
"1","2017","31","Hotel","11","36","128","275","93","198","221","473","2.375"
"1","2017","31","Otros","10","23","84","353","39","270","123","623","7"
"1","2017","31","Otros","6","28","138","168","12","12","150","180","1"
"1","2017","31","Otros","7","38","208","563","61","130","269","693","1"
"1","2017","31","Hotel","15","16","2172","5700","4215","4925","6387","10625","2"
"1","2017","31","Otros","2","29","20","62","224","411","244","473","3.28"
"1","2017","31","Hotel","8","3","0","0","0","0","0","0","1"
"1","2017","31","Hotel","6","12","1395","1752","24","24","1419","1776","1"
"1","2017","31","Hotel","11","15","206","1863","10","84","216","1947","1"
"1","2017","31","Otros","4","21","959","2239","320","945","1279","3184","1"
"1","2017","31","Otros","16","19","258","698","0","0","258","698","10.263157894737"
"1","2017","31","","9","37","377","424","24","30","401","454","1"
"1","2017","31","Otros","10","27","224","480","263","403","487","883","4.84"
"1","2017","31","Otros","11","15","66","90","0","0","66","90","2.3571428571429"
"1","2017","31","Hotel","8","3","10","41","2","28","12","69","1"
"1","2017","31","Hotel","2","29","56","174","99","329","155","503","2"
"1","2017","31","Otros","9","22","369","664","0","0","369","664","3.25"
"1","2017","30","Hotel","10","27","256","396","221","288","477","684","1"
"1","2017","31","Hotel","11","36","188","559","172","385","360","944","2.375"
"1","2017","31","Hotel","9","37","89","129","52","86","141","215","3.4"
"1","2017","31","Otros","14","27","4","8","9","18","13","26","11.833333333333"
"1","2017","31","Otros","7","38","307","670","11","11","318","681","1"
"1","2017","31","Hotel","2","1","71","403","0","0","71","403","6.4"
"1","2017","31","Otros","2","29","17","34","115","341","132","375","3.28"
"1","2017","31","Hotel","6","27","7","20","2","2","9","22","3"
"1","2017","31","Otros","5","9","35","151","0","0","35","151","4.0454545454545"
"1","2017","31","Hotel","2","1","160","200","0","0","160","200","6.4"
"1","2017","31","Hotel","10","27","42","42","133","133","175","175","1"
"1","2017","31","Hotel","3","7","18","50","45","81","63","131","1"
"1","2017","31","Otros","7","38","257","257","190","190","447","447","2.75"
"1","2017","31","Otros","12","24","17","18","76","80","93","98","1"
"1","2017","31","Otros","7","17","20","53","0","0","20","53","17.166666666667"
"1","2017","31","Otros","7","38","51","123","4","16","55","139","2.75"
"1","2017","31","Otros","4","21","121","127","30","30","151","157","4.8333333333333"
"1","2017","31","Otros","2","1","31","61","18","28","49","89","5.5"
"1","2017","31","Otros","12","35","67","81","76","94","143","175","3.5"
"1","2017","0","Otros","3","4","0","0","0","0","0","0","1"
"1","2017","31","Otros","12","35","31","71","30","46","61","117","3.5"
"1","2017","31","Otros","4","21","51","60","16","38","67","98","4.8333333333333"
"1","2017","31","Otros","12","24","34","85","60","185","94","270","9.2"
"1","2017","31","Otros","16","19","52","84","0","0","52","84","10.263157894737"
"1","2017","31","Otros","9","30","36","65","0","0","36","65","1"
"1","2017","31","Otros","10","11","180","301","14","17","194","318","11.764705882353"
"1","2017","31","Otros","16","19","109","353","0","0","109","353","10.263157894737"
"1","2017","31","Hotel","2","27","63","63","31","31","94","94","1"
"1","2017","31","Otros","6","28","82","84","7","10","89","94","4.65"
"1","2017","31","Otros","10","18","190","320","98","242","288","562","10.25"
"1","2017","31","Otros","14","27","19","41","3","6","22","47","11.833333333333"
"1","2017","31","Hotel","16","19","124","374","0","0","124","374","1"
"1","2017","31","Hotel","11","32","157","207","7","14","164","221","1"
"1","2017","31","Hotel","7","17","68","232","14","94","82","326","1"
"1","2017","31","Otros","8","27","10","16","0","0","10","16","9.4"
"1","2017","31","Hotel","12","35","105","241","149","237","254","478","1.7272727272727"
"1","2017","31","Otros","13","14","67","149","0","0","67","149","7.3846153846154"
"1","2017","31","Hotel","11","15","156","1302","0","0","156","1302","1"
"1","2017","31","Otros","16","19","54","166","0","0","54","166","4"
"1","2017","31","Otros","11","36","58","93","19","28","77","121","5.1904761904762"
"1","2017","27","Otros","10","23","123","285","33","43","156","328","1"
"1","2017","31","Otros","16","20","35","58","0","0","35","58","3.0769230769231"
"1","2017","31","Hotel","14","31","350","1217","657","1161","1007","2378","7.8"
"1","2017","31","Otros","2","27","210","412","11","49","221","461","3.2"
"1","2017","31","","16","40","564","3633","0","0","564","3633","3.0555555555556"
"1","2017","31","Hotel","11","36","98","185","45","101","143","286","2.375"
"1","2017","31","Hotel","9","22","57","76","10","10","67","86","2.5555555555556"
"1","2017","31","Otros","6","10","176","474","0","0","176","474","1"
"1","2017","31","Otros","2","29","41","48","101","139","142","187","3.28"
"1","2017","29","Hotel","10","27","72","92","550","664","622","756","2.25"
"1","2017","31","Hotel","10","18","64","108","67","120","131","228","1"
"1","2017","31","Otros","10","27","11","57","0","0","11","57","4.84"
"1","2017","31","Hotel","16","19","104","140","0","0","104","140","4"
"1","2017","22","Otros","2","6","11","28","1","1","12","29","5"
"1","2017","31","Otros","7","27","394","1617","19","120","413","1737","4.8333333333333"
"1","2017","31","Hotel","2","6","112","870","0","0","112","870","5.5"
"1","2017","31","Hotel","6","28","22","27","52","82","74","109","2.4"
"1","2017","31","Otros","6","10","351","998","17","17","368","1015","3.8518518518518"
"1","2017","31","Hotel","6","27","3","4","0","0","3","4","3"
"1","2017","31","Otros","6","10","76","146","0","0","76","146","1"
"1","2017","31","Otros","5","9","167","305","40","89","207","394","5.5"
"1","2017","31","Otros","5","5","43","66","13","26","56","92","3.65625"
"1","2017","29","Otros","12","24","64","118","98","155","162","273","9.2"
"1","2017","31","Hotel","8","2","20","35","5","7","25","42","3"
"1","2017","31","Hotel","11","32","29","53","8","8","37","61","1"
"1","2017","31","Otros","10","18","13","23","88","280","101","303","10.25"
"1","2017","31","Hotel","9","37","60","93","16","46","76","139","3.4"
"1","2017","31","Otros","5","9","80","85","112","179","192","264","4.0454545454545"
"1","2017","30","Otros","12","24","16","38","46","64","62","102","9.2"
"1","2017","31","Otros","9","22","40","40","0","0","40","40","7.6428571428571"
"1","2017","31","Otros","2","29","8","28","35","87","43","115","3.28"
"1","2017","31","Otros","10","23","34","81","14","42","48","123","7"
"1","2017","31","Otros","7","27","95","124","0","0","95","124","1"
"1","2017","31","Otros","10","27","41","77","11","30","52","107","3"
"1","2017","31","Otros","10","27","311","542","145","247","456","789","4.84"
"1","2017","31","Otros","10","11","43","53","0","0","43","53","11.764705882353"
"1","2017","31","Otros","10","11","26","55","6","6","32","61","1"
"1","2017","31","Otros","8","3","108","579","60","293","168","872","10"
"1","2017","31","Otros","14","31","44","104","586","961","630","1065","20.2"
"1","2017","31","Otros","2","29","282","520","272","684","554","1204","3.28"
"1","2017","31","Otros","6","25","0","0","0","0","0","0","1"
"1","2017","31","Otros","10","18","51","174","97","299","148","473","4.6"
"1","2017","31","Hotel","15","16","157","502","90","258","247","760","7.8"
"1","2017","31","Otros","13","33","161","405","15","47","176","452","1"
"1","2017","11","Otros","8","27","4","4","2","4","6","8","1"
"1","2017","31","Hotel","15","27","221","402","8","8","229","410","1"
"1","2017","31","Otros","10","27","14","20","0","0","14","20","4.84"
"1","2017","31","Otros","10","23","113","113","17","17","130","130","7"
"1","2017","31","Otros","6","27","40","80","0","0","40","80","3.960088691796"
"1","2017","31","Otros","16","40","93","296","23","53","116","349","28.142857142857"
"1","2017","31","Otros","11","36","150","431","22","67","172","498","5.1904761904762"
"1","2017","31","Otros","8","34","72","119","35","103","107","222","5.75"
"1","2017","26","Otros","6","12","93","123","2","2","95","125","1.8256578947368"
"1","2017","31","Otros","6","10","137","257","0","0","137","257","3.8518518518518"
"1","2017","31","Otros","8","27","335","550","82","169","417","719","1"
"1","2017","31","Otros","8","2","66","104","88","209","154","313","1"
"1","2017","31","Hotel","12","24","14","24","232","327","246","351","1"
"1","2017","31","Hotel","4","21","130","372","107","311","237","683","3"
"1","2017","31","Otros","7","27","223","244","24","42","247","286","1"
"1","2017","31","Hotel","11","36","173","340","102","343","275","683","2.375"
"1","2017","31","Otros","5","8","163","223","161","230","324","453","5"
"1","2017","31","Hotel","7","17","87","99","115","132","202","231","10"
"1","2017","27","Hotel","11","36","212","362","11","16","223","378","1"
"1","2017","31","Otros","9","30","146","225","0","0","146","225","2.3333333333333"
"1","2017","31","Otros","5","8","0","0","36","228","36","228","9"
"1","2017","31","Hotel","12","35","106","188","307","512","413","700","1.7272727272727"
"1","2017","31","Otros","2","1","75","216","32","50","107","266","5.5"
"1","2017","31","Hotel","6","25","74","81","6","6","80","87","1"
"1","2017","31","Otros","5","5","55","235","43","134","98","369","3.65625"
"1","2017","31","Otros","2","29","18","52","59","161","77","213","3.28"
"1","2017","31","Hotel","2","6","14","17","20","20","34","37","5.5"
"1","2017","31","Otros","7","17","43","85","11","23","54","108","17.166666666667"
"1","2017","31","Hotel","8","2","30","30","39","39","69","69","3"
"1","2017","31","Hotel","13","14","45","45","8","14","53","59","1"
"1","2017","31","Otros","7","38","84","207","18","39","102","246","2.75"
"1","2017","31","Hotel","14","31","6","12","153","371","159","383","24"
"1","2017","31","Hotel","5","5","62","72","111","149","173","221","2.1428571428571"
"1","2017","31","Otros","2","27","13","13","6","6","19","19","3.2"
"1","2017","31","Otros","12","24","9","16","130","204","139","220","1"
"1","2017","31","Otros","5","8","46","51","65","98","111","149","5"
"1","2017","31","Otros","3","4","18","30","39","173","57","203","12.2"
"1","2017","31","Otros","13","14","4","15","0","0","4","15","7.3846153846154"
"1","2017","31","Otros","9","37","63","112","4","4","67","116","4.5"
"1","2017","31","Hotel","10","23","1159","1346","208","333","1367","1679","1"
"1","2017","31","Otros","11","32","45","45","3","3","48","48","2.2857142857143"
"1","2017","24","Otros","10","11","16","16","0","0","16","16","1"
"1","2017","31","Otros","11","15","4","8","0","0","4","8","2.3571428571429"
"1","2017","31","Otros","8","3","95","401","82","342","177","743","10"
"1","2017","31","Otros","16","20","51","126","0","0","51","126","3.0769230769231"
"1","2017","20","Otros","10","18","22","90","28","130","50","220","4.6"
"1","2017","31","Otros","8","3","74","429","37","115","111","544","10"
"1","2017","31","Otros","16","27","237","707","0","0","237","707","2"
"1","2017","31","Otros","16","19","81","200","1","1","82","201","4"
"1","2017","31","Hotel","16","19","43","75","2","4","45","79","4"
"1","2017","31","Hotel","16","27","59","110","7","29","66","139","5.8571428571429"
"1","2017","31","Otros","12","35","16","23","38","47","54","70","2.6666666666667"
"1","2017","31","Otros","9","26","53","64","11","18","64","82","3.8888888888889"
"1","2017","31","Otros","5","5","15","24","12","26","27","50","3.65625"
"1","2017","31","Otros","14","27","6","6","0","0","6","6","11.833333333333"
"1","2017","31","Hotel","5","5","4","16","42","257","46","273","2.1428571428571"
"1","2017","31","Hotel","12","24","88","238","128","337","216","575","3"
"1","2017","31","Otros","16","27","50","156","6","14","56","170","13.818181818182"
"1","2017","31","Otros","7","27","50","58","1","1","51","59","1"
"1","2017","31","Otros","8","3","62","331","57","230","119","561","1"
"1","2017","31","Otros","9","37","57","125","0","0","57","125","2"
"1","2017","31","Otros","13","27","196","225","0","0","196","225","12.2"
"1","2017","31","Hotel","16","40","44","70","75","189","119","259","16.333333333333"
"1","2017","31","Otros","11","36","46","92","10","20","56","112","1"
"1","2017","30","Otros","10","27","100","189","64","103","164","292","4.84"
"1","2017","31","Hotel","7","38","125","184","18","18","143","202","1"
"1","2017","31","Otros","13","33","339","478","0","0","339","478","1"
"1","2017","31","Otros","9","22","134","423","0","0","134","423","7.6428571428571"
"1","2017","31","Hotel","8","3","41","56","12","18","53","74","1"
"1","2017","31","Hotel","5","5","43","71","34","60","77","131","2.1428571428571"
"1","2017","31","Otros","2","29","48","141","147","324","195","465","3.28"
"1","2017","31","Otros","2","29","4","28","34","99","38","127","3.28"
"1","2017","31","Otros","2","29","13","47","81","206","94","253","1"
"1","2017","31","Hotel","7","17","48","104","67","399","115","503","1"
"1","2017","31","Hotel","13","14","117","181","6","6","123","187","1"
"1","2017","31","Otros","6","25","1","1","0","0","1","1","2.3846153846154"
"1","2017","31","Otros","2","1","21","25","2","4","23","29","5.5"
"1","2017","31","Hotel","12","27","66","86","104","114","170","200","1"
"1","2017","31","Hotel","13","27","26","26","0","0","26","26","4.2"
"1","2017","31","Otros","6","12","78","199","2","8","80","207","1.8256578947368"
"1","2017","31","Otros","6","27","47","49","0","0","47","49","3.960088691796"
"1","2017","31","Otros","6","25","78","78","0","0","78","78","2.3846153846154"
"1","2017","31","Otros","6","25","200","337","21","42","221","379","1"
"1","2017","31","Hotel","6","28","20","68","0","0","20","68","2.5833333333333"
"1","2017","31","Otros","6","27","16","38","0","0","16","38","3.6666666666667"
"1","2017","31","Otros","5","5","0","0","16","16","16","16","3.65625"
"1","2017","31","Otros","5","9","6","13","10","23","16","36","4.0454545454545"
"1","2017","31","Otros","5","8","16","22","13","15","29","37","5"
"1","2017","31","Hotel","2","29","123","342","133","265","256","607","1"
"1","2017","31","Otros","5","5","110","183","92","156","202","339","3.65625"
"1","2017","31","Hotel","9","26","20","57","9","21","29","78","1.5"
"1","2017","31","Otros","9","30","11","16","0","0","11","16","2.3333333333333"
"1","2017","31","Otros","11","15","37","97","5","8","42","105","2.3571428571429"
"1","2017","31","Hotel","16","27","4","5","2","2","6","7","5.8571428571429"
"1","2017","31","Otros","9","30","53","65","0","0","53","65","2.3333333333333"
"1","2017","31","Otros","11","15","68","79","7","9","75","88","1"
"1","2017","31","Otros","2","29","26","47","80","195","106","242","3.28"
"1","2017","31","Otros","7","38","44","72","39","53","83","125","2.75"
"1","2017","31","Otros","4","21","45","281","80","500","125","781","4.8333333333333"
"1","2017","31","Otros","9","22","96","229","0","0","96","229","7.6428571428571"
"1","2017","31","Otros","9","22","177","298","0","0","177","298","7.6428571428571"
"1","2017","31","Otros","13","27","31","160","0","0","31","160","12.2"
"1","2017","31","Otros","8","3","135","386","8","48","143","434","14.75"
"1","2017","16","Otros","11","32","33","208","0","0","33","208","1"
"1","2017","31","Hotel","11","36","3926","4319","168","232","4094","4551","1"
"1","2017","31","Otros","13","33","16","32","4","4","20","36","5.125"
"1","2017","31","Otros","11","36","150","346","100","237","250","583","5.1904761904762"
"1","2017","31","Otros","12","35","98","174","245","366","343","540","3.5"
"1","2017","31","Otros","12","35","24","60","29","61","53","121","3.5"
"1","2017","31","Otros","16","40","2","2","19","49","21","51","1"
"1","2017","31","Otros","10","11","97","199","19","35","116","234","11.764705882353"
"1","2017","31","Otros","12","24","24","51","30","90","54","141","9.2"
"1","2017","31","Otros","16","20","54","190","22","92","76","282","3.0769230769231"
"1","2017","31","Hotel","7","27","275","352","60","114","335","466","1"
"1","2017","31","Otros","13","27","62","106","12","12","74","118","9"
"1","2017","31","Otros","6","12","23","24","0","0","23","24","1.8256578947368"
"1","2017","31","Otros","11","32","489","922","119","222","608","1144","2.2857142857143"
"1","2017","31","Otros","6","28","52","135","1","3","53","138","4.65"
"1","2017","31","Otros","8","34","1","1","0","0","1","1","5.75"
"1","2017","31","Otros","16","27","51","179","0","0","51","179","13.818181818182"
"1","2017","31","Otros","10","27","15","15","24","27","39","42","3"
"1","2017","31","Otros","10","11","26","26","0","0","26","26","11.764705882353"
"1","2017","31","Otros","6","10","74","192","0","0","74","192","3.8518518518518"
"1","2017","31","Otros","8","3","3","5","0","0","3","5","10"
"1","2017","31","Hotel","16","20","45","163","79","248","124","411","1"
"1","2017","31","Hotel","11","32","72","124","62","104","134","228","1"
"1","2017","31","Otros","8","27","23","23","67","67","90","90","9.4"
"1","2017","31","Otros","12","27","24","32","21","27","45","59","3.4285714285714"
"1","2017","31","Otros","6","10","104","219","0","0","104","219","3.8518518518518"
"1","2017","31","Otros","6","10","67","210","0","0","67","210","3.8518518518518"
"1","2017","31","Otros","5","8","10","15","10","22","20","37","5"
"1","2017","31","Otros","5","8","85","85","77","81","162","166","5"
"1","2017","31","Otros","5","9","16","24","1","1","17","25","5.5"
"1","2017","31","Hotel","9","26","98","108","4","8","102","116","1.5"
"1","2017","31","Hotel","13","14","35","45","5","7","40","52","1"
"1","2017","31","Otros","10","18","53","295","76","333","129","628","10.25"
"1","2017","31","Otros","8","2","64","68","61","65","125","133","6.4285714285714"
"1","2017","31","Otros","7","27","64","97","0","0","64","97","4.8333333333333"
"1","2017","31","Otros","2","29","20","66","74","262","94","328","1"
"1","2017","31","Otros","2","29","50","130","37","78","87","208","3.28"
"1","2017","31","Otros","11","32","1","2","0","0","1","2","2.2857142857143"
"1","2017","31","Otros","9","30","28","56","0","0","28","56","2.3333333333333"
"1","2017","31","Otros","2","29","19","59","19","89","38","148","3.28"
"1","2017","31","Otros","5","5","31","40","28","39","59","79","3.65625"
"1","2017","31","Otros","11","15","53","76","0","0","53","76","2.3571428571429"
"1","2017","31","Otros","10","23","99","119","56","56","155","175","7"
"1","2017","31","Otros","11","36","80","133","56","88","136","221","5.1904761904762"
"1","2017","31","Hotel","3","7","27","42","41","68","68","110","1"
"1","2017","31","Otros","10","27","27","107","42","42","69","149","4.84"
"1","2017","31","Otros","2","27","7","9","0","0","7","9","3.2"
"1","2017","31","Otros","12","35","16","24","70","143","86","167","3.5"
"1","2017","31","Otros","10","27","17","35","33","65","50","100","4.84"
"1","2017","31","Otros","16","40","38","104","176","437","214","541","28.142857142857"
"1","2017","31","Hotel","8","3","399","872","147","284","546","1156","4.1111111111111"
"1","2017","31","Otros","9","22","62","128","0","0","62","128","7.6428571428571"
"1","2017","31","Otros","13","14","53","106","2","8","55","114","7.3846153846154"
"1","2017","31","Otros","5","9","0","0","4","12","4","12","4.0454545454545"
"1","2017","31","Otros","10","18","44","69","77","138","121","207","10.25"
"1","2017","31","Otros","6","25","255","689","4","16","259","705","2.3846153846154"
"1","2017","31","Otros","9","22","183","536","0","0","183","536","7.6428571428571"
"1","2017","31","Otros","10","27","152","239","5","5","157","244","4.84"
"1","2017","31","Otros","9","22","40","71","0","0","40","71","3.25"
"1","2017","31","Otros","16","20","114","228","14","36","128","264","3.0769230769231"
"1","2017","31","Otros","13","14","136","225","6","6","142","231","1"
"1","2017","31","Otros","16","19","19","44","0","0","19","44","4"
"1","2017","31","Hotel","7","17","205","512","61","198","266","710","10"
"1","2017","31","Otros","15","27","65","89","0","0","65","89","1.4222222222222"
"1","2017","31","Otros","12","35","39","71","58","64","97","135","3.5"
"1","2017","31","Otros","12","35","26","35","162","222","188","257","3.5"
"1","2017","31","Otros","3","7","10","14","0","0","10","14","2"
"1","2017","31","Otros","10","11","4","6","14","19","18","25","11.764705882353"
"1","2017","31","Otros","12","24","8","16","43","73","51","89","9.2"
"1","2017","31","Otros","10","23","43","51","0","0","43","51","7"
"1","2017","31","Otros","7","27","43","80","0","0","43","80","4.8333333333333"
"1","2017","31","","10","18","5","7","0","0","5","7","1"
"1","2017","31","Otros","10","18","48","124","4","12","52","136","4.6"
"1","2017","31","Otros","8","2","48","48","0","0","48","48","1"
"1","2017","31","Otros","16","27","2","2","8","8","10","10","13.818181818182"
"1","2017","31","Hotel","2","29","9","30","20","60","29","90","1"
"1","2017","31","Otros","14","27","30","120","0","0","30","120","11.833333333333"
"1","2017","31","Otros","11","32","111","226","0","0","111","226","2.2857142857143"
"1","2017","31","Otros","16","19","292","1362","0","0","292","1362","1"
"1","2017","31","Otros","16","27","100","198","0","0","100","198","13.818181818182"
"1","2017","31","Otros","8","3","110","444","0","0","110","444","10"
"1","2017","31","Otros","16","27","129","173","0","0","129","173","13.818181818182"
"1","2017","31","Otros","16","20","83","326","40","122","123","448","3.0769230769231"
"1","2017","28","Otros","11","36","35","76","2","7","37","83","3.25"
"1","2017","31","Otros","8","2","59","152","37","44","96","196","1"
"1","2017","31","Otros","16","40","136","512","82","225","218","737","28.142857142857"
"1","2017","31","Hotel","11","36","91","138","36","58","127","196","2.375"
"1","2017","31","Otros","7","17","38","169","3","6","41","175","3"
"1","2017","31","Otros","6","10","102","168","0","0","102","168","3.8518518518518"
"1","2017","31","Otros","7","38","104","320","16","32","120","352","2.75"
"1","2017","31","Otros","13","14","24","24","3","6","27","30","7.3846153846154"
"1","2017","31","Otros","9","30","12","16","7","7","19","23","2.3333333333333"
"1","2017","31","Otros","13","27","25","124","0","0","25","124","12.2"
"1","2017","31","Otros","10","27","21","21","17","17","38","38","4.84"
"1","2017","31","Otros","6","25","34","52","18","37","52","89","2.3846153846154"
"1","2017","31","Otros","9","26","30","920","0","0","30","920","3.8888888888889"
"1","2017","31","Otros","10","18","26","67","29","87","55","154","10.25"
"1","2017","31","Otros","2","29","8","42","0","0","8","42","3.28"
"1","2017","31","Otros","6","25","87","153","0","0","87","153","2.3846153846154"
"1","2017","31","Otros","6","25","18","18","0","0","18","18","1"
"1","2017","31","Otros","6","27","116","370","4","8","120","378","3.6666666666667"
"1","2017","31","Otros","5","9","58","58","88","108","146","166","4.0454545454545"
"1","2017","31","Otros","5","9","12","26","22","32","34","58","4.0454545454545"
"1","2017","31","Hotel","9","37","49","84","6","23","55","107","3.4"
"1","2017","31","Hotel","7","38","151","397","2","8","153","405","1"
"1","2017","31","Otros","7","27","93","169","0","0","93","169","4.8333333333333"
"1","2017","31","Otros","5","9","19","19","0","0","19","19","4.0454545454545"
"1","2017","31","Otros","10","27","14","15","26","27","40","42","4.84"
"1","2017","31","Otros","7","27","45","50","0","0","45","50","4.8333333333333"
"1","2017","31","Otros","16","40","46","72","34","88","80","160","28.142857142857"
"1","2017","31","Otros","10","23","41","41","13","13","54","54","7"
"1","2017","31","Otros","15","16","159","565","10","20","169","585","9"
"1","2017","31","Otros","3","7","7","13","67","182","74","195","2"
"1","2017","31","Otros","7","17","64","229","52","215","116","444","17.166666666667"
"1","2017","31","Otros","8","27","87","135","22","24","109","159","9.4"
"1","2017","25","Otros","11","36","64","64","8","8","72","72","3.25"
"1","2017","31","Otros","9","22","36","76","0","0","36","76","7.6428571428571"
"1","2017","31","Otros","16","19","23","91","0","0","23","91","10.263157894737"
"1","2017","31","Otros","13","14","75","155","0","0","75","155","1"
"1","2017","31","Otros","5","9","66","124","66","141","132","265","5.5"
"1","2017","31","","15","27","130","260","0","0","130","260","1"
"1","2017","31","Hotel","16","19","103","262","0","0","103","262","1"
"1","2017","31","Hotel","10","11","36","58","35","61","71","119","5.6666666666667"
"1","2017","31","Otros","2","27","3","7","9","10","12","17","3.2"
"1","2017","31","Otros","8","2","35","102","73","102","108","204","6.4285714285714"
"1","2017","31","Otros","5","5","12","15","11","17","23","32","3.65625"
"1","2017","31","Otros","12","35","8","8","61","73","69","81","3.5"
"1","2017","31","Otros","8","3","16","42","72","189","88","231","10"
"1","2017","31","Otros","12","24","21","34","89","159","110","193","9.2"
"1","2017","31","Otros","11","32","95","534","16","66","111","600","2.2857142857143"
"1","2017","31","Otros","10","27","102","191","162","391","264","582","4.84"
"1","2017","31","Hotel","9","22","49","122","0","0","49","122","1"
"1","2017","28","Otros","11","15","68","332","5","50","73","382","2.3571428571429"
"1","2017","31","Otros","5","8","32","32","34","34","66","66","5"
"1","2017","31","Otros","14","27","25","25","12","12","37","37","11.833333333333"
"1","2017","31","Otros","13","27","322","445","52","156","374","601","12.2"
"1","2017","31","Otros","13","33","19","50","0","0","19","50","1"
"1","2017","31","Hotel","10","18","148","148","271","271","419","419","3.2"
"1","2017","31","Otros","6","25","115","152","1","1","116","153","1"
"1","2017","31","Otros","13","14","12","25","3","5","15","30","3.25"
"1","2017","14","Otros","10","23","4","14","3","5","7","19","1"
"1","2017","31","Otros","10","27","23","23","47","47","70","70","4.84"
"1","2017","31","Otros","13","14","90","180","30","60","120","240","3.25"
"1","2017","31","Otros","10","11","22","22","0","0","22","22","1"
"1","2017","31","Otros","15","16","35","45","0","0","35","45","1"
"1","2017","31","Otros","11","32","50","60","0","0","50","60","1"
"1","2017","31","Otros","9","37","25","49","0","0","25","49","4.5"
"1","2017","16","Otros","12","35","24","33","53","69","77","102","3.5"
"1","2017","31","Otros","8","34","110","150","102","176","212","326","5.75"
"1","2017","31","Hotel","16","40","24","27","92","166","116","193","16.333333333333"
"1","2017","31","Hotel","10","11","63","149","52","120","115","269","5.6666666666667"
"1","2017","31","Otros","7","27","19","39","0","0","19","39","4.8333333333333"
"1","2017","31","Hotel","7","38","18","18","0","0","18","18","1"
"1","2017","31","Otros","6","27","1","1","0","0","1","1","3.960088691796"
"1","2017","31","Otros","6","10","118","267","0","0","118","267","3.8518518518518"
"1","2017","31","Otros","6","25","284","689","0","0","284","689","1"
"1","2017","31","Otros","6","25","12","17","2","2","14","19","2.3846153846154"
"1","2017","31","Otros","6","27","120","413","16","58","136","471","3.960088691796"
"1","2017","31","Otros","6","10","16","90","0","0","16","90","1"
"1","2017","31","Otros","6","25","34","51","0","0","34","51","1"
"1","2017","31","Otros","6","27","275","551","0","0","275","551","3.960088691796"
"1","2017","31","Otros","5","5","74","112","24","36","98","148","3.65625"
"1","2017","31","Otros","5","5","12","21","0","0","12","21","3.65625"
"1","2017","31","Otros","5","8","60","85","20","30","80","115","9"
"1","2017","31","Otros","10","23","7","7","0","0","7","7","1"
"1","2017","31","Otros","3","4","16","22","7","7","23","29","12.2"
"1","2017","30","Otros","10","23","8","17","211","295","219","312","1"
"1","2017","31","Otros","10","23","23","66","25","37","48","103","7"
"1","2017","31","Otros","8","3","54","423","0","0","54","423","10"
"1","2017","31","Otros","13","14","31","131","16","52","47","183","3.25"
"1","2017","31","Otros","5","5","3","13","21","82","24","95","3.65625"
"1","2017","31","Otros","5","8","17","23","7","12","24","35","5"
"1","2017","31","Otros","6","10","169","390","14","26","183","416","3.8518518518518"
"1","2017","31","Otros","16","19","59","245","0","0","59","245","10.263157894737"
"1","2017","31","Otros","10","18","32","150","53","157","85","307","4.6"
"1","2017","31","Otros","11","15","66","159","5","18","71","177","2.3571428571429"
"1","2017","31","Otros","7","38","78","108","1","1","79","109","2.75"
"1","2017","31","Otros","11","32","209","570","47","83","256","653","2.2857142857143"
"1","2017","31","Otros","8","2","63","176","3","9","66","185","6.4285714285714"
"1","2017","31","Otros","10","27","36","53","18","37","54","90","4.84"
"1","2017","31","Otros","6","27","90","242","0","0","90","242","3.960088691796"
"1","2017","31","Otros","6","28","22","36","0","0","22","36","1"
"1","2017","31","Otros","13","14","155","158","1","1","156","159","1"
"1","2017","31","Otros","11","32","30","48","0","0","30","48","2.2857142857143"
"1","2017","31","Otros","8","34","21","21","122","173","143","194","5.75"
"1","2017","31","Otros","11","32","17","18","0","0","17","18","2.2857142857143"
"1","2017","13","Otros","10","18","14","29","17","19","31","48","4.6"
"1","2017","31","Otros","10","11","19","61","4","34","23","95","11.764705882353"
"1","2017","31","Otros","11","32","29","72","23","28","52","100","2.2857142857143"
"1","2017","31","Otros","14","31","0","0","22","33","22","33","20.2"
"1","2017","31","Hotel","8","3","138","318","130","226","268","544","1"
"1","2017","31","Hotel","14","31","107","191","760","2708","867","2899","17.4"
"1","2017","31","Otros","11","36","380","865","0","0","380","865","5.1904761904762"
"1","2017","31","Hotel","15","16","1544","2709","316","555","1860","3264","2"
"1","2017","31","Otros","15","27","0","0","4","6","4","6","1.4222222222222"
"1","2017","25","Otros","5","5","32","51","24","50","56","101","3.65625"
"1","2017","31","Otros","8","34","7","11","9","12","16","23","5.75"
"1","2017","31","Otros","13","14","187","431","11","24","198","455","3.25"
"1","2017","31","Otros","7","27","62","178","2","2","64","180","4.8333333333333"
"1","2017","31","Otros","12","35","31","37","26","26","57","63","3.5"
"1","2017","31","Otros","5","5","58","98","9","10","67","108","3.65625"
"1","2017","31","Otros","10","11","6","38","2","2","8","40","11.764705882353"
"1","2017","31","Otros","10","11","2","3","0","0","2","3","11.764705882353"
"1","2017","31","Otros","9","30","8","160","0","0","8","160","2.3333333333333"
"1","2017","31","Otros","8","2","37","92","0","0","37","92","6.4285714285714"
"1","2017","31","Otros","10","27","36","78","106","170","142","248","4.84"
"1","2017","31","Otros","5","9","55","71","14","15","69","86","4.0454545454545"
"1","2017","31","Otros","10","27","96","148","78","97","174","245","3"
"1","2017","31","Otros","6","27","24","24","0","0","24","24","3.960088691796"
"1","2017","31","Otros","6","10","126","259","28","46","154","305","3.8518518518518"
"1","2017","31","Otros","6","10","145","414","2","8","147","422","3.8518518518518"
"1","2017","31","Otros","6","27","24","32","0","0","24","32","3.960088691796"
"1","2017","21","Otros","6","12","5","34","0","0","5","34","1.8256578947368"
"1","2017","31","Otros","6","10","101","282","0","0","101","282","3.8518518518518"
"1","2017","31","Otros","6","10","47","110","0","0","47","110","3.8518518518518"
"1","2017","31","Otros","6","27","12","24","0","0","12","24","3.960088691796"
"1","2017","31","Otros","6","12","82","139","0","0","82","139","1.8256578947368"
"1","2017","31","Otros","6","10","39","59","0","0","39","59","3.8518518518518"
"1","2017","31","Hotel","6","25","92","180","0","0","92","180","1"
"1","2017","31","Otros","6","10","90","237","0","0","90","237","1"
"1","2017","31","Otros","6","27","41","41","1","1","42","42","3.960088691796"
"1","2017","31","Otros","5","9","38","78","23","35","61","113","4.0454545454545"
"1","2017","31","Otros","5","5","48","100","47","71","95","171","3.65625"
"1","2017","31","Otros","5","5","18","24","0","0","18","24","3.65625"
"1","2017","31","Otros","5","5","97","152","37","102","134","254","3.65625"
"1","2017","31","Otros","5","9","64","178","23","88","87","266","5.5"
"1","2017","31","Otros","11","36","44","184","0","0","44","184","5.1904761904762"
"1","2017","31","Otros","10","27","0","0","4","4","4","4","3"
"1","2017","31","Otros","10","11","66","82","0","0","66","82","1"
"1","2017","31","Hotel","6","10","833","3133","87","188","920","3321","1"
"1","2017","31","Otros","5","9","17","35","0","0","17","35","4.0454545454545"
"1","2017","31","Otros","5","8","77","88","19","38","96","126","5"
"1","2017","0","Hotel","15","27","0","0","0","0","0","0","1"
"1","2017","31","Hotel","3","4","293","1991","56","270","349","2261","3"
"1","2017","31","Otros","3","7","11","18","26","29","37","47","1"
"1","2017","31","Otros","7","38","162","398","13","22","175","420","2.75"
"1","2017","31","Hotel","10","27","190","223","249","311","439","534","1"
"1","2017","31","Hotel","12","35","5","10","134","253","139","263","1.7272727272727"
"1","2017","31","Hotel","10","27","13","21","0","0","13","21","2.25"
"1","2017","31","Hotel","7","17","574","1221","283","900","857","2121","4"
"1","2017","14","Hotel","16","19","50","78","18","29","68","107","4"
"1","2017","31","Hotel","2","6","343","1700","0","0","343","1700","2.2"
"1","2017","31","Otros","5","5","103","524","37","220","140","744","3.65625"
"1","2017","31","Hotel","10","18","65","133","154","380","219","513","1"
"1","2017","31","Otros","12","24","71","90","214","227","285","317","9.2"
"1","2017","31","Otros","5","8","91","171","51","125","142","296","5"
"1","2017","31","Otros","4","13","159","172","24","24","183","196","1"
"1","2017","31","Otros","10","11","289","289","0","0","289","289","11.764705882353"
"1","2017","31","Otros","12","35","16","25","95","132","111","157","3.5"
"1","2017","31","Otros","10","23","96","128","21","39","117","167","7"
"1","2017","31","Otros","11","36","401","1234","173","351","574","1585","5.1904761904762"
"1","2017","31","Otros","12","35","42","83","244","296","286","379","3.5"
"1","2017","31","Otros","11","36","97","247","24","60","121","307","5.1904761904762"
"1","2017","31","Otros","8","2","104","314","47","94","151","408","6.4285714285714"
"1","2017","31","Otros","9","30","159","636","0","0","159","636","2.3333333333333"
"1","2017","31","Otros","11","36","120","215","48","80","168","295","5.1904761904762"
"1","2017","31","Otros","6","10","88","196","0","0","88","196","3.8518518518518"
"1","2017","31","Otros","10","18","91","272","38","125","129","397","10.25"
"1","2017","31","Otros","10","11","15","15","0","0","15","15","1"
"1","2017","31","Otros","7","27","37","121","0","0","37","121","4.8333333333333"
"1","2017","31","Otros","16","20","89","534","28","168","117","702","1"
"1","2017","31","Otros","9","22","37","64","0","0","37","64","7.6428571428571"
"1","2017","31","Otros","15","16","372","392","0","0","372","392","1"
"1","2017","31","Otros","5","5","255","423","11","23","266","446","3.65625"
"1","2017","31","Otros","12","35","67","81","76","94","143","175","3.5"
"1","2017","31","Otros","10","11","36","61","50","110","86","171","11.764705882353"
"1","2017","31","Otros","10","11","18","101","1","2","19","103","11.764705882353"
"1","2017","25","Otros","5","9","104","183","14","22","118","205","4.0454545454545"
"1","2017","31","Otros","5","5","19","24","0","0","19","24","3.65625"
"1","2017","31","Otros","10","11","22","32","12","41","34","73","1"
"1","2017","31","Otros","12","35","15","24","87","146","102","170","3.5"
"1","2017","31","Otros","7","38","136","399","14","30","150","429","2.75"
"1","2017","31","Hotel","12","35","8","18","66","207","74","225","1.7272727272727"
"1","2017","31","Otros","13","14","114","186","5","5","119","191","1"
"1","2017","31","Otros","5","5","32","66","10","19","42","85","3.65625"
"1","2017","31","Otros","8","3","95","253","68","197","163","450","14.75"
"1","2017","31","Hotel","9","26","3","7","0","0","3","7","1.5"
"1","2017","31","Hotel","16","19","229","246","0","0","229","246","1"
"1","2017","31","Otros","9","22","76","78","0","0","76","78","3.25"
"1","2017","31","Otros","16","19","60","80","0","0","60","80","10.263157894737"
"1","2017","31","Otros","9","30","30","43","3","3","33","46","2.3333333333333"
"1","2017","31","Otros","16","19","19","25","0","0","19","25","10.263157894737"
"1","2017","31","Otros","16","19","172","583","0","0","172","583","10.263157894737"
"1","2017","31","Otros","9","26","9","9","0","0","9","9","3.8888888888889"
"1","2017","31","Otros","16","40","4","9","1","2","5","11","28.142857142857"
"1","2017","31","Hotel","16","27","27","55","0","0","27","55","5.8571428571429"
"1","2017","31","Otros","16","19","51","148","0","0","51","148","10.263157894737"
"1","2017","31","Otros","16","19","148","304","0","0","148","304","10.263157894737"
"1","2017","31","","9","30","121","221","15","27","136","248","1"
"1","2017","31","Otros","16","19","159","296","0","0","159","296","10.263157894737"
"1","2017","31","Otros","10","11","24","92","1","2","25","94","11.764705882353"
"1","2017","31","Otros","11","36","18","18","0","0","18","18","5.1904761904762"
"1","2017","31","Otros","16","19","9","36","0","0","9","36","10.263157894737"
"1","2017","31","Otros","16","19","155","457","0","0","155","457","1.3333333333333"
"1","2017","31","Otros","16","19","25","35","0","0","25","35","10.263157894737"
"1","2017","31","Otros","10","18","20","48","78","184","98","232","10.25"
"1","2017","31","Otros","16","19","186","569","0","0","186","569","10.263157894737"
"1","2017","31","Otros","16","19","57","141","12","68","69","209","1.3333333333333"
"1","2017","31","","9","26","195","1531","0","0","195","1531","1"
"1","2017","31","Otros","16","19","29","44","0","0","29","44","10.263157894737"
"1","2017","31","Otros","16","19","64","118","15","43","79","161","10.263157894737"
"1","2017","31","Hotel","8","2","0","0","0","0","0","0","1"
"1","2017","31","Otros","6","10","56","124","0","0","56","124","3.8518518518518"
"1","2017","25","Otros","6","25","63","117","0","0","63","117","1"
"1","2017","31","Otros","6","12","169","256","0","0","169","256","1.8256578947368"
"1","2017","31","Hotel","16","19","789","1309","0","0","789","1309","1"
"1","2017","31","Otros","3","7","8","8","38","38","46","46","2"
"1","2017","31","Hotel","2","6","1543","1543","2110","2110","3653","3653","1"
"1","2017","31","Hotel","3","4","687","899","180","280","867","1179","2.6"
"1","2017","31","Hotel","16","40","2052","3405","2914","5213","4966","8618","1"
"1","2017","31","Otros","16","27","148","579","0","0","148","579","13.818181818182"
"1","2017","29","Hotel","6","28","194","245","180","261","374","506","2.4"
"1","2017","31","Hotel","8","34","968","1192","759","975","1727","2167","1"
"1","2017","31","Otros","12","35","14","14","7","7","21","21","2.6666666666667"
"1","2017","31","Otros","9","30","10","13","0","0","10","13","2.3333333333333"
"1","2017","31","Hotel","10","18","37","37","245","245","282","282","1"
"1","2017","31","Hotel","9","30","424","763","0","0","424","763","1"
"1","2017","31","Hotel","15","27","14","14","0","0","14","14","1"
"1","2017","31","Hotel","9","22","105","216","0","0","105","216","2.5555555555556"
"1","2017","31","","11","15","179","358","25","60","204","418","1"
"1","2017","31","Otros","6","12","29","32","4","6","33","38","1.8256578947368"
"1","2017","31","Otros","6","28","4","16","2","20","6","36","1"
"1","2017","31","Hotel","15","27","80","1760","0","0","80","1760","1"
"1","2017","31","Otros","15","27","81","91","0","0","81","91","1.4222222222222"
"1","2017","31","Otros","15","27","15","15","0","0","15","15","1.4222222222222"
"1","2017","31","Otros","12","35","13","13","6","6","19","19","2.6666666666667"
"1","2017","31","Otros","2","1","18","18","7","7","25","25","1"
"1","2017","31","Otros","12","24","13","15","5","14","18","29","9.2"
"1","2017","31","Otros","5","5","18","45","22","43","40","88","3.65625"
"1","2017","31","Otros","6","28","55","55","0","0","55","55","1"
"1","2017","29","Hotel","7","27","208","234","125","134","333","368","1"
"1","2017","31","Otros","16","20","76","155","13","19","89","174","3.0769230769231"
"1","2017","31","Otros","10","11","8","24","0","0","8","24","1"
"1","2017","31","","10","11","129","327","39","114","168","441","1"
"1","2017","31","Hotel","16","40","30","65","84","227","114","292","16.333333333333"
"1","2017","31","Otros","12","35","12","12","0","0","12","12","3.5"
"1","2017","31","Hotel","6","27","25","31","0","0","25","31","3"
"1","2017","31","Otros","5","5","24","46","5","10","29","56","3.65625"
"1","2017","31","Hotel","6","27","72","102","8","10","80","112","3"
"1","2017","31","Otros","6","25","75","124","0","0","75","124","2.3846153846154"
"1","2017","31","Otros","9","37","30","46","0","0","30","46","19"
"1","2017","30","Hotel","15","27","59","135","6","10","65","145","1"
"1","2017","31","Otros","16","19","289","390","10","24","299","414","1"
"1","2017","31","Otros","5","9","30","35","49","67","79","102","4.0454545454545"
"1","2017","31","Hotel","15","27","20","40","0","0","20","40","1"
"1","2017","31","Hotel","5","9","19","19","0","0","19","19","1"
"1","2017","31","Hotel","8","34","75","127","134","213","209","340","2.5714285714286"
"1","2017","0","Hotel","15","27","0","0","0","0","0","0","1"
"1","2017","31","Hotel","6","27","54","72","0","0","54","72","3"
"1","2017","31","Otros","6","27","45","245","0","0","45","245","1"
"1","2017","31","Hotel","7","17","148","260","58","133","206","393","1"
"1","2017","31","Otros","12","27","1","1","24","24","25","25","3.4285714285714"
"1","2017","31","Hotel","12","35","71","163","453","1267","524","1430","1"
"1","2017","31","Hotel","2","27","372","728","56","233","428","961","1"
"1","2017","31","Hotel","10","27","38","124","96","264","134","388","1"
"1","2017","31","Hotel","2","6","48","911","0","0","48","911","1"
"1","2017","31","Otros","2","6","27","48","0","0","27","48","1"
"1","2017","31","Hotel","4","39","272","272","0","0","272","272","1"
"1","2017","31","Otros","16","27","25","38","0","0","25","38","1"
"1","2017","31","Hotel","6","10","1445","1875","32","50","1477","1925","1"
"1","2017","31","Hotel","8","3","11","30","134","491","145","521","1"
"1","2017","31","Otros","5","8","22","29","25","34","47","63","5"
"1","2017","31","Hotel","13","33","535","1008","470","593","1005","1601","1"
"1","2017","31","Hotel","13","33","171","228","58","116","229","344","1"
"1","2017","31","Otros","11","32","170","537","59","116","229","653","2.2857142857143"
"1","2017","31","Hotel","9","26","96","274","0","0","96","274","1"
"1","2017","31","Hotel","16","20","117","240","24","50","141","290","1"
"1","2017","31","Hotel","9","37","239","305","2","2","241","307","1"
"1","2017","31","Otros","16","20","11","15","29","33","40","48","3.0769230769231"
"1","2017","31","","16","40","839","2615","230","1380","1069","3995","1"
"1","2017","31","Hotel","12","24","220","235","4197","5732","4417","5967","1"
"1","2017","31","Hotel","15","16","1297","3203","849","3883","2146","7086","1"
"1","2017","31","Hotel","5","9","13","13","28","37","41","50","1"
"1","2017","31","Otros","7","38","88","665","1","1","89","666","2.75"
"1","2017","31","Otros","2","6","176","1234","0","0","176","1234","1"
"1","2017","31","Otros","2","6","66","145","0","0","66","145","1"
"1","2017","31","Hotel","12","24","209","409","1660","4082","1869","4491","1"
"1","2017","0","Hotel","8","34","0","0","0","0","0","0","1"
"1","2017","31","Hotel","15","27","311","750","97","99","408","849","1"
"1","2017","31","Otros","7","38","112","223","0","0","112","223","2.75"
"1","2017","31","Otros","2","1","7","70","14","28","21","98","1"
"1","2017","31","Otros","8","3","147","317","36","55","183","372","10"
"1","2017","31","Hotel","12","35","18","44","176","352","194","396","2"
"1","2017","31","Otros","11","36","36","74","0","0","36","74","5.1904761904762"
"1","2017","31","Otros","16","20","45","91","0","0","45","91","3.0769230769231"
"1","2017","31","Otros","8","3","468","815","8","14","476","829","1"
"1","2017","31","Otros","4","39","33","50","0","0","33","50","2.2222222222222"
"1","2017","31","Otros","5","5","40","88","53","143","93","231","3.65625"
"1","2017","31","Otros","12","27","15","67","42","42","57","109","3.4285714285714"
"1","2017","31","Otros","7","27","42","311","30","175","72","486","1"
"1","2017","31","Hotel","2","6","28","28","97","103","125","131","1"
"1","2017","31","Otros","12","24","15","25","90","123","105","148","1"
"1","2017","31","Hotel","14","27","109","213","150","211","259","424","1"
"1","2017","31","Hotel","16","19","292","817","41","305","333","1122","1"
"1","2017","31","","2","1","60","480","0","0","60","480","1"
"1","2017","31","Hotel","2","27","72","159","8","11","80","170","1"
"1","2017","31","Otros","16","20","263","458","43","147","306","605","1"
"1","2017","31","Otros","13","14","23","31","2","6","25","37","1"
"1","2017","31","Hotel","11","36","105","161","18","22","123","183","2.375"
"1","2017","31","Otros","13","14","46","461","0","0","46","461","7.3846153846154"
"1","2017","31","Otros","12","27","28","45","0","0","28","45","3.4285714285714"
"1","2017","31","Hotel","2","6","262","446","111","132","373","578","2.2"
"1","2017","31","Otros","2","6","156","1214","0","0","156","1214","1"
"1","2017","31","Otros","10","27","18","107","0","0","18","107","4.84"
"1","2017","31","Otros","12","27","8","8","7","7","15","15","3.4285714285714"
"1","2017","31","Otros","13","14","175","175","0","0","175","175","7.3846153846154"
"1","2017","30","Otros","6","12","81","197","25","104","106","301","1.8256578947368"
"1","2017","31","Otros","2","6","688","1029","78","185","766","1214","1"
"1","2017","31","Hotel","16","40","200","297","0","0","200","297","1"
"1","2017","31","Hotel","12","35","106","188","307","512","413","700","1.7272727272727"
"1","2017","31","Otros","5","5","22","46","13","16","35","62","3.65625"
"1","2017","31","Otros","11","32","23","77","16","40","39","117","1"
"1","2017","31","Otros","9","30","4","124","2","62","6","186","2.3333333333333"
"1","2017","31","Otros","11","15","6","36","0","0","6","36","1"
"1","2017","31","Hotel","8","2","6","13","19","30","25","43","1"
"1","2017","31","Otros","9","30","8","12","0","0","8","12","2.3333333333333"
"1","2017","31","Otros","10","27","114","248","5","10","119","258","3"
"1","2017","31","Hotel","15","27","50","50","2","2","52","52","1"
"1","2017","31","Hotel","3","7","40","325","0","0","40","325","1"
"1","2017","31","Otros","6","12","84","151","0","0","84","151","1.8256578947368"
"1","2017","31","Otros","12","27","25","56","22","30","47","86","3.4285714285714"
"1","2017","31","Otros","2","6","14","44","0","0","14","44","5"
"1","2017","31","Otros","6","27","58","185","0","0","58","185","3.960088691796"
"1","2017","31","Hotel","10","11","108","214","7","15","115","229","1"
"1","2017","31","Otros","2","1","10","80","0","0","10","80","1"
"1","2017","31","Hotel","4","13","3","33","0","0","3","33","1"
"1","2017","31","Otros","11","36","56","56","7","7","63","63","5.1904761904762"
"1","2017","0","Hotel","11","32","0","0","0","0","0","0","1"
"1","2017","31","Otros","2","27","3","11","0","0","3","11","1"
"1","2017","31","Otros","12","27","4","6","4","4","8","10","3.4285714285714"
"1","2017","31","Hotel","8","2","4","8","0","0","4","8","3"
"1","2017","31","Hotel","16","20","40","91","0","0","40","91","1"
"1","2017","31","Otros","12","35","0","0","132","176","132","176","3.5"
"1","2017","31","Otros","13","14","39","91","7","14","46","105","1"
"1","2017","31","Hotel","16","19","81","149","0","0","81","149","1"
"1","2017","31","Otros","2","27","41","233","0","0","41","233","3.2"
"1","2017","31","Hotel","6","27","30","30","0","0","30","30","3"
"1","2017","31","Hotel","8","3","166","509","96","243","262","752","4.1111111111111"
"1","2017","31","Hotel","12","24","76","162","275","466","351","628","1"
"1","2017","31","Hotel","15","27","122","141","10","10","132","151","1"
"1","2017","31","Otros","8","3","168","493","49","98","217","591","10"
"1","2017","31","Hotel","16","20","80","380","65","319","145","699","1"
"1","2017","31","Hotel","6","28","152","204","0","0","152","204","2.4"
"1","2017","31","Otros","7","17","135","580","34","299","169","879","3"
"1","2017","31","Otros","2","1","45","117","19","32","64","149","5.5"
"1","2017","31","Hotel","11","36","123","203","272","381","395","584","2.375"
"1","2017","31","Otros","4","13","169","894","0","0","169","894","1"
"1","2017","31","Hotel","12","35","70","168","155","233","225","401","2"
"1","2017","31","Otros","2","6","305","2138","0","0","305","2138","1"
"1","2017","31","Otros","8","34","41","58","69","97","110","155","5.75"
"1","2017","31","Hotel","11","15","8","22","0","0","8","22","1"
"1","2017","31","Otros","12","27","36","64","21","39","57","103","1"
"1","2017","31","Otros","15","27","4","4","0","0","4","4","1.4222222222222"
"1","2017","31","Otros","16","40","66","95","48","103","114","198","1"
"1","2017","31","Otros","12","27","4","4","1","3","5","7","1"
"1","2017","31","Hotel","13","14","268","412","30","52","298","464","1"
"1","2017","31","Otros","3","4","40","40","39","40","79","80","1"
"1","2017","31","Hotel","13","14","140","323","82","172","222","495","1"
"1","2017","31","Hotel","9","30","73","106","32","66","105","172","1"
"1","2017","31","Hotel","4","13","256","455","198","328","454","783","5.4"
"1","2017","31","Otros","6","27","14","24","0","0","14","24","3.960088691796"
"1","2017","20","Hotel","15","27","10","26","14","20","24","46","1"
"1","2017","31","Hotel","2","29","15","80","103","363","118","443","2"
"1","2017","31","Hotel","13","33","17","27","50","94","67","121","2"
"1","2017","31","Hotel","12","35","106","188","307","512","413","700","1.7272727272727"
"1","2017","31","Hotel","13","14","524","1087","35","85","559","1172","1"
"1","2017","31","Otros","6","25","150","351","0","0","150","351","2.3846153846154"
"1","2017","31","Hotel","8","2","11","18","14","21","25","39","3"
"1","2017","31","Otros","2","29","17","57","81","237","98","294","1"
"1","2017","31","Otros","4","39","66","121","0","0","66","121","2.2222222222222"
"1","2017","31","Otros","6","12","130","175","31","36","161","211","1.8256578947368"
"1","2017","31","Otros","13","33","115","189","4","4","119","193","1"
"1","2017","31","Otros","13","33","53","69","18","34","71","103","5.125"
"1","2017","31","Hotel","4","13","90","233","37","116","127","349","5.4"
"1","2017","31","Otros","12","24","22","42","63","88","85","130","1"
"1","2017","31","Hotel","7","27","145","179","0","0","145","179","4.1666666666667"
"1","2017","31","Hotel","4","13","619","1710","233","237","852","1947","1"
"1","2017","31","","5","8","10","12","23","30","33","42","1"
"1","2017","31","Otros","8","2","112","246","57","88","169","334","6.4285714285714"
"1","2017","31","Otros","6","27","149","413","0","0","149","413","3.6666666666667"
"1","2017","31","Otros","2","6","37","37","64","64","101","101","1"
"1","2017","31","","6","10","45","157","0","0","45","157","1"
"1","2017","31","Hotel","2","29","45","65","104","160","149","225","2"
"1","2017","31","","14","31","76","153","595","1916","671","2069","1"
"1","2017","31","Hotel","16","27","7388","22165","0","0","7388","22165","1"
"1","2017","31","Hotel","12","35","69","163","121","292","190","455","1.7272727272727"
"1","2017","31","","12","35","3155","3701","4371","4818","7526","8519","1"
"1","2017","31","","9","26","20","129","0","0","20","129","1"
"1","2017","31","Otros","11","32","214","368","0","0","214","368","2.2857142857143"
"1","2017","31","Otros","12","24","69","134","136","202","205","336","9.2"
"1","2017","31","Hotel","6","25","17","29","0","0","17","29","1"
"1","2017","31","Otros","7","17","44","214","5","35","49","249","3"
"1","2017","27","Otros","11","32","55","103","26","30","81","133","2.2857142857143"
"1","2017","31","Hotel","16","19","211","359","2","3","213","362","4"
"1","2017","31","Otros","8","3","53","237","23","79","76","316","14.75"
"1","2017","31","Hotel","7","17","11","13","0","0","11","13","1"
"1","2017","31","Otros","13","33","24","24","0","0","24","24","5.125"
"1","2017","31","Otros","16","27","30","96","1","1","31","97","13.818181818182"
"1","2017","31","Otros","6","12","123","190","4","16","127","206","1.8256578947368"
"1","2017","30","Otros","2","29","25","85","8","8","33","93","3.28"
"1","2017","31","Hotel","14","27","183","199","53","53","236","252","1"
"1","2017","31","Otros","2","1","1","1","0","0","1","1","1"
"1","2017","31","Otros","11","32","56","56","0","0","56","56","2.2857142857143"
"1","2017","31","Otros","2","27","4","8","0","0","4","8","1"
"1","2017","31","Hotel","2","29","152","606","80","196","232","802","1"
"1","2017","31","Hotel","4","13","55","367","0","0","55","367","3.2"
"1","2017","31","Hotel","4","21","91","1049","0","0","91","1049","3"
"1","2017","31","Otros","7","27","243","484","0","0","243","484","4.8333333333333"
"1","2017","31","","3","4","77","150","56","118","133","268","1"
"1","2017","31","Hotel","6","27","11","26","17","27","28","53","3"
"1","2017","31","Otros","16","19","79","130","0","0","79","130","10.263157894737"
"1","2017","31","Otros","11","32","1","2","0","0","1","2","2.2857142857143"
"1","2017","31","Otros","3","7","46","68","60","104","106","172","2"
"1","2017","31","Otros","5","5","30","54","17","34","47","88","3.65625"
"1","2017","24","Otros","15","27","1008","1008","0","0","1008","1008","1.4222222222222"
"1","2017","31","Otros","6","25","238","520","0","0","238","520","2.3846153846154"
"1","2017","31","","10","27","60","185","24","42","84","227","1"
"1","2017","31","Otros","2","29","51","89","196","292","247","381","3.28"
"1","2017","31","Otros","12","35","33","45","60","109","93","154","3.5"
"1","2017","31","Otros","16","19","85","272","0","0","85","272","10.263157894737"
"1","2017","31","Otros","9","26","32","133","0","0","32","133","3.8888888888889"
"1","2017","31","Hotel","13","33","20","20","93","93","113","113","2"
"1","2017","31","Otros","11","32","27","86","4","14","31","100","2.2857142857143"
"1","2017","31","Otros","9","22","41","65","0","0","41","65","7.6428571428571"
"1","2017","31","Otros","6","27","2","62","0","0","2","62","3.960088691796"
"1","2017","31","Otros","15","27","88","104","0","0","88","104","1.4222222222222"
"1","2017","31","Otros","11","32","82","84","7","7","89","91","2.2857142857143"
"1","2017","31","Otros","11","15","56","145","10","33","66","178","2.3571428571429"
"1","2017","31","Otros","9","37","13","24","0","0","13","24","4.5"
"1","2017","31","Otros","5","9","14","17","9","14","23","31","4.0454545454545"
"1","2017","31","Hotel","10","27","12","34","0","0","12","34","2.25"
"1","2017","31","Otros","6","28","22","39","0","0","22","39","4.65"
"1","2017","31","Otros","4","13","26","33","28","31","54","64","3.4"
"1","2017","31","Otros","2","1","1","1","0","0","1","1","1"
"1","2017","31","Otros","2","29","38","77","65","157","103","234","3.28"
"1","2017","31","Hotel","8","3","97","255","48","78","145","333","4.1111111111111"
"1","2017","31","Otros","16","19","242","920","0","0","242","920","1.3333333333333"
"1","2017","31","Otros","12","35","2","2","14","30","16","32","3.5"
"1","2017","31","Hotel","12","35","39","67","261","345","300","412","1.7272727272727"
"1","2017","31","Otros","12","35","41","53","28","33","69","86","3.5"
"1","2017","31","Otros","2","29","46","84","98","161","144","245","3.28"
"1","2017","31","Hotel","7","27","172","259","16","16","188","275","1"
"1","2017","31","Hotel","9","22","64","92","0","0","64","92","2.5555555555556"
"1","2017","31","Hotel","12","35","48","82","234","358","282","440","1.7272727272727"
"1","2017","31","Otros","15","16","183","369","94","272","277","641","2"
"1","2017","31","Hotel","15","27","4","8","0","0","4","8","1"
"1","2017","31","Otros","4","13","6","6","0","0","6","6","3.4"
"1","2017","31","Hotel","8","34","78","148","102","210","180","358","2.5714285714286"
"1","2017","31","Hotel","16","20","300","300","0","0","300","300","1"
"1","2017","31","Hotel","6","28","228","228","186","186","414","414","2.4"
"1","2017","31","Hotel","15","27","96","186","32","42","128","228","1"
"1","2017","31","Otros","12","35","128","404","169","356","297","760","3.5"
"1","2017","31","Otros","11","15","50","90","0","0","50","90","2.3571428571429"
"1","2017","31","Otros","11","15","134","614","11","120","145","734","2.3571428571429"
"1","2017","31","Otros","11","36","111","217","131","198","242","415","5.1904761904762"
"1","2017","31","Hotel","11","36","38","92","34","86","72","178","2.375"
"1","2017","31","Hotel","6","12","85","234","0","0","85","234","5"
"1","2017","31","Otros","8","3","129","203","69","105","198","308","10"
"1","2017","31","Otros","10","27","3","8","60","104","63","112","4.84"
"1","2017","31","Otros","8","3","17","41","39","167","56","208","10"
"1","2017","31","Otros","6","25","96","216","0","0","96","216","2.3846153846154"
"1","2017","31","Hotel","2","27","90","131","0","0","90","131","1"
"1","2017","31","Hotel","10","18","75","375","174","522","249","897","3.2"
"1","2017","31","Otros","11","32","217","1124","0","0","217","1124","1"
"1","2017","31","Hotel","6","10","1054","1250","885","1406","1939","2656","1"
"1","2017","31","Otros","4","13","171","176","53","59","224","235","1"
"1","2017","31","Otros","11","32","78","182","9","18","87","200","2.2857142857143"
"1","2017","0","Otros","2","27","0","0","0","0","0","0","1"
"1","2017","31","Otros","4","13","50","100","0","0","50","100","1"
"1","2017","31","","12","24","180","242","1166","1567","1346","1809","1"
"1","2017","31","Hotel","16","27","624","992","0","0","624","992","5.8571428571429"
"1","2017","31","Hotel","7","38","53","280","0","0","53","280","1"
"1","2017","31","Hotel","6","12","375","378","0","0","375","378","1"
"2","2017","28","Hotel","14","31","2637","4533","6281","8519","8918","13052","1"
"2","2017","28","Hotel","14","31","361","536","1793","5818","2154","6354","1"
"2","2017","28","Hotel","14","31","872","1902","2886","7871","3758","9773","1"
"2","2017","28","Hotel","11","32","200","272","24","69","224","341","1"
"2","2017","28","Hotel","14","27","2485","4364","510","894","2995","5258","1"
"2","2017","28","Otros","11","32","134","230","0","0","134","230","2.2857142857143"
"2","2017","28","Hotel","14","31","278","488","2662","4454","2940","4942","5.4"
"2","2017","28","Hotel","15","16","1335","5450","142","588","1477","6038","1"
"2","2017","28","Hotel","14","31","1227","2552","1091","3475","2318","6027","5.4"
"2","2017","28","Hotel","12","24","3870","5107","2702","4751","6572","9858","1"
"2","2017","28","Hotel","16","40","909","2351","886","2074","1795","4425","1"
"2","2017","28","Hotel","6","12","1166","1654","101","267","1267","1921","1"
"2","2017","28","Hotel","10","23","1465","1861","676","1287","2141","3148","1"
"2","2017","28","Hotel","14","31","1216","3196","248","571","1464","3767","5.4"
"2","2017","28","Hotel","3","4","737","2127","251","1031","988","3158","1"
"2","2017","28","","11","32","678","1128","90","173","768","1301","1"
"2","2017","28","Hotel","6","12","600","1143","128","285","728","1428","1"
"2","2017","28","Hotel","6","12","1836","2646","375","515","2211","3161","1"
"2","2017","28","Hotel","9","26","2762","5678","55","112","2817","5790","1"
"2","2017","28","Hotel","2","1","393","2492","61","353","454","2845","1"
"2","2017","28","Hotel","9","26","653","1247","323","1567","976","2814","1"
"2","2017","28","Hotel","6","12","350","569","76","149","426","718","1"
"2","2017","28","Hotel","14","31","27","38","4175","7112","4202","7150","5.4"
"2","2017","28","Hotel","11","32","634","898","116","241","750","1139","1"
"2","2017","28","Hotel","2","6","1012","1638","353","701","1365","2339","1"
"2","2017","28","Hotel","16","40","1884","3311","1700","3178","3584","6489","1"
"2","2017","28","Hotel","14","27","698","1544","724","1972","1422","3516","1"
"2","2017","28","Otros","11","36","454","1294","34","88","488","1382","1"
"2","2017","28","Hotel","10","23","1324","2773","1001","2170","2325","4943","1"
"2","2017","28","Hotel","14","31","113","421","605","2668","718","3089","7.8"
"2","2017","28","Hotel","7","17","545","1861","409","1304","954","3165","1"
"2","2017","28","Hotel","2","1","2093","2712","328","375","2421","3087","2"
"2","2017","28","Hotel","2","1","2218","3703","445","1195","2663","4898","2"
"2","2017","28","Hotel","4","13","857","1496","346","540","1203","2036","1"
"2","2017","28","Hotel","2","1","1898","2136","142","182","2040","2318","2"
"2","2017","28","Hotel","10","27","2640","5653","381","752","3021","6405","1"
"2","2017","28","Hotel","14","27","1594","1807","1097","1645","2691","3452","1"
"2","2017","28","Hotel","14","27","1980","2708","999","1682","2979","4390","1"
"2","2017","28","Hotel","6","12","1119","2775","59","161","1178","2936","1"
"2","2017","28","Hotel","6","12","1328","2229","763","1029","2091","3258","1"
"2","2017","28","Hotel","13","27","2762","7836","6","14","2768","7850","1"
"2","2017","28","Hotel","14","31","205","416","886","2623","1091","3039","7.8"
"2","2017","28","Hotel","6","12","1100","1963","229","407","1329","2370","1"
"2","2017","28","Hotel","16","27","1240","2800","260","390","1500","3190","1"
"2","2017","28","","10","27","563","1093","69","192","632","1285","1"
"2","2017","28","Hotel","10","18","980","1971","720","2647","1700","4618","1"
"2","2017","28","Hotel","9","37","1832","3305","437","1111","2269","4416","1"
"2","2017","28","Hotel","16","27","3337","8789","0","0","3337","8789","1"
"2","2017","28","Hotel","15","16","1019","2555","338","1272","1357","3827","2"
"2","2017","28","Hotel","2","1","1302","2236","267","456","1569","2692","2"
"2","2017","28","Hotel","3","4","584","1965","226","480","810","2445","1"
"2","2017","28","Hotel","16","40","1908","2844","917","1690","2825","4534","1"
"2","2017","28","Hotel","7","17","3259","4487","514","644","3773","5131","1"
"2","2017","28","Hotel","12","24","907","1498","2844","3693","3751","5191","1"
"2","2017","28","Hotel","12","35","782","2056","2282","3305","3064","5361","1"
"2","2017","28","Hotel","2","6","335","515","192","236","527","751","1"
"2","2017","28","Hotel","13","33","1285","2011","518","1220","1803","3231","1"
"2","2017","28","Hotel","10","27","1741","2457","1222","1903","2963","4360","1"
"2","2017","28","Hotel","10","23","1375","2112","262","457","1637","2569","1"
"2","2017","28","Hotel","11","36","1634","3150","449","1178","2083","4328","1"
"2","2017","28","Hotel","8","34","1410","1886","98","275","1508","2161","1"
"2","2017","28","Hotel","2","6","654","1506","136","272","790","1778","1"
"2","2017","28","Hotel","14","31","298","439","1157","1831","1455","2270","7.8"
"2","2017","28","Hotel","11","36","2382","4447","297","428","2679","4875","1"
"2","2017","28","","10","27","0","0","456","992","456","992","1"
"2","2017","28","Hotel","14","31","1020","1361","2404","5809","3424","7170","5.4"
"2","2017","28","Hotel","4","13","2299","2313","4","8","2303","2321","1"
"2","2017","28","Hotel","6","28","1208","1480","108","175","1316","1655","1"
"2","2017","28","Otros","14","31","48","85","347","506","395","591","2.8"
"2","2017","28","Otros","16","27","30","60","0","0","30","60","2"
"2","2017","28","Hotel","2","1","905","1499","138","284","1043","1783","2"
"2","2017","28","Hotel","10","18","2054","3006","1152","1549","3206","4555","1"
"2","2017","28","Hotel","7","17","1033","4170","330","678","1363","4848","1"
"2","2017","28","Hotel","12","24","532","1529","765","2274","1297","3803","1"
"2","2017","28","Hotel","10","18","1771","3797","521","1018","2292","4815","1"
"2","2017","28","Hotel","2","1","2782","3574","53","133","2835","3707","1"
"2","2017","28","Hotel","10","18","1194","1631","383","770","1577","2401","1"
"2","2017","28","Hotel","6","28","1908","3391","180","262","2088","3653","1"
"2","2017","28","Hotel","5","5","220","327","1156","2010","1376","2337","1"
"2","2017","28","Hotel","4","13","600","854","51","68","651","922","1"
"2","2017","28","Hotel","10","18","1698","2297","1481","1879","3179","4176","1"
"2","2017","28","Hotel","16","40","1383","2503","550","1056","1933","3559","1"
"2","2017","28","Hotel","8","3","1331","3045","422","942","1753","3987","1"
"2","2017","28","Hotel","15","16","1692","3526","474","1006","2166","4532","2"
"2","2017","28","Hotel","14","31","63","144","261","690","324","834","7.8"
"2","2017","28","Hotel","13","33","80","105","229","1110","309","1215","1"
"2","2017","28","Hotel","15","16","747","1939","456","1863","1203","3802","2"
"2","2017","28","Otros","4","21","871","1258","12","32","883","1290","1"
"2","2017","28","Hotel","6","10","785","1925","19","47","804","1972","1"
"2","2017","28","Hotel","16","19","839","1821","105","228","944","2049","1"
"2","2017","28","Hotel","16","27","1506","3916","20","37","1526","3953","1"
"2","2017","28","Hotel","10","11","3650","4311","217","407","3867","4718","1"
"2","2017","28","Otros","10","23","728","1633","101","255","829","1888","1"
"2","2017","28","Hotel","12","35","185","545","422","978","607","1523","1"
"2","2017","28","Hotel","11","36","824","1581","554","961","1378","2542","1"
"2","2017","28","Hotel","14","31","73","283","137","1484","210","1767","17.4"
"2","2017","28","Hotel","10","18","689","2017","766","1844","1455","3861","3.2"
"2","2017","28","Hotel","4","13","698","1003","165","329","863","1332","1"
"2","2017","28","Hotel","6","12","432","587","104","222","536","809","5"
"2","2017","28","Hotel","6","10","558","833","72","103","630","936","1"
"2","2017","28","Otros","5","5","402","609","284","430","686","1039","3.65625"
"2","2017","28","Hotel","12","24","1057","1167","1258","1761","2315","2928","1"
"2","2017","28","Hotel","8","3","1573","3659","199","413","1772","4072","1"
"2","2017","25","Hotel","13","27","910","2276","0","0","910","2276","2.75"
"2","2017","28","Hotel","15","16","208","946","219","923","427","1869","4"
"2","2017","28","Otros","15","16","303","975","220","1167","523","2142","2"
"2","2017","28","Otros","16","20","961","2800","104","322","1065","3122","1"
"2","2017","28","Hotel","3","4","806","2466","18","18","824","2484","1"
"2","2017","28","Hotel","11","36","217","256","0","0","217","256","1"
"2","2017","28","Hotel","2","6","226","468","155","220","381","688","1"
"2","2017","28","Hotel","8","34","848","1486","173","304","1021","1790","1"
"2","2017","28","Hotel","4","13","299","378","19","42","318","420","3.2"
"2","2017","28","Hotel","13","27","1158","2561","0","0","1158","2561","2.75"
"2","2017","28","Hotel","2","29","374","682","780","1377","1154","2059","1"
"2","2017","28","Otros","11","36","155","460","4","12","159","472","1"
"2","2017","28","Otros","7","17","484","1322","4","4","488","1326","1"
"2","2017","28","","10","11","21","21","0","0","21","21","1"
"2","2017","28","Hotel","4","13","832","1231","83","239","915","1470","1"
"2","2017","28","Hotel","16","40","2263","3397","946","1421","3209","4818","5.6666666666667"
"2","2017","28","Hotel","10","23","675","1187","878","1928","1553","3115","2.8"
"2","2017","28","Hotel","8","34","520","784","740","1462","1260","2246","1"
"2","2017","28","Hotel","5","5","523","1639","300","600","823","2239","1"
"2","2017","28","Hotel","3","4","106","211","128","262","234","473","3"
"2","2017","28","Hotel","9","26","71","177","15","38","86","215","1"
"2","2017","28","Hotel","8","34","555","740","533","942","1088","1682","1"
"2","2017","28","Hotel","7","17","518","1047","231","869","749","1916","4"
"2","2017","28","Hotel","4","13","176","507","38","118","214","625","3.2"
"2","2017","28","Hotel","12","35","39","137","534","1927","573","2064","1"
"2","2017","28","Hotel","16","40","2249","4371","2640","5324","4889","9695","1"
"2","2017","28","Hotel","9","26","475","977","93","362","568","1339","1"
"2","2017","28","","6","27","209","319","26","119","235","438","1"
"2","2017","28","Hotel","9","26","399","689","4","6","403","695","1"
"2","2017","28","Hotel","4","13","108","140","129","217","237","357","3.2"
"2","2017","28","Hotel","6","28","2224","2620","105","116","2329","2736","1"
"2","2017","28","","2","29","67","168","595","1944","662","2112","1"
"2","2017","28","Hotel","16","19","317","563","0","0","317","563","1"
"2","2017","28","Hotel","13","33","952","1391","155","317","1107","1708","1"
"2","2017","28","Hotel","8","3","606","1437","198","450","804","1887","1"
"2","2017","28","Hotel","14","27","235","328","768","1038","1003","1366","1"
"2","2017","28","Hotel","16","40","677","1114","19","44","696","1158","5.6666666666667"
"2","2017","28","Hotel","12","24","315","618","494","837","809","1455","1"
"2","2017","28","Hotel","10","18","2015","2510","238","398","2253","2908","3.2"
"2","2017","28","Otros","15","16","189","199","9","9","198","208","9"
"2","2017","28","Hotel","6","10","938","1039","0","0","938","1039","1"
"2","2017","28","Hotel","10","11","809","1777","175","368","984","2145","1"
"2","2017","28","Otros","6","10","26","40","0","0","26","40","3.8518518518518"
"2","2017","28","Otros","10","23","192","1207","0","0","192","1207","1"
"2","2017","28","Otros","8","2","65","140","9","27","74","167","1"
"2","2017","28","Otros","10","11","80","128","70","111","150","239","1"
"2","2017","28","Hotel","10","23","500","842","663","1077","1163","1919","2.8"
"2","2017","28","Hotel","6","12","292","426","0","0","292","426","5"
"2","2017","28","Hotel","6","27","332","825","4","8","336","833","3"
"2","2017","28","Hotel","10","23","389","775","468","1167","857","1942","2.8"
"2","2017","28","","4","39","268","544","0","0","268","544","1"
"2","2017","28","Hotel","8","34","292","355","965","1341","1257","1696","1"
"2","2017","28","Hotel","8","34","647","894","543","744","1190","1638","1"
"2","2017","28","Otros","4","39","20","34","0","0","20","34","2.2222222222222"
"2","2017","28","Otros","13","14","191","382","0","0","191","382","1"
"2","2017","28","Hotel","10","23","890","1457","187","274","1077","1731","2.8"
"2","2017","28","Otros","13","14","291","752","12","12","303","764","1"
"2","2017","28","Hotel","12","24","508","794","547","997","1055","1791","1"
"2","2017","28","","6","25","290","423","0","0","290","423","1"
"2","2017","28","Hotel","15","27","488","919","9","48","497","967","1"
"2","2017","28","Hotel","12","35","198","288","962","1631","1160","1919","1"
"2","2017","28","Hotel","16","40","581","1187","2730","7990","3311","9177","1"
"2","2017","28","Hotel","16","27","74","108","80","135","154","243","1"
"2","2017","28","Hotel","9","30","37","161","0","0","37","161","1"
"2","2017","28","Hotel","4","13","230","389","135","177","365","566","3.2"
"2","2017","28","Hotel","2","29","18","50","308","1040","326","1090","1"
"2","2017","28","Hotel","16","20","1105","1183","621","642","1726","1825","1"
"2","2017","28","Hotel","5","5","457","1467","151","375","608","1842","1"
"2","2017","28","Hotel","13","33","637","1006","74","138","711","1144","1"
"2","2017","28","Otros","16","19","408","816","0","0","408","816","1.3333333333333"
"2","2017","28","Hotel","12","24","199","393","368","972","567","1365","1"
"2","2017","28","","8","2","616","1232","43","77","659","1309","1"
"2","2017","28","Hotel","12","35","7","22","247","1769","254","1791","1"
"2","2017","28","Hotel","16","27","82","91","775","887","857","978","2.5"
"2","2017","28","Otros","9","37","58","78","0","0","58","78","2"
"2","2017","28","Otros","16","27","673","1653","29","83","702","1736","2"
"2","2017","28","Hotel","8","34","577","769","672","1171","1249","1940","1"
"2","2017","28","Otros","8","3","1128","6060","12","56","1140","6116","1"
"2","2017","28","Hotel","7","27","239","399","81","185","320","584","1"
"2","2017","28","Hotel","4","39","345","600","19","19","364","619","1"
"2","2017","28","Hotel","15","16","455","780","288","618","743","1398","4"
"2","2017","28","Hotel","4","39","6","7","2","2","8","9","1"
"2","2017","28","Hotel","4","39","215","322","17","21","232","343","1"
"2","2017","28","Hotel","15","16","162","558","171","966","333","1524","4"
"2","2017","28","Hotel","14","31","32","56","171","623","203","679","17.4"
"2","2017","28","Hotel","8","34","345","418","594","808","939","1226","1"
"2","2017","28","Hotel","6","28","325","392","125","151","450","543","1"
"2","2017","28","Hotel","7","17","293","1329","177","2040","470","3369","4"
"2","2017","28","Otros","7","27","123","369","0","0","123","369","1"
"2","2017","28","Hotel","11","36","1898","2040","84","175","1982","2215","1"
"2","2017","28","Otros","7","17","624","1724","22","56","646","1780","1"
"2","2017","28","Otros","4","21","113","251","2","2","115","253","1"
"2","2017","28","Otros","15","16","157","239","52","103","209","342","2"
"2","2017","28","Otros","7","17","568","2321","59","341","627","2662","3"
"2","2017","28","Hotel","7","38","391","544","18","28","409","572","1"
"2","2017","28","Hotel","16","27","415","570","23","63","438","633","2.5"
"2","2017","28","Hotel","2","6","41","80","91","91","132","171","2.2"
"2","2017","28","Hotel","11","36","561","1000","189","352","750","1352","1"
"2","2017","28","Otros","13","14","7","12","7","9","14","21","1"
"2","2017","28","Hotel","6","28","140","150","30","30","170","180","1"
"2","2017","28","Hotel","6","12","68","110","0","0","68","110","5"
"2","2017","28","Otros","9","22","180","725","0","0","180","725","1"
"2","2017","28","","13","14","411","867","41","94","452","961","2"
"2","2017","28","Hotel","2","29","39","133","593","1564","632","1697","1"
"2","2017","28","Hotel","2","29","43","125","129","486","172","611","1"
"2","2017","28","Otros","4","13","256","281","41","41","297","322","1"
"2","2017","28","Hotel","15","16","135","266","36","69","171","335","4"
"2","2017","28","Hotel","2","1","141","398","6","12","147","410","6.4"
"2","2017","28","Otros","7","27","373","842","0","0","373","842","1"
"2","2017","28","Otros","13","33","168","189","0","0","168","189","5.125"
"2","2017","28","","4","21","1310","1630","155","307","1465","1937","1"
"2","2017","28","Hotel","6","10","362","362","6","6","368","368","1"
"2","2017","28","Hotel","11","36","228","524","30","90","258","614","1"
"2","2017","28","Otros","14","31","175","460","230","380","405","840","2.8"
"2","2017","28","Hotel","7","27","272","562","11","34","283","596","1"
"2","2017","28","Otros","6","10","0","0","28","560","28","560","3.8518518518518"
"2","2017","28","Hotel","4","39","158","299","15","24","173","323","2.6"
"2","2017","28","Otros","8","2","118","348","52","80","170","428","6.4285714285714"
"2","2017","28","Otros","11","36","109","309","20","38","129","347","5.1904761904762"
"2","2017","28","Hotel","13","33","161","161","16","16","177","177","1"
"2","2017","28","Hotel","10","18","113","226","38","50","151","276","1"
"2","2017","28","Otros","9","37","276","621","0","0","276","621","2"
"2","2017","28","","3","4","180","227","54","77","234","304","1"
"2","2017","28","Hotel","7","17","237","623","97","278","334","901","4"
"2","2017","28","Hotel","8","2","468","724","23","44","491","768","1"
"2","2017","0","Otros","9","37","0","0","0","0","0","0","2"
"2","2017","28","Otros","15","16","264","386","71","173","335","559","2"
"2","2017","28","Hotel","10","11","727","1432","5","7","732","1439","1"
"2","2017","28","Hotel","16","19","301","569","0","0","301","569","1"
"2","2017","28","Hotel","10","23","434","499","127","269","561","768","4"
"2","2017","28","","7","38","424","563","85","114","509","677","1"
"2","2017","28","Hotel","7","27","316","425","13","13","329","438","1"
"2","2017","28","Hotel","11","36","595","1625","73","141","668","1766","1"
"2","2017","28","Hotel","16","40","170","351","16","52","186","403","16.333333333333"
"2","2017","28","Hotel","16","19","117","718","23","47","140","765","1"
"2","2017","28","Hotel","12","35","152","354","314","578","466","932","1"
"2","2017","28","Hotel","16","19","245","301","0","0","245","301","1"
"2","2017","28","Hotel","16","20","165","256","0","0","165","256","1"
"2","2017","28","Hotel","10","11","425","745","59","73","484","818","1"
"2","2017","28","Otros","7","27","180","421","9","9","189","430","4.8333333333333"
"2","2017","28","Otros","7","27","14","56","0","0","14","56","1"
"2","2017","28","Hotel","7","27","31","56","0","0","31","56","4.1666666666667"
"2","2017","28","Otros","16","19","217","490","0","0","217","490","1"
"2","2017","28","Otros","13","14","696","1825","8","18","704","1843","1"
"2","2017","28","Otros","11","15","72","182","0","0","72","182","2.3571428571429"
"2","2017","28","Otros","10","27","140","176","112","231","252","407","4.84"
"2","2017","28","Otros","14","31","147","147","2272","2272","2419","2419","2.8"
"2","2017","28","Otros","11","36","81","187","19","30","100","217","5.1904761904762"
"2","2017","28","Hotel","16","19","133","187","8","32","141","219","1"
"2","2017","28","","14","27","202","305","16","20","218","325","2.6666666666667"
"2","2017","28","Hotel","16","40","116","136","18","22","134","158","5.6666666666667"
"2","2017","28","Hotel","10","27","18","29","2","2","20","31","2.25"
"2","2017","28","Otros","2","29","283","522","223","511","506","1033","3.28"
"2","2017","28","Hotel","13","27","0","0","87","109","87","109","1"
"2","2017","28","Otros","9","22","293","436","3","4","296","440","1"
"2","2017","28","Hotel","2","27","180","232","15","15","195","247","1"
"2","2017","28","Hotel","8","34","287","418","680","983","967","1401","1"
"2","2017","28","Hotel","7","27","275","448","0","0","275","448","1"
"2","2017","28","Hotel","15","16","246","702","101","374","347","1076","4"
"2","2017","28","Hotel","16","20","230","443","6","10","236","453","1"
"2","2017","28","Otros","4","13","63","296","0","0","63","296","1"
"2","2017","28","Otros","5","9","195","367","28","60","223","427","1"
"2","2017","28","Hotel","2","1","187","559","2","7","189","566","6.4"
"2","2017","28","Otros","11","32","132","688","0","0","132","688","2.2857142857143"
"2","2017","28","Hotel","2","29","4","27","169","1390","173","1417","1"
"2","2017","28","Hotel","16","27","220","225","95","110","315","335","2.5"
"2","2017","28","Hotel","10","18","267","1006","131","393","398","1399","3.2"
"2","2017","28","Otros","11","36","836","1267","0","0","836","1267","1"
"2","2017","28","Otros","13","14","171","330","14","31","185","361","1"
"2","2017","28","Hotel","7","27","148","210","0","0","148","210","1"
"2","2017","28","Otros","7","17","217","217","21","21","238","238","3"
"2","2017","28","Otros","14","31","164","349","384","659","548","1008","2.8"
"2","2017","28","Hotel","12","35","99","234","259","501","358","735","1"
"2","2017","28","Hotel","2","29","42","145","441","1337","483","1482","1"
"2","2017","28","Hotel","8","3","321","679","256","502","577","1181","1"
"2","2017","28","Hotel","8","34","415","561","221","395","636","956","2.5714285714286"
"2","2017","28","Hotel","8","34","182","291","237","642","419","933","2.5714285714286"
"2","2017","28","Hotel","12","35","159","325","602","836","761","1161","1"
"2","2017","28","Hotel","12","35","101","179","265","415","366","594","1"
"2","2017","28","Hotel","11","32","322","857","59","124","381","981","1"
"2","2017","28","Hotel","13","33","200","421","124","142","324","563","2"
"2","2017","28","Hotel","10","23","210","370","204","327","414","697","2.8"
"2","2017","28","Hotel","12","35","197","557","60","80","257","637","1"
"2","2017","28","","16","40","326","552","353","841","679","1393","3.0555555555556"
"2","2017","28","Otros","16","19","240","398","0","0","240","398","1.3333333333333"
"2","2017","28","Otros","16","20","224","1228","112","896","336","2124","1"
"2","2017","28","Hotel","6","12","144","765","18","22","162","787","5"
"2","2017","28","Hotel","16","19","377","694","18","50","395","744","4"
"2","2017","28","Hotel","12","24","154","427","247","584","401","1011","1"
"2","2017","28","Hotel","12","24","111","161","411","522","522","683","3"
"2","2017","0","Hotel","8","3","0","0","0","0","0","0","1"
"2","2017","28","Hotel","5","9","13","20","7","10","20","30","1"
"2","2017","28","Hotel","16","27","160","279","15","26","175","305","2.5"
"2","2017","28","Otros","10","23","67","67","0","0","67","67","7"
"2","2017","28","Otros","13","14","338","855","0","0","338","855","7.3846153846154"
"2","2017","28","Otros","2","6","106","435","20","43","126","478","1"
"2","2017","1","Hotel","15","16","2","2","15","15","17","17","7.8"
"2","2017","28","Hotel","8","3","207","436","7","9","214","445","1"
"2","2017","28","Hotel","8","34","376","457","303","678","679","1135","1"
"2","2017","28","Hotel","8","3","222","640","111","220","333","860","1"
"2","2017","28","","2","29","143","255","45","145","188","400","1"
"2","2017","28","Hotel","2","1","198","366","32","52","230","418","6.4"
"2","2017","28","Hotel","7","17","250","417","109","159","359","576","4"
"2","2017","28","Otros","7","17","253","1367","32","206","285","1573","3"
"2","2017","28","Hotel","16","40","143","273","281","622","424","895","5.6666666666667"
"2","2017","28","Hotel","12","24","213","396","576","872","789","1268","1"
"2","2017","28","Hotel","14","31","153","232","251","663","404","895","17.4"
"2","2017","0","Hotel","9","26","0","0","0","0","0","0","1"
"2","2017","28","Hotel","6","12","40","69","0","0","40","69","5"
"2","2017","28","Otros","5","9","37","57","43","68","80","125","4.0454545454545"
"2","2017","28","Otros","5","9","22","24","20","30","42","54","4.0454545454545"
"2","2017","28","Otros","15","27","256","422","0","0","256","422","1.4222222222222"
"2","2017","28","Hotel","8","34","1","1","2","2","3","3","2.5714285714286"
"2","2017","28","Hotel","10","18","464","995","168","444","632","1439","7.75"
"2","2017","28","Hotel","15","16","323","352","229","463","552","815","7.8"
"2","2017","28","Hotel","2","29","41","141","294","925","335","1066","1"
"2","2017","28","Hotel","4","39","108","187","12","34","120","221","2.6"
"2","2017","28","Otros","4","39","186","296","0","0","186","296","2.2222222222222"
"2","2017","28","Hotel","4","13","149","232","150","281","299","513","5.4"
"2","2017","28","Otros","10","23","119","156","0","0","119","156","7"
"2","2017","28","Otros","14","31","61","107","593","1202","654","1309","20.2"
"2","2017","28","Hotel","3","4","246","423","66","113","312","536","2.6"
"2","2017","28","Hotel","10","23","217","299","105","172","322","471","4"
"2","2017","28","Otros","9","22","414","1384","0","0","414","1384","1"
"2","2017","28","Hotel","12","24","104","212","527","733","631","945","3"
"2","2017","28","Hotel","13","14","29","51","15","22","44","73","1"
"2","2017","28","Hotel","12","35","182","356","396","611","578","967","1.7272727272727"
"2","2017","28","Hotel","6","28","435","641","0","0","435","641","1"
"2","2017","28","","6","28","73","292","0","0","73","292","1"
"2","2017","28","Hotel","12","24","434","768","277","587","711","1355","3"
"2","2017","28","Otros","5","9","15","24","15","27","30","51","4.0454545454545"
"2","2017","28","Hotel","16","20","156","198","5","6","161","204","1"
"2","2017","28","Hotel","4","21","334","1159","78","140","412","1299","3"
"2","2017","28","Otros","10","11","128","203","11","18","139","221","11.764705882353"
"2","2017","28","Otros","13","14","245","490","0","0","245","490","7.3846153846154"
"2","2017","28","Otros","6","27","207","547","0","0","207","547","1"
"2","2017","28","Otros","16","27","208","658","0","0","208","658","13.818181818182"
"2","2017","28","Hotel","9","26","237","455","27","59","264","514","1"
"2","2017","28","Hotel","16","27","731","833","500","694","1231","1527","2.5"
"2","2017","28","Hotel","3","4","381","648","227","417","608","1065","3"
"2","2017","28","Otros","16","27","220","220","0","0","220","220","2"
"2","2017","28","Otros","16","19","894","4508","0","0","894","4508","1.3333333333333"
"2","2017","28","Hotel","6","12","582","822","12","12","594","834","5"
"2","2017","28","Hotel","2","1","243","641","27","35","270","676","6.4"
"2","2017","28","Hotel","10","11","653","1141","107","170","760","1311","1"
"2","2017","28","Otros","10","23","91","193","8","8","99","201","1"
"2","2017","28","Otros","10","27","688","739","486","547","1174","1286","4.84"
"2","2017","28","Hotel","16","27","168","308","17","31","185","339","2.5"
"2","2017","28","Hotel","6","28","250","305","72","91","322","396","1"
"2","2017","28","Hotel","4","13","88","225","78","150","166","375","5.4"
"2","2017","28","Hotel","14","27","501","748","41","41","542","789","8.5"
"2","2017","28","Hotel","10","27","183","221","675","873","858","1094","1"
"2","2017","28","Hotel","13","27","141","211","79","123","220","334","4.2"
"2","2017","28","Hotel","3","4","700","974","36","55","736","1029","3"
"2","2017","28","Otros","4","13","291","305","21","21","312","326","3.4"
"2","2017","28","Otros","11","15","86","153","0","0","86","153","2.3571428571429"
"2","2017","28","Otros","6","10","137","822","0","0","137","822","3.8518518518518"
"2","2017","28","Otros","2","1","138","192","29","52","167","244","1"
"2","2017","28","","6","12","91","314","0","0","91","314","1"
"2","2017","28","Otros","10","23","227","698","53","141","280","839","1"
"2","2017","28","Hotel","16","19","192","362","0","0","192","362","4"
"2","2017","28","Hotel","10","11","29","94","48","134","77","228","5.6666666666667"
"2","2017","28","Hotel","10","23","192","211","55","64","247","275","4"
"2","2017","28","Otros","14","31","39","196","236","680","275","876","2.8"
"2","2017","28","Otros","13","27","6","6","0","0","6","6","12.2"
"2","2017","28","Hotel","2","1","445","1626","22","154","467","1780","6.4"
"2","2017","28","Hotel","16","19","168","259","0","0","168","259","4"
"2","2017","28","Otros","12","35","91","124","42","58","133","182","3.5"
"2","2017","28","Otros","15","16","193","704","94","288","287","992","2"
"2","2017","28","Otros","9","22","616","1232","219","433","835","1665","1"
"2","2017","28","Hotel","10","27","298","411","1294","1576","1592","1987","1"
"2","2017","28","Hotel","2","27","185","234","20","27","205","261","3.6"
"2","2017","28","Hotel","16","20","106","284","40","126","146","410","1"
"2","2017","28","Hotel","10","18","0","0","16","73","16","73","7.75"
"2","2017","28","Hotel","6","12","311","315","0","0","311","315","5"
"2","2017","28","Hotel","2","27","76","281","0","0","76","281","3.6"
"2","2017","28","Hotel","15","16","248","607","24","52","272","659","7.8"
"2","2017","28","Hotel","10","23","96","96","73","73","169","169","4"
"2","2017","28","Hotel","11","32","318","492","52","60","370","552","1"
"2","2017","28","Hotel","14","27","157","331","50","195","207","526","8.5"
"2","2017","28","Otros","16","19","82","134","0","0","82","134","4"
"2","2017","28","Otros","10","11","265","484","3","4","268","488","11.764705882353"
"2","2017","28","Otros","13","14","86","207","0","0","86","207","1"
"2","2017","28","Hotel","2","27","78","208","10","14","88","222","3.6"
"2","2017","28","Otros","13","14","252","1407","8","16","260","1423","7.3846153846154"
"2","2017","28","Hotel","2","1","116","138","14","14","130","152","6.4"
"2","2017","28","Otros","7","17","207","1156","52","389","259","1545","17.166666666667"
"2","2017","28","Otros","10","23","86","445","15","60","101","505","7"
"2","2017","28","Hotel","13","27","331","331","28","28","359","359","2.75"
"2","2017","28","Otros","10","18","115","354","0","0","115","354","10.25"
"2","2017","28","Otros","5","9","20","560","0","0","20","560","4.0454545454545"
"2","2017","28","Hotel","4","39","124","172","4","6","128","178","2.6"
"2","2017","28","Otros","16","27","27","71","0","0","27","71","13.818181818182"
"2","2017","28","Hotel","14","27","28","52","29","96","57","148","8.5"
"2","2017","28","Hotel","10","11","164","456","38","170","202","626","5.6666666666667"
"2","2017","28","Hotel","10","18","138","344","0","0","138","344","7.75"
"2","2017","28","Otros","14","31","65","100","82","125","147","225","20.2"
"2","2017","28","Otros","11","32","81","325","0","0","81","325","2.2857142857143"
"2","2017","28","Otros","5","5","48","140","0","0","48","140","3.65625"
"2","2017","28","Otros","6","25","254","458","0","0","254","458","2.3846153846154"
"2","2017","28","Hotel","3","4","82","192","17","40","99","232","2.6"
"2","2017","28","Otros","7","27","403","1400","16","59","419","1459","4.8333333333333"
"2","2017","28","Otros","2","29","77","164","165","334","242","498","3.28"
"2","2017","28","Hotel","2","29","66","85","296","358","362","443","1"
"2","2017","28","Otros","4","21","115","301","14","40","129","341","1"
"2","2017","12","Hotel","7","27","15","45","0","0","15","45","4.1666666666667"
"2","2017","28","Otros","5","5","30","103","32","63","62","166","3.65625"
"2","2017","28","Otros","11","36","268","703","145","326","413","1029","5.1904761904762"
"2","2017","28","Otros","6","27","210","531","0","0","210","531","1"
"2","2017","28","Hotel","7","27","334","334","0","0","334","334","4.1666666666667"
"2","2017","28","Hotel","16","20","412","808","37","72","449","880","1"
"2","2017","28","Hotel","12","24","277","456","525","756","802","1212","3"
"2","2017","28","Hotel","9","26","138","231","31","135","169","366","1.5"
"2","2017","28","Hotel","7","17","410","1207","90","259","500","1466","10"
"2","2017","28","Hotel","9","37","146","171","27","76","173","247","3.4"
"2","2017","28","Hotel","5","5","458","621","260","333","718","954","2.1428571428571"
"2","2017","28","Otros","6","27","176","505","25","50","201","555","3.960088691796"
"2","2017","28","Hotel","9","37","39","42","13","14","52","56","3.4"
"2","2017","28","Otros","10","27","69","85","0","0","69","85","4.84"
"2","2017","28","Otros","8","3","418","748","36","66","454","814","10"
"2","2017","28","Otros","16","20","83","120","1","1","84","121","3.0769230769231"
"2","2017","28","Otros","9","22","152","282","0","0","152","282","7.6428571428571"
"2","2017","28","Otros","10","27","480","657","120","127","600","784","4.84"
"2","2017","28","Otros","10","23","192","233","5","7","197","240","7"
"2","2017","28","Otros","2","6","346","346","85","85","431","431","1"
"2","2017","28","Otros","5","5","62","78","101","156","163","234","4"
"2","2017","28","Otros","4","39","30","40","0","0","30","40","2.2222222222222"
"2","2017","28","Hotel","2","27","110","125","67","68","177","193","1"
"2","2017","28","Hotel","14","31","36","76","118","424","154","500","24"
"2","2017","28","Otros","12","35","46","80","88","124","134","204","2.6666666666667"
"2","2017","28","Otros","2","29","108","246","94","152","202","398","3.28"
"2","2017","28","Otros","8","3","1050","3150","150","300","1200","3450","10"
"2","2017","28","Hotel","7","27","56","67","0","0","56","67","1"
"2","2017","28","","13","14","2","8","33","79","35","87","1"
"2","2017","28","Hotel","6","10","416","501","34","40","450","541","6.6"
"2","2017","28","Hotel","8","34","183","283","92","183","275","466","2.5714285714286"
"2","2017","28","Hotel","9","22","187","423","0","0","187","423","2.5555555555556"
"2","2017","28","Hotel","2","6","68","258","176","320","244","578","2.2"
"2","2017","28","Hotel","10","27","121","196","421","572","542","768","2.25"
"2","2017","28","Otros","14","27","398","398","0","0","398","398","11.833333333333"
"2","2017","28","Otros","6","12","149","282","0","0","149","282","1.8256578947368"
"2","2017","28","Hotel","6","27","196","224","2","2","198","226","3"
"2","2017","28","Hotel","5","5","67","124","37","89","104","213","2.1428571428571"
"2","2017","28","Hotel","5","5","80","126","90","107","170","233","2.1428571428571"
"2","2017","28","Hotel","13","27","89","89","0","0","89","89","4.2"
"2","2017","28","Hotel","2","27","129","179","0","0","129","179","3.6"
"2","2017","28","Hotel","8","3","132","132","120","120","252","252","4.1111111111111"
"2","2017","28","Otros","11","36","64","217","12","24","76","241","5.1904761904762"
"2","2017","28","Otros","9","30","419","1169","0","0","419","1169","2.3333333333333"
"2","2017","28","Otros","16","19","104","364","0","0","104","364","10.263157894737"
"2","2017","28","Hotel","14","31","87","128","307","841","394","969","17.4"
"2","2017","28","Hotel","2","1","321","379","8","11","329","390","6.4"
"2","2017","28","Hotel","16","40","811","1600","823","1698","1634","3298","5.6666666666667"
"2","2017","28","Otros","7","17","295","959","116","462","411","1421","17.166666666667"
"2","2017","28","Hotel","13","27","323","404","142","751","465","1155","2.75"
"2","2017","28","Hotel","14","31","62","79","178","201","240","280","24"
"2","2017","28","Otros","3","4","82","215","12","16","94","231","12.2"
"2","2017","28","Otros","8","34","97","115","434","661","531","776","5.75"
"2","2017","28","Hotel","9","22","261","489","10","13","271","502","2.5555555555556"
"2","2017","28","Hotel","4","21","274","487","28","38","302","525","3"
"2","2017","28","Hotel","6","27","88","252","0","0","88","252","3"
"2","2017","28","Hotel","12","35","66","114","135","261","201","375","1.7272727272727"
"2","2017","28","Hotel","2","29","22","44","156","270","178","314","2"
"2","2017","28","Otros","10","11","91","135","14","21","105","156","11.764705882353"
"2","2017","28","Hotel","6","10","225","266","15","36","240","302","6.6"
"2","2017","28","Hotel","13","14","159","344","3","13","162","357","2"
"2","2017","28","Otros","16","27","313","596","0","0","313","596","13.818181818182"
"2","2017","28","Otros","6","27","55","69","1","1","56","70","3.960088691796"
"2","2017","28","Hotel","16","40","77","146","490","947","567","1093","5.6666666666667"
"2","2017","28","Otros","6","10","266","811","8","56","274","867","3.8518518518518"
"2","2017","28","Otros","10","23","71","190","13","15","84","205","7"
"2","2017","28","Hotel","6","28","288","375","39","42","327","417","1"
"2","2017","28","Otros","7","38","589","849","204","346","793","1195","2.75"
"2","2017","28","Hotel","6","12","147","371","5","16","152","387","5"
"2","2017","28","Hotel","13","27","466","886","0","0","466","886","4.2"
"2","2017","28","Otros","4","21","198","1317","0","0","198","1317","4.8333333333333"
"2","2017","28","Otros","13","14","139","209","0","0","139","209","1"
"2","2017","28","Hotel","16","27","70","168","12","12","82","180","5.8571428571429"
"2","2017","28","Hotel","5","5","79","126","149","288","228","414","2.1428571428571"
"2","2017","28","Otros","12","24","40","102","153","189","193","291","9.2"
"2","2017","28","Otros","15","16","136","187","32","53","168","240","9"
"2","2017","28","Hotel","8","27","289","289","28","28","317","317","4.5"
"2","2017","28","Hotel","9","22","66","78","0","0","66","78","2.5555555555556"
"2","2017","28","Hotel","10","11","224","410","93","167","317","577","5.6666666666667"
"2","2017","28","Hotel","8","3","186","530","61","189","247","719","4.1111111111111"
"2","2017","28","Hotel","6","10","568","945","65","555","633","1500","6.6"
"2","2017","28","Otros","9","26","24","37","0","0","24","37","3.8888888888889"
"2","2017","28","Hotel","4","39","40","99","21","24","61","123","2.6"
"2","2017","28","Otros","6","27","10","28","0","0","10","28","3.960088691796"
"2","2017","28","Otros","6","12","158","221","0","0","158","221","1.8256578947368"
"2","2017","28","Hotel","6","27","69","124","7","9","76","133","3"
"2","2017","28","Otros","5","9","120","131","39","48","159","179","4.0454545454545"
"2","2017","0","Otros","5","9","0","0","0","0","0","0","1"
"2","2017","28","Hotel","2","27","103","177","15","35","118","212","3.6"
"2","2017","28","Hotel","2","29","20","61","301","929","321","990","1"
"2","2017","28","Hotel","4","13","49","232","3","3","52","235","5.4"
"2","2017","28","","11","15","14","280","0","0","14","280","1"
"2","2017","28","Hotel","6","10","323","383","21","32","344","415","6.6"
"2","2017","28","Otros","6","12","24","36","15","19","39","55","1.8256578947368"
"2","2017","28","Otros","10","18","35","145","14","42","49","187","10.25"
"2","2017","28","Otros","9","22","455","1121","0","0","455","1121","7.6428571428571"
"2","2017","28","Otros","7","27","326","834","0","0","326","834","1"
"2","2017","28","","14","27","337","361","0","0","337","361","1"
"2","2017","28","Hotel","16","27","30","44","8","8","38","52","5.8571428571429"
"2","2017","28","Otros","2","29","22","40","66","82","88","122","3.28"
"2","2017","28","Hotel","8","27","53","62","4","4","57","66","1"
"2","2017","28","Otros","13","33","48","54","0","0","48","54","5.125"
"2","2017","28","Hotel","9","22","27","71","2","4","29","75","1"
"2","2017","28","Otros","10","23","79","279","4","10","83","289","1"
"2","2017","28","Otros","13","33","53","66","8","17","61","83","5.125"
"2","2017","28","Otros","6","10","96","222","0","0","96","222","3.8518518518518"
"2","2017","28","Hotel","10","18","164","529","84","207","248","736","7.75"
"2","2017","28","Hotel","14","31","79","95","30","83","109","178","24"
"2","2017","28","Hotel","4","21","86","96","9","14","95","110","3"
"2","2017","28","Hotel","3","4","53","255","65","243","118","498","2.6"
"2","2017","28","Otros","8","27","309","981","0","0","309","981","1"
"2","2017","28","Otros","6","27","17","83","0","0","17","83","3.960088691796"
"2","2017","28","Hotel","6","25","420","489","0","0","420","489","1"
"2","2017","28","Otros","6","12","172","357","17","50","189","407","1.8256578947368"
"2","2017","28","Hotel","6","27","32","40","0","0","32","40","3"
"2","2017","28","Otros","6","27","15","45","0","0","15","45","3.960088691796"
"2","2017","28","Otros","6","10","179","667","0","0","179","667","3.8518518518518"
"2","2017","28","Otros","6","12","112","202","0","0","112","202","1.8256578947368"
"2","2017","28","Otros","5","5","29","63","15","23","44","86","3.65625"
"2","2017","28","Hotel","12","24","32","161","124","325","156","486","3"
"2","2017","28","Hotel","12","35","75","131","86","131","161","262","2"
"2","2017","28","Hotel","15","16","87","238","29","77","116","315","7.8"
"2","2017","28","Otros","4","13","61","84","7","7","68","91","3.4"
"2","2017","28","Hotel","2","29","184","619","63","214","247","833","1"
"2","2017","28","Hotel","4","21","83","207","8","22","91","229","3"
"2","2017","28","Hotel","10","27","177","225","706","946","883","1171","2.25"
"2","2017","28","Hotel","8","3","277","579","82","187","359","766","4.1111111111111"
"2","2017","28","Hotel","12","27","138","274","42","44","180","318","1"
"2","2017","28","Otros","5","5","166","333","73","136","239","469","3.65625"
"2","2017","28","Otros","13","14","78","119","0","0","78","119","7.3846153846154"
"2","2017","28","Otros","10","11","478","836","49","80","527","916","11.764705882353"
"2","2017","28","Otros","16","40","340","820","46","127","386","947","28.142857142857"
"2","2017","28","Hotel","11","36","413","824","57","115","470","939","1"
"2","2017","28","Otros","12","35","29","65","195","488","224","553","2.6666666666667"
"2","2017","28","Otros","8","34","97","130","126","161","223","291","5.75"
"2","2017","28","Hotel","7","17","202","638","36","51","238","689","10"
"2","2017","28","Otros","12","35","159","327","28","45","187","372","3.5"
"2","2017","28","Otros","5","9","37","39","8","8","45","47","4.0454545454545"
"2","2017","28","Hotel","9","22","96","192","12","28","108","220","2.5555555555556"
"2","2017","28","Otros","2","29","54","116","53","130","107","246","3.28"
"2","2017","28","Otros","2","29","49","113","46","102","95","215","3.28"
"2","2017","28","Otros","10","23","109","186","51","77","160","263","1"
"2","2017","28","Hotel","10","27","126","234","299","379","425","613","2.25"
"2","2017","28","Hotel","16","19","110","194","7","11","117","205","4"
"2","2017","28","Hotel","16","40","74","412","108","276","182","688","16.333333333333"
"2","2017","28","Hotel","8","27","332","374","64","79","396","453","4.5"
"2","2017","28","Otros","13","14","36","387","0","0","36","387","7.3846153846154"
"2","2017","28","Hotel","7","27","34","50","3","12","37","62","4.1666666666667"
"2","2017","28","Otros","2","6","1","1","1","1","2","2","5"
"2","2017","28","Hotel","7","17","247","1341","51","424","298","1765","10"
"2","2017","28","Hotel","3","4","108","250","69","144","177","394","2.6"
"2","2017","28","Otros","6","12","7","18","0","0","7","18","1.8256578947368"
"2","2017","28","Otros","6","10","83","117","0","0","83","117","3.8518518518518"
"2","2017","28","Hotel","16","40","22","50","18","38","40","88","16.333333333333"
"2","2017","28","Otros","4","39","78","150","3","3","81","153","2.2222222222222"
"2","2017","28","Otros","13","14","188","421","0","0","188","421","7.3846153846154"
"2","2017","28","Otros","7","38","275","548","54","84","329","632","2.75"
"2","2017","28","Hotel","11","32","78","145","0","0","78","145","1"
"2","2017","28","Otros","11","36","241","528","10","18","251","546","5.1904761904762"
"2","2017","28","Hotel","4","21","221","341","20","40","241","381","3"
"2","2017","28","Otros","3","4","23","80","2","2","25","82","12.2"
"2","2017","28","Otros","5","9","61","88","42","87","103","175","4.0454545454545"
"2","2017","28","Otros","16","19","141","195","0","0","141","195","4"
"2","2017","28","Hotel","8","27","100","144","3","5","103","149","4.5"
"2","2017","28","Otros","16","40","33","74","33","130","66","204","1"
"2","2017","28","","7","17","240","642","62","294","302","936","1"
"2","2017","28","Otros","16","20","162","975","20","202","182","1177","3.0769230769231"
"2","2017","28","Otros","4","21","125","205","3","5","128","210","4.8333333333333"
"2","2017","28","Otros","13","33","80","86","25","38","105","124","5.125"
"2","2017","28","","12","35","0","0","450","1880","450","1880","1"
"2","2017","28","Hotel","13","33","2","2","2","6","4","8","2"
"2","2017","28","Otros","4","39","21","29","1","1","22","30","2.2222222222222"
"2","2017","28","Otros","10","18","117","384","33","76","150","460","10.25"
"2","2017","28","Otros","6","27","118","154","4","4","122","158","3.960088691796"
"2","2017","28","Otros","12","35","37","50","338","553","375","603","2.6666666666667"
"2","2017","28","Hotel","4","39","66","153","0","0","66","153","2.6"
"2","2017","28","Otros","14","31","83","213","137","225","220","438","20.2"
"2","2017","28","Hotel","2","29","20","66","290","780","310","846","2"
"2","2017","28","Hotel","13","14","16","20","0","0","16","20","1"
"2","2017","28","Hotel","9","26","212","305","0","0","212","305","1.5"
"2","2017","28","Otros","8","2","73","198","4","6","77","204","1"
"2","2017","28","Otros","12","35","11","11","15","19","26","30","3.5"
"2","2017","28","Hotel","14","27","100","137","54","69","154","206","8.5"
"2","2017","28","Otros","11","36","244","926","21","82","265","1008","5.1904761904762"
"2","2017","28","Otros","16","20","201","1029","46","161","247","1190","3.0769230769231"
"2","2017","28","Otros","4","39","3","7","0","0","3","7","2.2222222222222"
"2","2017","28","Otros","7","27","305","420","10","10","315","430","4.8333333333333"
"2","2017","28","Otros","6","27","229","337","6","6","235","343","3.960088691796"
"2","2017","28","Otros","5","8","15","420","0","0","15","420","5"
"2","2017","28","Otros","9","37","143","246","15","44","158","290","4.5"
"2","2017","28","Hotel","2","6","35","127","0","0","35","127","5.5"
"2","2017","28","Hotel","10","27","380","536","138","172","518","708","2.25"
"2","2017","28","Hotel","9","30","177","346","36","73","213","419","1"
"2","2017","28","Otros","4","13","48","86","11","15","59","101","3.4"
"2","2017","28","Hotel","5","5","334","334","40","40","374","374","1"
"2","2017","28","Otros","7","38","290","694","0","0","290","694","2.75"
"2","2017","28","Hotel","13","14","50","62","5","7","55","69","1"
"2","2017","28","Otros","5","9","100","120","43","52","143","172","4.0454545454545"
"2","2017","21","Otros","5","8","4","5","6","14","10","19","5"
"2","2017","0","Otros","10","27","0","0","0","0","0","0","4.84"
"2","2017","28","Hotel","13","14","45","89","9","19","54","108","1"
"2","2017","28","Otros","11","15","2","28","0","0","2","28","2.3571428571429"
"2","2017","28","Hotel","9","22","603","946","0","0","603","946","2.5555555555556"
"2","2017","28","Otros","11","36","134","236","18","29","152","265","5.1904761904762"
"2","2017","28","Hotel","10","18","2370","4234","2356","4597","4726","8831","1"
"2","2017","28","Hotel","6","12","151","298","23","64","174","362","5"
"2","2017","28","","2","29","257","846","701","1809","958","2655","1"
"2","2017","28","Hotel","16","27","1541","3425","12","27","1553","3452","1"
"2","2017","28","","14","31","188","312","527","2229","715","2541","1"
"2","2017","28","Hotel","8","3","163","290","80","97","243","387","4.1111111111111"
"2","2017","28","Otros","13","33","99","195","185","225","284","420","5.125"
"2","2017","28","","14","27","89","112","0","0","89","112","2.6666666666667"
"2","2017","28","Otros","9","22","49","82","0","0","49","82","7.6428571428571"
"2","2017","28","Hotel","10","11","94","214","2","4","96","218","5.6666666666667"
"2","2017","28","Otros","6","12","32","37","0","0","32","37","1.8256578947368"
"2","2017","28","Hotel","8","3","266","648","43","53","309","701","4.1111111111111"
"2","2017","28","Otros","9","22","226","539","0","0","226","539","3.25"
"2","2017","28","Hotel","7","17","145","373","8","8","153","381","1"
"2","2017","26","Otros","6","12","270","808","6","24","276","832","1.8256578947368"
"2","2017","28","Hotel","8","27","172","198","2","4","174","202","4.5"
"2","2017","28","Hotel","6","28","286","325","74","79","360","404","2.4"
"2","2017","28","Otros","8","2","304","903","46","98","350","1001","1"
"2","2017","28","Hotel","8","27","77","104","1","3","78","107","1"
"2","2017","28","Otros","6","25","178","1173","0","0","178","1173","2.3846153846154"
"2","2017","28","Otros","6","25","81","172","0","0","81","172","2.3846153846154"
"2","2017","28","Hotel","11","36","713","1337","0","0","713","1337","1"
"2","2017","28","Otros","16","20","107","183","9","12","116","195","1"
"2","2017","28","Otros","2","6","43","144","199","524","242","668","5"
"2","2017","28","Hotel","14","31","24","55","124","338","148","393","24"
"2","2017","28","Otros","4","21","92","172","5","18","97","190","4.8333333333333"
"2","2017","28","Otros","7","38","115","239","0","0","115","239","2.75"
"2","2017","28","Otros","13","14","300","409","0","0","300","409","7.3846153846154"
"2","2017","28","Otros","2","29","51","123","38","64","89","187","3.28"
"2","2017","28","Otros","3","4","125","125","38","38","163","163","12.2"
"2","2017","28","Hotel","3","4","439","1267","19","30","458","1297","3"
"2","2017","28","Otros","7","27","484","804","56","64","540","868","1"
"2","2017","28","Otros","7","17","69","125","0","0","69","125","3"
"2","2017","28","Hotel","12","27","155","249","35","46","190","295","1"
"2","2017","28","Otros","5","5","83","103","21","33","104","136","3.65625"
"2","2017","28","Hotel","6","10","360","494","30","30","390","524","6.6"
"2","2017","28","Otros","10","18","183","473","66","178","249","651","10.25"
"2","2017","28","Otros","8","27","58","97","0","0","58","97","9.4"
"2","2017","28","Otros","8","3","217","636","26","67","243","703","10"
"2","2017","28","Hotel","16","27","12","96","0","0","12","96","5.8571428571429"
"2","2017","28","Otros","16","40","131","370","0","0","131","370","1"
"2","2017","28","Otros","8","27","324","532","45","75","369","607","1"
"2","2017","28","Otros","6","10","103","212","0","0","103","212","3.8518518518518"
"2","2017","28","Otros","7","17","201","783","19","56","220","839","3"
"2","2017","28","Otros","16","40","66","76","24","30","90","106","1"
"2","2017","28","Hotel","2","6","24","42","0","0","24","42","5.5"
"2","2017","28","Hotel","8","3","121","471","23","73","144","544","4.1111111111111"
"2","2017","28","Otros","7","38","455","1139","6","6","461","1145","1"
"2","2017","28","Otros","10","11","95","228","16","24","111","252","11.764705882353"
"2","2017","28","Otros","6","27","159","274","0","0","159","274","3.960088691796"
"2","2017","28","Otros","15","16","4","6","0","0","4","6","9"
"2","2017","28","Otros","6","25","60","245","0","0","60","245","1"
"2","2017","28","Otros","5","5","0","0","89","152","89","152","3.65625"
"2","2017","28","Otros","10","27","286","424","145","246","431","670","4.84"
"2","2017","28","Hotel","7","38","144","195","87","104","231","299","1"
"2","2017","28","Hotel","12","35","90","155","302","437","392","592","2"
"2","2017","28","Hotel","13","27","6","6","0","0","6","6","4.2"
"2","2017","28","Hotel","16","20","255","267","0","0","255","267","1"
"2","2017","28","Otros","10","27","67","67","0","0","67","67","4.84"
"2","2017","28","Otros","16","40","26","78","12","26","38","104","1"
"2","2017","28","Hotel","3","7","39","69","9","26","48","95","1"
"2","2017","28","Otros","2","29","155","238","13","22","168","260","3.28"
"2","2017","28","Otros","10","18","192","638","43","78","235","716","10.25"
"2","2017","28","Otros","5","5","80","197","43","99","123","296","4"
"2","2017","28","Otros","9","22","247","506","0","0","247","506","7.6428571428571"
"2","2017","28","Otros","15","27","77","91","0","0","77","91","1.4222222222222"
"2","2017","28","Otros","5","5","62","94","41","94","103","188","4"
"2","2017","28","Hotel","16","19","97","273","0","0","97","273","1"
"2","2017","28","Otros","11","36","13","31","1","2","14","33","5.1904761904762"
"2","2017","28","Otros","5","5","33","51","17","27","50","78","3.65625"
"2","2017","28","Otros","2","29","25","75","39","73","64","148","3.28"
"2","2017","28","Hotel","9","22","220","220","28","28","248","248","2.5555555555556"
"2","2017","28","Otros","11","32","6","12","0","0","6","12","2.2857142857143"
"2","2017","28","Hotel","10","27","292","501","582","692","874","1193","1"
"2","2017","28","Otros","16","27","557","904","0","0","557","904","2"
"2","2017","28","Otros","13","33","6","11","29","55","35","66","1"
"2","2017","28","Hotel","16","20","121","238","52","303","173","541","1"
"2","2017","28","Otros","11","15","36","86","2","30","38","116","2.3571428571429"
"2","2017","28","Otros","7","17","145","536","0","0","145","536","3"
"2","2017","28","Otros","5","8","42","75","8","8","50","83","5"
"2","2017","28","Otros","8","27","378","406","4","4","382","410","1"
"2","2017","28","Otros","8","3","34","90","73","185","107","275","14.75"
"2","2017","0","Otros","16","27","0","0","0","0","0","0","1"
"2","2017","0","Otros","13","14","0","0","0","0","0","0","1"
"2","2017","28","Hotel","13","33","52","109","10","10","62","119","2"
"2","2017","28","Otros","5","9","145","233","154","231","299","464","4.0454545454545"
"2","2017","28","Otros","10","27","123","185","160","200","283","385","4.84"
"2","2017","28","Otros","9","22","145","481","0","0","145","481","7.6428571428571"
"2","2017","28","Otros","16","40","56","112","0","0","56","112","28.142857142857"
"2","2017","28","Hotel","16","40","151","151","51","51","202","202","1"
"2","2017","28","Otros","15","16","71","310","13","29","84","339","9"
"2","2017","28","Hotel","8","2","50","62","25","25","75","87","3"
"2","2017","28","Otros","8","3","133","526","0","0","133","526","10"
"2","2017","28","Otros","7","17","74","144","22","49","96","193","17.166666666667"
"2","2017","28","Otros","16","20","92","204","0","0","92","204","3.0769230769231"
"2","2017","28","Otros","6","27","147","410","0","0","147","410","3.960088691796"
"2","2017","28","Otros","12","35","39","64","229","273","268","337","3.5"
"2","2017","28","Otros","6","28","128","430","68","139","196","569","4.65"
"2","2017","28","Otros","6","28","653","1188","152","228","805","1416","4.65"
"2","2017","28","Hotel","8","34","74","157","302","387","376","544","2.5714285714286"
"2","2017","28","Hotel","16","20","2154","3905","30","201","2184","4106","1"
"2","2017","28","Hotel","2","6","218","406","6","7","224","413","2.2"
"2","2017","28","Hotel","7","27","27","28","0","0","27","28","4.1666666666667"
"2","2017","28","Hotel","10","23","243","307","12","15","255","322","4"
"2","2017","28","Hotel","9","26","53","72","5","6","58","78","1.5"
"2","2017","28","Otros","13","14","112","155","8","24","120","179","1"
"2","2017","28","Otros","8","27","177","381","8","10","185","391","9.4"
"2","2017","28","Otros","10","27","136","190","30","30","166","220","4.84"
"2","2017","28","Otros","11","15","39","84","10","12","49","96","2.3571428571429"
"2","2017","28","Otros","16","20","32","63","0","0","32","63","3.0769230769231"
"2","2017","28","Otros","11","32","194","205","6","9","200","214","1"
"2","2017","28","Otros","16","27","103","103","2","2","105","105","13.818181818182"
"2","2017","28","Otros","7","38","140","384","0","0","140","384","1"
"2","2017","28","Otros","9","37","60","60","0","0","60","60","4.5"
"2","2017","28","Hotel","2","29","8","41","22","59","30","100","2"
"2","2017","28","Hotel","2","1","11","78","0","0","11","78","6.4"
"2","2017","28","Otros","5","8","23","25","14","17","37","42","5"
"2","2017","28","Otros","9","37","55","88","26","48","81","136","4.5"
"2","2017","28","Otros","7","38","171","733","0","0","171","733","2.75"
"2","2017","28","Otros","11","32","148","627","2","10","150","637","1"
"2","2017","28","Otros","4","39","81","116","10","68","91","184","2.2222222222222"
"2","2017","28","Hotel","11","36","211","386","20","50","231","436","2.375"
"2","2017","28","Otros","10","23","79","495","23","64","102","559","7"
"2","2017","28","Otros","6","28","232","353","10","10","242","363","1"
"2","2017","28","Otros","7","38","178","518","43","108","221","626","1"
"2","2017","28","Hotel","15","16","518","1701","551","2898","1069","4599","2"
"2","2017","28","Otros","2","29","71","163","192","400","263","563","3.28"
"2","2017","28","Hotel","8","3","48","50","4","4","52","54","1"
"2","2017","28","Hotel","6","12","1369","1774","27","27","1396","1801","1"
"2","2017","28","Hotel","11","15","180","2676","13","84","193","2760","1"
"2","2017","28","Otros","4","21","1110","3141","162","405","1272","3546","1"
"2","2017","28","Otros","16","19","173","456","0","0","173","456","10.263157894737"
"2","2017","28","","9","37","348","402","15","21","363","423","1"
"2","2017","28","Otros","10","27","259","608","96","199","355","807","4.84"
"2","2017","28","Otros","11","15","72","92","0","0","72","92","2.3571428571429"
"2","2017","28","Hotel","8","3","23","173","0","0","23","173","1"
"2","2017","28","Hotel","2","29","42","89","49","131","91","220","2"
"2","2017","28","Otros","9","22","754","1355","0","0","754","1355","3.25"
"2","2017","28","Hotel","10","27","192","302","177","261","369","563","1"
"2","2017","28","Hotel","11","36","69","182","81","185","150","367","2.375"
"2","2017","28","Hotel","9","37","131","187","22","28","153","215","3.4"
"2","2017","28","Otros","14","27","11","34","2","4","13","38","11.833333333333"
"2","2017","28","Otros","7","38","401","1153","0","0","401","1153","1"
"2","2017","28","Hotel","2","1","20","200","0","0","20","200","6.4"
"2","2017","28","Otros","2","29","10","13","42","583","52","596","3.28"
"2","2017","28","Hotel","6","27","4","6","0","0","4","6","3"
"2","2017","28","Otros","5","9","4","112","0","0","4","112","4.0454545454545"
"2","2017","28","Hotel","2","1","138","220","0","0","138","220","6.4"
"2","2017","28","Hotel","10","27","165","331","119","156","284","487","1"
"2","2017","28","Hotel","3","7","25","48","26","38","51","86","1"
"2","2017","28","Otros","7","38","299","299","176","176","475","475","2.75"
"2","2017","28","Otros","12","24","3","11","20","24","23","35","1"
"2","2017","28","Otros","7","17","16","34","2","2","18","36","17.166666666667"
"2","2017","28","Otros","7","38","98","207","0","0","98","207","2.75"
"2","2017","28","Otros","4","21","174","194","14","18","188","212","4.8333333333333"
"2","2017","28","Otros","2","1","31","59","9","11","40","70","5.5"
"2","2017","28","Otros","12","35","68","82","65","79","133","161","3.5"
"2","2017","28","Otros","3","4","4","10","4","4","8","14","1"
"2","2017","28","Otros","12","35","20","28","25","44","45","72","3.5"
"2","2017","28","Otros","4","21","50","68","17","28","67","96","4.8333333333333"
"2","2017","28","Otros","12","24","20","40","30","60","50","100","9.2"
"2","2017","28","Otros","16","19","49","73","0","0","49","73","10.263157894737"
"2","2017","28","Otros","9","30","38","57","0","0","38","57","1"
"2","2017","28","Otros","10","11","292","484","5","17","297","501","11.764705882353"
"2","2017","28","Otros","16","19","131","450","0","0","131","450","10.263157894737"
"2","2017","28","Hotel","2","27","45","45","15","15","60","60","1"
"2","2017","28","Otros","6","28","96","171","0","0","96","171","4.65"
"2","2017","28","Otros","10","18","209","345","94","230","303","575","10.25"
"2","2017","28","Otros","14","27","13","22","4","12","17","34","11.833333333333"
"2","2017","28","Hotel","16","19","218","345","0","0","218","345","1"
"2","2017","28","Hotel","11","32","61","191","4","20","65","211","1"
"2","2017","28","Hotel","7","17","106","387","0","0","106","387","1"
"2","2017","28","Otros","8","27","20","20","0","0","20","20","9.4"
"2","2017","28","Hotel","12","35","129","285","90","140","219","425","1.7272727272727"
"2","2017","28","Otros","13","14","86","122","0","0","86","122","7.3846153846154"
"2","2017","28","Hotel","11","15","120","1014","0","0","120","1014","1"
"2","2017","28","Otros","16","19","88","170","0","0","88","170","4"
"2","2017","28","Otros","11","36","89","123","30","59","119","182","5.1904761904762"
"2","2017","28","Otros","10","23","150","386","39","42","189","428","1"
"2","2017","28","Otros","16","20","52","101","0","0","52","101","3.0769230769231"
"2","2017","28","Hotel","14","31","175","175","653","1953","828","2128","7.8"
"2","2017","28","Otros","2","27","248","511","13","19","261","530","3.2"
"2","2017","28","","16","40","563","3827","0","0","563","3827","3.0555555555556"
"2","2017","28","Hotel","11","36","191","250","66","138","257","388","2.375"
"2","2017","28","Hotel","9","22","60","113","0","0","60","113","2.5555555555556"
"2","2017","28","Otros","6","10","241","704","19","54","260","758","1"
"2","2017","28","Otros","2","29","40","82","62","142","102","224","3.28"
"2","2017","28","Hotel","10","27","79","87","348","423","427","510","2.25"
"2","2017","28","Hotel","10","18","84","149","44","70","128","219","1"
"2","2017","28","Otros","10","27","9","56","0","0","9","56","4.84"
"2","2017","28","Hotel","16","19","89","168","14","29","103","197","4"
"2","2017","20","Otros","2","6","7","8","0","0","7","8","5"
"2","2017","28","Otros","7","27","391","1635","11","89","402","1724","4.8333333333333"
"2","2017","28","Hotel","2","6","101","710","0","0","101","710","5.5"
"2","2017","28","Hotel","6","28","48","65","20","28","68","93","2.4"
"2","2017","28","Otros","6","10","313","1204","0","0","313","1204","3.8518518518518"
"2","2017","28","Hotel","6","27","3","4","0","0","3","4","3"
"2","2017","28","Otros","6","10","106","344","0","0","106","344","1"
"2","2017","20","Otros","5","9","94","159","25","43","119","202","5.5"
"2","2017","28","Otros","5","5","47","64","14","21","61","85","3.65625"
"2","2017","28","Otros","12","24","47","82","120","172","167","254","9.2"
"2","2017","28","Hotel","8","2","141","262","29","41","170","303","3"
"2","2017","28","Hotel","11","32","77","119","8","8","85","127","1"
"2","2017","28","Otros","10","18","85","211","56","131","141","342","10.25"
"2","2017","28","Hotel","9","37","62","110","22","36","84","146","3.4"
"2","2017","28","Otros","5","9","119","192","132","191","251","383","4.0454545454545"
"2","2017","28","Otros","12","24","19","63","46","77","65","140","9.2"
"2","2017","28","Otros","9","22","28","28","0","0","28","28","7.6428571428571"
"2","2017","28","Otros","2","29","16","31","33","56","49","87","3.28"
"2","2017","28","Otros","10","23","20","34","5","20","25","54","7"
"2","2017","28","Otros","7","27","263","529","0","0","263","529","1"
"2","2017","28","Otros","10","27","53","53","6","6","59","59","3"
"2","2017","28","Otros","10","27","332","336","62","74","394","410","4.84"
"2","2017","28","Otros","10","11","50","100","0","0","50","100","11.764705882353"
"2","2017","28","Otros","10","11","12","16","6","6","18","22","1"
"2","2017","28","Otros","8","3","130","940","48","195","178","1135","10"
"2","2017","28","Otros","14","31","51","75","445","744","496","819","20.2"
"2","2017","28","Otros","2","29","256","548","160","376","416","924","3.28"
"2","2017","28","Otros","6","25","0","0","0","0","0","0","1"
"2","2017","28","Otros","10","18","111","441","47","128","158","569","4.6"
"2","2017","28","Hotel","15","16","25","83","35","114","60","197","7.8"
"2","2017","28","Otros","13","33","264","1108","23","68","287","1176","1"
"2","2017","28","Otros","8","27","48","74","4","4","52","78","1"
"2","2017","28","Hotel","15","27","112","224","0","0","112","224","1"
"2","2017","28","Otros","10","27","11","36","2","8","13","44","4.84"
"2","2017","28","Otros","10","23","181","181","4","4","185","185","7"
"2","2017","28","Otros","6","27","13","19","0","0","13","19","3.960088691796"
"2","2017","28","Otros","16","40","126","302","22","64","148","366","28.142857142857"
"2","2017","28","Otros","11","36","332","665","6","8","338","673","5.1904761904762"
"2","2017","28","Otros","8","34","38","95","2","2","40","97","5.75"
"2","2017","28","Otros","6","12","76","114","2","2","78","116","1.8256578947368"
"2","2017","28","Otros","6","10","211","448","0","0","211","448","3.8518518518518"
"2","2017","28","Otros","8","27","311","654","25","41","336","695","1"
"2","2017","28","Otros","8","2","107","242","25","61","132","303","1"
"2","2017","28","Hotel","12","24","10","23","208","286","218","309","1"
"2","2017","28","Hotel","4","21","253","507","36","103","289","610","3"
"2","2017","28","Otros","7","27","211","240","6","6","217","246","1"
"2","2017","28","Hotel","11","36","216","533","61","154","277","687","2.375"
"2","2017","28","Otros","5","8","249","337","135","164","384","501","5"
"2","2017","28","Hotel","7","17","179","204","11","17","190","221","10"
"2","2017","28","Hotel","11","36","556","765","34","42","590","807","1"
"2","2017","28","Otros","9","30","165","243","0","0","165","243","2.3333333333333"
"2","2017","28","Otros","5","8","0","0","40","264","40","264","9"
"2","2017","28","Hotel","12","35","96","193","265","414","361","607","1.7272727272727"
"2","2017","28","Otros","2","1","84","168","35","61","119","229","5.5"
"2","2017","28","Hotel","6","25","15","18","0","0","15","18","1"
"2","2017","28","Otros","5","5","61","221","63","126","124","347","3.65625"
"2","2017","28","Otros","2","29","15","42","42","119","57","161","3.28"
"2","2017","28","Hotel","2","6","20","22","14","14","34","36","5.5"
"2","2017","28","Otros","7","17","41","176","11","50","52","226","17.166666666667"
"2","2017","28","Hotel","8","2","41","41","19","19","60","60","3"
"2","2017","28","Hotel","13","14","117","117","0","0","117","117","1"
"2","2017","28","Otros","7","38","130","306","25","65","155","371","2.75"
"2","2017","28","Hotel","14","31","8","15","44","113","52","128","24"
"2","2017","28","Hotel","5","5","65","87","107","164","172","251","2.1428571428571"
"2","2017","28","Otros","2","27","4","4","3","3","7","7","3.2"
"2","2017","28","Otros","12","24","2","4","54","155","56","159","1"
"2","2017","28","Otros","5","8","82","105","90","115","172","220","5"
"2","2017","28","Otros","3","4","41","116","31","128","72","244","12.2"
"2","2017","28","Otros","13","14","6","18","0","0","6","18","7.3846153846154"
"2","2017","28","Otros","9","37","61","118","17","26","78","144","4.5"
"2","2017","28","Hotel","10","23","1197","1582","164","226","1361","1808","1"
"2","2017","28","Otros","11","32","78","78","0","0","78","78","2.2857142857143"
"2","2017","23","Otros","10","11","36","72","0","0","36","72","1"
"2","2017","28","Otros","11","15","1","2","0","0","1","2","2.3571428571429"
"2","2017","28","Otros","8","3","120","523","25","100","145","623","10"
"2","2017","28","Otros","16","20","197","988","0","0","197","988","3.0769230769231"
"2","2017","28","Otros","10","18","94","207","5","15","99","222","4.6"
"2","2017","28","Otros","8","3","106","615","12","54","118","669","10"
"2","2017","28","Otros","16","27","486","975","0","0","486","975","2"
"2","2017","28","Otros","16","19","33","50","0","0","33","50","4"
"2","2017","28","Hotel","16","19","74","157","9","9","83","166","4"
"2","2017","28","Hotel","16","27","61","139","4","8","65","147","5.8571428571429"
"2","2017","28","Otros","12","35","28","28","37","42","65","70","2.6666666666667"
"2","2017","28","Otros","9","26","68","83","13","19","81","102","3.8888888888889"
"2","2017","28","Otros","5","5","17","41","26","42","43","83","3.65625"
"2","2017","28","Otros","14","27","9","9","0","0","9","9","11.833333333333"
"2","2017","28","Hotel","5","5","5","16","56","292","61","308","2.1428571428571"
"2","2017","28","Hotel","12","24","92","250","132","333","224","583","3"
"2","2017","28","Otros","16","27","68","237","0","0","68","237","13.818181818182"
"2","2017","28","Otros","7","27","40","44","0","0","40","44","1"
"2","2017","28","Otros","8","3","61","215","41","149","102","364","1"
"2","2017","28","Otros","9","37","164","364","0","0","164","364","2"
"2","2017","28","Otros","13","27","278","378","10","10","288","388","12.2"
"2","2017","28","Hotel","16","40","79","146","63","152","142","298","16.333333333333"
"2","2017","28","Otros","11","36","58","113","30","60","88","173","1"
"2","2017","28","Otros","10","27","171","177","79","133","250","310","4.84"
"2","2017","28","Hotel","7","38","113","250","5","11","118","261","1"
"2","2017","28","Otros","13","33","281","393","0","0","281","393","1"
"2","2017","28","Otros","9","22","151","457","7","21","158","478","7.6428571428571"
"2","2017","28","Hotel","8","3","32","64","8","10","40","74","1"
"2","2017","28","Hotel","5","5","22","44","66","98","88","142","2.1428571428571"
"2","2017","28","Otros","2","29","29","119","78","186","107","305","3.28"
"2","2017","28","Otros","2","29","11","21","11","41","22","62","3.28"
"2","2017","28","Otros","2","29","20","80","31","72","51","152","1"
"2","2017","28","Hotel","7","17","77","252","33","172","110","424","1"
"2","2017","28","Hotel","13","14","130","235","6","21","136","256","1"
"2","2017","28","Otros","6","25","4","4","0","0","4","4","2.3846153846154"
"2","2017","28","Otros","2","1","18","31","0","0","18","31","5.5"
"2","2017","28","Hotel","12","27","104","127","87","109","191","236","1"
"2","2017","28","Hotel","13","27","24","24","0","0","24","24","4.2"
"2","2017","28","Otros","6","12","98","268","1","2","99","270","1.8256578947368"
"2","2017","28","Otros","6","27","62","62","0","0","62","62","3.960088691796"
"2","2017","28","Otros","6","25","125","135","0","0","125","135","2.3846153846154"
"2","2017","28","Otros","6","25","108","162","0","0","108","162","1"
"2","2017","28","Hotel","6","28","16","40","0","0","16","40","2.5833333333333"
"2","2017","28","Otros","6","27","8","80","0","0","8","80","3.6666666666667"
"2","2017","28","Otros","5","5","10","12","8","8","18","20","3.65625"
"2","2017","28","Otros","5","9","17","23","13","17","30","40","4.0454545454545"
"2","2017","28","Otros","5","8","19","24","12","17","31","41","5"
"2","2017","28","Hotel","2","29","79","190","101","174","180","364","1"
"2","2017","28","Otros","5","5","111","127","70","97","181","224","3.65625"
"2","2017","28","Hotel","9","26","45","108","2","4","47","112","1.5"
"2","2017","28","Otros","9","30","10","28","0","0","10","28","2.3333333333333"
"2","2017","28","Otros","11","15","43","113","0","0","43","113","2.3571428571429"
"2","2017","28","Hotel","16","27","6","24","23","28","29","52","5.8571428571429"
"2","2017","28","Otros","9","30","37","91","2","2","39","93","2.3333333333333"
"2","2017","28","Otros","11","15","115","117","6","7","121","124","1"
"2","2017","28","Otros","2","29","9","19","41","135","50","154","3.28"
"2","2017","28","Otros","7","38","86","172","27","48","113","220","2.75"
"2","2017","28","Otros","4","21","94","518","18","122","112","640","4.8333333333333"
"2","2017","28","Otros","9","22","83","296","0","0","83","296","7.6428571428571"
"2","2017","28","Otros","9","22","212","358","0","0","212","358","7.6428571428571"
"2","2017","28","Otros","13","27","36","54","0","0","36","54","12.2"
"2","2017","28","Otros","8","3","120","411","0","0","120","411","14.75"
"2","2017","28","Otros","11","32","33","495","0","0","33","495","1"
"2","2017","28","Hotel","11","36","3754","4203","138","209","3892","4412","1"
"2","2017","28","Otros","13","33","13","26","7","14","20","40","5.125"
"2","2017","28","Otros","11","36","164","378","112","264","276","642","5.1904761904762"
"2","2017","28","Otros","12","35","100","180","222","314","322","494","3.5"
"2","2017","28","Otros","12","35","21","68","24","46","45","114","3.5"
"2","2017","28","Otros","16","40","4","6","11","21","15","27","1"
"2","2017","28","Otros","10","11","121","350","2","2","123","352","11.764705882353"
"2","2017","28","Otros","12","24","30","70","25","75","55","145","9.2"
"2","2017","28","Otros","16","20","87","337","0","0","87","337","3.0769230769231"
"2","2017","28","Hotel","7","27","379","531","18","20","397","551","1"
"2","2017","28","Otros","13","27","46","60","0","0","46","60","9"
"2","2017","28","Otros","6","12","19","19","0","0","19","19","1.8256578947368"
"2","2017","28","Otros","11","32","256","975","27","70","283","1045","2.2857142857143"
"2","2017","28","Otros","6","28","565","792","3","3","568","795","4.65"
"2","2017","28","Otros","8","34","1","1","0","0","1","1","5.75"
"2","2017","28","Otros","16","27","112","171","0","0","112","171","13.818181818182"
"2","2017","28","Otros","10","27","35","41","17","17","52","58","3"
"2","2017","28","Otros","10","11","25","25","0","0","25","25","11.764705882353"
"2","2017","28","Otros","6","10","121","286","0","0","121","286","3.8518518518518"
"2","2017","28","Otros","8","3","4","6","0","0","4","6","10"
"2","2017","28","Hotel","16","20","77","197","53","120","130","317","1"
"2","2017","28","Hotel","11","32","58","123","10","26","68","149","1"
"2","2017","28","Otros","8","27","26","29","55","233","81","262","9.4"
"2","2017","28","Otros","12","27","27","31","22","28","49","59","3.4285714285714"
"2","2017","28","Otros","6","10","147","490","0","0","147","490","3.8518518518518"
"2","2017","28","Otros","6","10","98","183","0","0","98","183","3.8518518518518"
"2","2017","28","Otros","5","8","20","35","12","22","32","57","5"
"2","2017","28","Otros","5","8","138","157","90","96","228","253","5"
"2","2017","28","Otros","5","9","14","16","2","2","16","18","5.5"
"2","2017","28","Hotel","9","26","64","85","10","18","74","103","1.5"
"2","2017","28","Hotel","13","14","80","116","22","25","102","141","1"
"2","2017","28","Otros","10","18","74","482","21","111","95","593","10.25"
"2","2017","28","Otros","8","2","75","88","42","42","117","130","6.4285714285714"
"2","2017","28","Otros","7","27","61","74","0","0","61","74","4.8333333333333"
"2","2017","28","Otros","2","29","22","92","60","228","82","320","1"
"2","2017","28","Otros","2","29","19","53","26","87","45","140","3.28"
"2","2017","28","Otros","11","32","1","1","0","0","1","1","2.2857142857143"
"2","2017","28","Otros","9","30","67","147","0","0","67","147","2.3333333333333"
"2","2017","28","Otros","2","29","42","125","11","25","53","150","3.28"
"2","2017","28","Otros","5","5","62","81","0","0","62","81","3.65625"
"2","2017","28","Otros","11","15","35","56","0","0","35","56","2.3571428571429"
"2","2017","28","Otros","10","23","270","270","163","163","433","433","7"
"2","2017","28","Otros","11","36","130","173","29","41","159","214","5.1904761904762"
"2","2017","28","Hotel","3","7","17","32","35","71","52","103","1"
"2","2017","28","Otros","10","27","37","51","11","15","48","66","4.84"
"2","2017","28","Otros","2","27","4","4","4","4","8","8","3.2"
"2","2017","28","Otros","12","35","45","90","77","120","122","210","3.5"
"2","2017","28","Otros","10","27","34","105","18","67","52","172","4.84"
"2","2017","28","Otros","16","40","37","79","136","291","173","370","28.142857142857"
"2","2017","28","Hotel","8","3","623","1377","105","196","728","1573","4.1111111111111"
"2","2017","28","Otros","9","22","137","334","0","0","137","334","7.6428571428571"
"2","2017","28","Otros","13","14","53","141","0","0","53","141","7.3846153846154"
"2","2017","28","Otros","5","9","3","12","2","4","5","16","4.0454545454545"
"2","2017","28","Otros","10","18","138","316","50","160","188","476","10.25"
"2","2017","28","Otros","6","25","282","610","0","0","282","610","2.3846153846154"
"2","2017","28","Otros","9","22","170","618","0","0","170","618","7.6428571428571"
"2","2017","28","Otros","10","27","71","162","2","2","73","164","4.84"
"2","2017","28","Otros","9","22","56","106","0","0","56","106","3.25"
"2","2017","28","Otros","16","20","89","237","14","19","103","256","3.0769230769231"
"2","2017","28","Otros","13","14","130","283","0","0","130","283","1"
"2","2017","28","Otros","16","19","18","51","0","0","18","51","4"
"2","2017","28","Hotel","7","17","203","589","10","79","213","668","10"
"2","2017","28","Otros","15","27","55","100","0","0","55","100","1.4222222222222"
"2","2017","28","Otros","12","35","41","62","39","47","80","109","3.5"
"2","2017","28","Otros","12","35","23","36","111","154","134","190","3.5"
"2","2017","28","Otros","3","7","9","14","0","0","9","14","2"
"2","2017","28","Otros","10","11","7","9","6","8","13","17","11.764705882353"
"2","2017","28","Otros","12","24","7","12","38","59","45","71","9.2"
"2","2017","28","Otros","10","23","52","59","0","0","52","59","7"
"2","2017","28","Otros","7","27","3","7","0","0","3","7","4.8333333333333"
"2","2017","28","","10","18","12","40","0","0","12","40","1"
"2","2017","28","Otros","10","18","72","232","0","0","72","232","4.6"
"2","2017","28","Otros","8","2","32","32","0","0","32","32","1"
"2","2017","28","Otros","16","27","0","0","8","8","8","8","13.818181818182"
"2","2017","28","Hotel","2","29","10","30","15","45","25","75","1"
"2","2017","28","Otros","14","27","12","12","0","0","12","12","11.833333333333"
"2","2017","28","Otros","11","32","123","284","0","0","123","284","2.2857142857143"
"2","2017","28","Otros","16","19","361","4338","20","192","381","4530","1"
"2","2017","28","Otros","16","27","67","123","0","0","67","123","13.818181818182"
"2","2017","28","Otros","8","3","40","336","0","0","40","336","10"
"2","2017","28","Otros","16","27","117","458","0","0","117","458","13.818181818182"
"2","2017","28","Otros","16","20","100","478","12","35","112","513","3.0769230769231"
"2","2017","28","Otros","11","36","61","180","0","0","61","180","3.25"
"2","2017","28","Otros","8","2","97","157","36","46","133","203","1"
"2","2017","28","Otros","16","40","164","581","55","125","219","706","28.142857142857"
"2","2017","28","Hotel","11","36","122","341","20","30","142","371","2.375"
"2","2017","28","Otros","7","17","79","472","0","0","79","472","3"
"2","2017","28","Otros","6","10","49","94","0","0","49","94","3.8518518518518"
"2","2017","28","Otros","7","38","66","266","19","89","85","355","2.75"
"2","2017","28","Otros","13","14","50","94","0","0","50","94","7.3846153846154"
"2","2017","28","Otros","9","30","45","47","1","1","46","48","2.3333333333333"
"2","2017","28","Otros","13","27","13","25","0","0","13","25","12.2"
"2","2017","28","Otros","10","27","25","25","22","22","47","47","4.84"
"2","2017","28","Otros","6","25","42","48","45","48","87","96","2.3846153846154"
"2","2017","28","Otros","9","26","17","17","0","0","17","17","3.8888888888889"
"2","2017","28","Otros","10","18","20","109","16","66","36","175","10.25"
"2","2017","28","Otros","2","29","9","38","0","0","9","38","3.28"
"2","2017","28","Otros","6","25","114","226","0","0","114","226","2.3846153846154"
"2","2017","28","Otros","6","25","21","21","0","0","21","21","1"
"2","2017","28","Otros","6","27","54","146","14","42","68","188","3.6666666666667"
"2","2017","28","Otros","5","9","51","64","51","83","102","147","4.0454545454545"
"2","2017","28","Otros","5","9","30","49","21","47","51","96","4.0454545454545"
"2","2017","28","Hotel","9","37","30","37","5","27","35","64","3.4"
"2","2017","28","Hotel","7","38","234","422","8","10","242","432","1"
"2","2017","28","Otros","7","27","101","118","0","0","101","118","4.8333333333333"
"2","2017","28","Otros","5","9","14","14","0","0","14","14","4.0454545454545"
"2","2017","20","Otros","10","27","34","36","9","13","43","49","4.84"
"2","2017","28","Otros","7","27","48","68","0","0","48","68","4.8333333333333"
"2","2017","12","Otros","16","40","16","30","22","56","38","86","28.142857142857"
"2","2017","28","Otros","10","23","43","43","3","6","46","49","7"
"2","2017","28","Otros","15","16","117","395","11","35","128","430","9"
"2","2017","28","Otros","3","7","8","18","115","244","123","262","2"
"2","2017","28","Otros","7","17","43","149","27","93","70","242","17.166666666667"
"2","2017","28","Otros","8","27","103","145","9","9","112","154","9.4"
"2","2017","28","Otros","11","36","75","105","6","6","81","111","3.25"
"2","2017","28","Otros","9","22","75","470","0","0","75","470","7.6428571428571"
"2","2017","28","Otros","16","19","25","91","0","0","25","91","10.263157894737"
"2","2017","28","Otros","13","14","154","390","0","0","154","390","1"
"2","2017","28","Otros","5","9","72","98","21","23","93","121","5.5"
"2","2017","28","","15","27","124","200","0","0","124","200","1"
"2","2017","28","Hotel","16","19","95","273","0","0","95","273","1"
"2","2017","28","Hotel","10","11","53","53","42","64","95","117","5.6666666666667"
"2","2017","28","Otros","2","27","3","6","2","2","5","8","3.2"
"2","2017","28","Otros","8","2","71","137","52","83","123","220","6.4285714285714"
"2","2017","28","Otros","5","5","7","10","4","5","11","15","3.65625"
"2","2017","28","Otros","12","35","14","14","56","61","70","75","3.5"
"2","2017","28","Otros","8","3","16","48","53","210","69","258","10"
"2","2017","28","Otros","12","24","16","27","62","129","78","156","9.2"
"2","2017","28","Otros","11","32","85","461","9","29","94","490","2.2857142857143"
"2","2017","28","Otros","10","27","211","378","148","230","359","608","4.84"
"2","2017","28","Hotel","9","22","75","168","0","0","75","168","1"
"2","2017","28","Otros","11","15","164","677","6","18","170","695","2.3571428571429"
"2","2017","28","Otros","5","8","73","120","23","40","96","160","5"
"2","2017","28","Otros","14","27","40","40","3","3","43","43","11.833333333333"
"2","2017","28","Otros","13","27","222","266","52","156","274","422","12.2"
"2","2017","28","Otros","13","33","11","34","0","0","11","34","1"
"2","2017","28","Hotel","10","18","263","263","113","113","376","376","3.2"
"2","2017","28","Otros","6","25","192","234","6","6","198","240","1"
"2","2017","28","Otros","13","14","32","42","1","3","33","45","3.25"
"2","2017","8","Otros","10","23","16","28","4","8","20","36","1"
"2","2017","28","Otros","10","27","37","37","72","72","109","109","4.84"
"2","2017","28","Otros","13","14","140","354","35","88","175","442","3.25"
"2","2017","28","Otros","10","11","71","79","0","0","71","79","1"
"2","2017","28","Otros","15","16","11","24","0","0","11","24","1"
"2","2017","28","Otros","11","32","23","30","0","0","23","30","1"
"2","2017","28","Otros","9","37","35","183","0","0","35","183","4.5"
"2","2017","28","Otros","12","35","66","116","210","333","276","449","3.5"
"2","2017","28","Otros","8","34","127","202","57","96","184","298","5.75"
"2","2017","28","Hotel","16","40","25","36","68","158","93","194","16.333333333333"
"2","2017","28","Hotel","10","11","96","305","28","60","124","365","5.6666666666667"
"2","2017","28","Otros","7","27","33","111","0","0","33","111","4.8333333333333"
"2","2017","28","Hotel","7","38","16","34","0","0","16","34","1"
"2","2017","28","Otros","6","27","1","1","0","0","1","1","3.960088691796"
"2","2017","28","Otros","6","10","127","473","3","9","130","482","3.8518518518518"
"2","2017","28","Otros","6","25","410","853","2","12","412","865","1"
"2","2017","28","Otros","6","25","38","55","2","11","40","66","2.3846153846154"
"2","2017","28","Otros","6","27","101","470","20","151","121","621","3.960088691796"
"2","2017","28","Otros","6","10","55","88","0","0","55","88","1"
"2","2017","28","Otros","6","25","160","434","22","88","182","522","1"
"2","2017","28","Otros","6","27","257","574","14","28","271","602","3.960088691796"
"2","2017","28","Otros","5","5","62","93","7","15","69","108","3.65625"
"2","2017","28","Otros","5","5","12","19","0","0","12","19","3.65625"
"2","2017","28","Otros","5","8","63","73","7","10","70","83","9"
"2","2017","28","Otros","10","23","20","20","2","2","22","22","1"
"2","2017","28","Otros","3","4","21","47","22","25","43","72","12.2"
"2","2017","28","Otros","10","23","10","22","152","209","162","231","1"
"2","2017","28","Otros","10","23","40","66","17","25","57","91","7"
"2","2017","28","Otros","8","3","34","213","0","0","34","213","10"
"2","2017","28","Otros","13","14","62","186","15","45","77","231","3.25"
"2","2017","28","Otros","5","5","14","22","7","17","21","39","3.65625"
"2","2017","28","Otros","5","8","20","47","13","17","33","64","5"
"2","2017","28","Otros","6","10","243","550","28","50","271","600","3.8518518518518"
"2","2017","28","Otros","16","19","35","162","0","0","35","162","10.263157894737"
"2","2017","28","Otros","10","18","83","345","19","85","102","430","4.6"
"2","2017","28","Otros","11","15","72","176","0","0","72","176","2.3571428571429"
"2","2017","28","Otros","7","38","108","124","0","0","108","124","2.75"
"2","2017","28","Otros","11","32","220","538","26","46","246","584","2.2857142857143"
"2","2017","28","Otros","8","2","103","222","0","0","103","222","6.4285714285714"
"2","2017","28","Otros","10","27","23","56","8","14","31","70","4.84"
"2","2017","28","Otros","6","27","87","291","0","0","87","291","3.960088691796"
"2","2017","28","Otros","6","28","70","70","5","5","75","75","1"
"2","2017","28","Otros","13","14","158","391","5","5","163","396","1"
"2","2017","28","Otros","11","32","98","229","2","4","100","233","2.2857142857143"
"2","2017","28","Otros","8","34","38","47","85","129","123","176","5.75"
"2","2017","28","Otros","11","32","6","8","0","0","6","8","2.2857142857143"
"2","2017","28","Otros","10","18","52","62","31","38","83","100","4.6"
"2","2017","28","Otros","10","11","34","98","0","0","34","98","11.764705882353"
"2","2017","28","Otros","11","32","54","107","2","6","56","113","2.2857142857143"
"2","2017","28","Otros","14","31","0","0","23","56","23","56","20.2"
"2","2017","28","Hotel","8","3","255","598","68","157","323","755","1"
"2","2017","28","Hotel","14","31","87","139","716","2456","803","2595","17.4"
"2","2017","28","Otros","11","36","362","954","46","73","408","1027","5.1904761904762"
"2","2017","28","Hotel","15","16","1490","2614","305","535","1795","3149","2"
"2","2017","28","Otros","15","27","14","14","0","0","14","14","1.4222222222222"
"2","2017","28","Otros","5","5","17","26","16","27","33","53","3.65625"
"2","2017","28","Otros","8","34","10","10","11","11","21","21","5.75"
"2","2017","28","Otros","13","14","190","464","10","20","200","484","3.25"
"2","2017","28","Otros","7","27","51","165","0","0","51","165","4.8333333333333"
"2","2017","28","Otros","12","35","30","35","24","24","54","59","3.5"
"2","2017","28","Otros","5","5","100","219","6","7","106","226","3.65625"
"2","2017","28","Otros","10","11","16","52","4","4","20","56","11.764705882353"
"2","2017","28","Otros","10","11","7","8","0","0","7","8","11.764705882353"
"2","2017","28","Otros","9","30","8","160","0","0","8","160","2.3333333333333"
"2","2017","28","Otros","8","2","61","160","3","6","64","166","6.4285714285714"
"2","2017","28","Otros","10","27","87","109","148","238","235","347","4.84"
"2","2017","28","Otros","5","9","51","61","11","11","62","72","4.0454545454545"
"2","2017","28","Otros","10","27","0","0","8","192","8","192","3"
"2","2017","28","Otros","6","27","78","156","0","0","78","156","3.960088691796"
"2","2017","28","Otros","6","10","179","418","11","19","190","437","3.8518518518518"
"2","2017","28","Otros","6","10","143","347","0","0","143","347","3.8518518518518"
"2","2017","28","Otros","6","27","64","136","0","0","64","136","3.960088691796"
"2","2017","11","Otros","6","12","6","18","0","0","6","18","1.8256578947368"
"2","2017","28","Otros","6","10","122","392","0","0","122","392","3.8518518518518"
"2","2017","26","Otros","6","10","33","156","0","0","33","156","3.8518518518518"
"2","2017","28","Otros","6","27","32","96","0","0","32","96","3.960088691796"
"2","2017","28","Otros","6","12","105","265","0","0","105","265","1.8256578947368"
"2","2017","28","Otros","6","10","35","67","0","0","35","67","3.8518518518518"
"2","2017","28","Hotel","6","25","102","230","0","0","102","230","1"
"2","2017","6","Otros","6","10","20","20","0","0","20","20","1"
"2","2017","28","Otros","6","27","19","19","0","0","19","19","3.960088691796"
"2","2017","28","Otros","5","9","32","54","17","28","49","82","4.0454545454545"
"2","2017","28","Otros","5","5","56","83","28","29","84","112","3.65625"
"2","2017","28","Otros","5","5","24","48","8","12","32","60","3.65625"
"2","2017","28","Otros","5","5","104","152","43","83","147","235","3.65625"
"2","2017","28","Otros","5","9","57","88","6","15","63","103","5.5"
"2","2017","28","Otros","11","36","147","548","0","0","147","548","5.1904761904762"
"2","2017","28","Otros","10","27","15","15","0","0","15","15","3"
"2","2017","28","Otros","10","11","72","141","0","0","72","141","1"
"2","2017","28","Hotel","6","10","1067","3054","20","38","1087","3092","1"
"2","2017","28","Otros","5","9","43","49","7","10","50","59","4.0454545454545"
"2","2017","28","Otros","5","8","14","22","50","84","64","106","5"
"2","2017","0","Hotel","15","27","0","0","0","0","0","0","1"
"2","2017","28","Hotel","3","4","232","1326","70","284","302","1610","3"
"2","2017","28","Otros","3","7","30","91","11","26","41","117","1"
"2","2017","28","Otros","7","38","169","604","7","18","176","622","2.75"
"2","2017","28","Hotel","10","27","163","207","217","240","380","447","1"
"2","2017","28","Hotel","12","35","19","35","91","278","110","313","1.7272727272727"
"2","2017","28","Hotel","10","27","18","18","0","0","18","18","2.25"
"2","2017","28","Hotel","7","17","744","1679","195","476","939","2155","4"
"2","2017","17","Hotel","16","19","53","103","11","18","64","121","4"
"2","2017","28","Hotel","2","6","364","1748","0","0","364","1748","2.2"
"2","2017","28","Otros","5","5","101","453","24","106","125","559","3.65625"
"2","2017","28","Hotel","10","18","50","152","97","251","147","403","1"
"2","2017","28","Otros","12","24","49","77","147","187","196","264","9.2"
"2","2017","28","Otros","5","8","54","103","15","28","69","131","5"
"2","2017","28","Otros","4","13","146","181","9","9","155","190","1"
"2","2017","28","Otros","10","11","159","259","0","0","159","259","11.764705882353"
"2","2017","28","Otros","12","35","60","83","129","147","189","230","3.5"
"2","2017","28","Otros","10","23","135","179","21","21","156","200","7"
"2","2017","28","Otros","11","36","612","1427","87","175","699","1602","5.1904761904762"
"2","2017","28","Otros","12","35","96","171","187","214","283","385","3.5"
"2","2017","28","Otros","11","36","179","490","0","0","179","490","5.1904761904762"
"2","2017","28","Otros","8","2","121","409","18","54","139","463","6.4285714285714"
"2","2017","28","Otros","9","30","179","537","0","0","179","537","2.3333333333333"
"2","2017","28","Otros","11","36","135","375","25","45","160","420","5.1904761904762"
"2","2017","28","Otros","6","10","90","217","0","0","90","217","3.8518518518518"
"2","2017","28","Otros","10","18","63","236","10","30","73","266","10.25"
"2","2017","28","Otros","10","11","45","175","0","0","45","175","1"
"2","2017","28","Otros","7","27","48","171","1","6","49","177","4.8333333333333"
"2","2017","28","Otros","16","20","180","880","60","240","240","1120","1"
"2","2017","28","Otros","9","22","45","76","0","0","45","76","7.6428571428571"
"2","2017","28","Otros","15","16","216","290","0","0","216","290","1"
"2","2017","28","Otros","5","5","276","341","30","40","306","381","3.65625"
"2","2017","28","Otros","12","35","71","83","66","81","137","164","3.5"
"2","2017","28","Otros","10","11","27","54","0","0","27","54","11.764705882353"
"2","2017","28","Otros","10","11","29","69","4","4","33","73","11.764705882353"
"2","2017","24","Otros","5","9","95","153","3","3","98","156","4.0454545454545"
"2","2017","28","Otros","5","5","4","112","0","0","4","112","3.65625"
"2","2017","28","Otros","10","11","77","121","33","56","110","177","1"
"2","2017","28","Otros","12","35","7","19","62","122","69","141","3.5"
"2","2017","28","Otros","7","38","83","300","12","30","95","330","2.75"
"2","2017","28","Hotel","12","35","0","0","145","359","145","359","1.7272727272727"
"2","2017","28","Otros","13","14","104","310","2","4","106","314","1"
"2","2017","28","Otros","5","5","52","72","27","33","79","105","3.65625"
"2","2017","28","Otros","8","3","109","374","48","154","157","528","14.75"
"2","2017","28","Hotel","9","26","8","20","0","0","8","20","1.5"
"2","2017","28","Hotel","16","19","224","235","0","0","224","235","1"
"2","2017","28","Otros","9","22","55","55","0","0","55","55","3.25"
"2","2017","28","Otros","16","19","96","142","0","0","96","142","10.263157894737"
"2","2017","28","Otros","9","30","39","76","2","2","41","78","2.3333333333333"
"2","2017","28","Otros","16","19","46","63","0","0","46","63","10.263157894737"
"2","2017","28","Otros","16","19","157","736","0","0","157","736","10.263157894737"
"2","2017","28","Otros","9","26","5","7","0","0","5","7","3.8888888888889"
"2","2017","28","Otros","16","40","4","12","0","0","4","12","28.142857142857"
"2","2017","28","Hotel","16","27","33","59","0","0","33","59","5.8571428571429"
"2","2017","28","Otros","16","19","85","347","0","0","85","347","10.263157894737"
"2","2017","28","Otros","16","19","101","255","0","0","101","255","10.263157894737"
"2","2017","28","","9","30","119","206","39","90","158","296","1"
"2","2017","28","Otros","16","19","143","354","0","0","143","354","10.263157894737"
"2","2017","28","Otros","10","11","25","29","10","32","35","61","11.764705882353"
"2","2017","28","Otros","11","36","18","31","4","8","22","39","5.1904761904762"
"2","2017","28","Otros","16","19","18","70","0","0","18","70","10.263157894737"
"2","2017","28","Otros","16","19","154","478","3","9","157","487","1.3333333333333"
"2","2017","28","Otros","16","19","43","120","0","0","43","120","10.263157894737"
"2","2017","28","Otros","10","18","30","68","56","122","86","190","10.25"
"2","2017","28","Otros","16","19","70","70","0","0","70","70","10.263157894737"
"2","2017","28","Otros","16","19","57","178","0","0","57","178","1.3333333333333"
"2","2017","28","","9","26","417","1476","0","0","417","1476","1"
"2","2017","28","Otros","16","19","26","51","0","0","26","51","10.263157894737"
"2","2017","28","Otros","16","19","76","132","26","34","102","166","10.263157894737"
"2","2017","28","Hotel","8","2","895","1814","169","339","1064","2153","1"
"2","2017","28","Otros","6","10","142","293","4","5","146","298","3.8518518518518"
"2","2017","20","Otros","6","25","96","186","0","0","96","186","1"
"2","2017","28","Otros","6","12","172","290","0","0","172","290","1.8256578947368"
"2","2017","28","Hotel","16","19","834","1666","16","52","850","1718","1"
"2","2017","11","Otros","3","7","6","8","16","22","22","30","2"
"2","2017","28","Hotel","2","6","1759","5777","1979","2996","3738","8773","1"
"2","2017","28","Hotel","3","4","208","690","62","309","270","999","2.6"
"2","2017","28","Hotel","16","40","2277","3886","1792","3056","4069","6942","1"
"2","2017","28","Otros","16","27","130","542","0","0","130","542","13.818181818182"
"2","2017","28","Hotel","6","28","353","406","153","205","506","611","2.4"
"2","2017","28","Hotel","8","34","449","628","303","524","752","1152","1"
"2","2017","28","Otros","12","35","10","10","5","5","15","15","2.6666666666667"
"2","2017","28","Otros","9","30","10","14","0","0","10","14","2.3333333333333"
"2","2017","28","Hotel","10","18","276","276","251","251","527","527","1"
"2","2017","28","Hotel","9","30","224","441","3","6","227","447","1"
"2","2017","28","Hotel","15","27","15","15","0","0","15","15","1"
"2","2017","28","Hotel","9","22","160","315","0","0","160","315","2.5555555555556"
"2","2017","28","","11","15","354","1055","78","234","432","1289","1"
"2","2017","28","Otros","6","12","18","23","3","4","21","27","1.8256578947368"
"2","2017","28","Otros","6","28","0","0","0","0","0","0","1"
"2","2017","28","Hotel","15","27","80","1760","0","0","80","1760","1"
"2","2017","28","Otros","15","27","70","82","0","0","70","82","1.4222222222222"
"2","2017","28","Otros","15","27","9","9","0","0","9","9","1.4222222222222"
"2","2017","28","Otros","12","35","32","35","2","2","34","37","2.6666666666667"
"2","2017","28","Otros","2","1","15","15","12","12","27","27","1"
"2","2017","28","Otros","12","24","8","12","8","10","16","22","9.2"
"2","2017","28","Otros","5","5","41","80","19","50","60","130","3.65625"
"2","2017","28","Otros","6","28","102","199","3","9","105","208","1"
"2","2017","28","Hotel","7","27","583","656","92","92","675","748","1"
"2","2017","28","Otros","16","20","118","287","10","20","128","307","3.0769230769231"
"2","2017","28","Otros","10","11","12","32","0","0","12","32","1"
"2","2017","28","","10","11","310","607","26","76","336","683","1"
"2","2017","28","Hotel","16","40","72","377","7","24","79","401","16.333333333333"
"2","2017","28","Otros","12","35","19","26","7","7","26","33","3.5"
"2","2017","28","Hotel","6","27","77","77","0","0","77","77","3"
"2","2017","28","Otros","5","5","31","59","11","25","42","84","3.65625"
"2","2017","28","Hotel","6","27","76","110","28","43","104","153","3"
"2","2017","28","Otros","6","25","108","172","10","32","118","204","2.3846153846154"
"2","2017","28","Otros","9","37","39","68","0","0","39","68","19"
"2","2017","28","Hotel","15","27","80","174","2","3","82","177","1"
"2","2017","28","Otros","16","19","256","466","13","30","269","496","1"
"2","2017","28","Otros","5","9","46","55","42","78","88","133","4.0454545454545"
"2","2017","28","Hotel","15","27","30","60","2","2","32","62","1"
"2","2017","28","Hotel","5","9","25","54","5","9","30","63","1"
"2","2017","28","Hotel","8","34","78","119","108","170","186","289","2.5714285714286"
"2","2017","0","Hotel","15","27","0","0","0","0","0","0","1"
"2","2017","28","Hotel","6","27","382","906","4","4","386","910","3"
"2","2017","28","Otros","6","27","49","253","0","0","49","253","1"
"2","2017","28","Hotel","7","17","133","278","17","39","150","317","1"
"2","2017","28","Otros","12","27","0","0","9","14","9","14","3.4285714285714"
"2","2017","28","Hotel","12","35","82","197","349","892","431","1089","1"
"2","2017","28","Hotel","2","27","405","869","39","210","444","1079","1"
"2","2017","28","Hotel","10","27","42","121","137","347","179","468","1"
"2","2017","28","Hotel","2","6","18","234","0","0","18","234","1"
"2","2017","28","Otros","2","6","21","45","0","0","21","45","1"
"2","2017","28","Hotel","4","39","313","313","0","0","313","313","1"
"2","2017","28","Otros","16","27","62","252","0","0","62","252","1"
"2","2017","28","Hotel","6","10","432","533","30","44","462","577","1"
"2","2017","28","Hotel","8","3","17","34","140","391","157","425","1"
"2","2017","28","Otros","5","8","52","76","69","115","121","191","5"
"2","2017","28","Hotel","13","33","803","1154","453","753","1256","1907","1"
"2","2017","28","Hotel","13","33","44","67","96","186","140","253","1"
"2","2017","28","Otros","11","32","235","782","28","52","263","834","2.2857142857143"
"2","2017","28","Hotel","9","26","159","258","159","197","318","455","1"
"2","2017","28","Hotel","16","20","197","382","22","58","219","440","1"
"2","2017","28","Hotel","9","37","221","291","1","1","222","292","1"
"2","2017","28","Otros","16","20","15","25","11","14","26","39","3.0769230769231"
"2","2017","28","","16","40","1130","3544","88","487","1218","4031","1"
"2","2017","28","Hotel","12","24","116","150","3331","5362","3447","5512","1"
"2","2017","28","Hotel","15","16","1583","4432","530","2196","2113","6628","1"
"2","2017","28","Hotel","5","9","21","24","31","46","52","70","1"
"2","2017","28","Otros","7","38","82","499","0","0","82","499","2.75"
"2","2017","28","Otros","2","6","129","905","0","0","129","905","1"
"2","2017","28","Otros","2","6","105","187","0","0","105","187","1"
"2","2017","28","Hotel","12","24","209","409","1665","4082","1874","4491","1"
"2","2017","0","Hotel","8","34","0","0","0","0","0","0","1"
"2","2017","28","Hotel","15","27","215","728","64","64","279","792","1"
"2","2017","28","Otros","7","38","160","354","0","0","160","354","2.75"
"2","2017","28","Otros","2","1","7","67","6","10","13","77","1"
"2","2017","28","Otros","8","3","174","314","22","22","196","336","10"
"2","2017","28","Hotel","12","35","34","72","205","408","239","480","2"
"2","2017","28","Otros","11","36","36","185","0","0","36","185","5.1904761904762"
"2","2017","28","Otros","16","20","69","159","0","0","69","159","3.0769230769231"
"2","2017","28","Otros","8","3","704","1170","1","1","705","1171","1"
"2","2017","28","Otros","4","39","67","92","0","0","67","92","2.2222222222222"
"2","2017","28","Otros","5","5","150","415","130","254","280","669","3.65625"
"2","2017","28","Otros","12","27","6","6","10","10","16","16","3.4285714285714"
"2","2017","28","Otros","7","27","210","605","16","80","226","685","1"
"2","2017","28","Hotel","2","6","6","8","91","140","97","148","1"
"2","2017","28","Otros","12","24","11","20","61","100","72","120","1"
"2","2017","28","Hotel","14","27","26","33","49","79","75","112","1"
"2","2017","28","Hotel","16","19","175","825","59","413","234","1238","1"
"2","2017","28","","2","1","54","432","0","0","54","432","1"
"2","2017","28","Hotel","2","27","48","134","5","6","53","140","1"
"2","2017","28","Otros","16","20","478","1077","18","39","496","1116","1"
"2","2017","28","Otros","13","14","34","54","2","4","36","58","1"
"2","2017","28","Hotel","11","36","130","183","9","9","139","192","2.375"
"2","2017","28","Otros","13","14","8","120","0","0","8","120","7.3846153846154"
"2","2017","28","Otros","12","27","25","31","0","0","25","31","3.4285714285714"
"2","2017","28","Hotel","2","6","240","405","33","33","273","438","2.2"
"2","2017","28","Otros","2","6","553","2184","0","0","553","2184","1"
"2","2017","28","Otros","10","27","3","84","0","0","3","84","4.84"
"2","2017","28","Otros","12","27","4","4","3","3","7","7","3.4285714285714"
"2","2017","28","Otros","13","14","13","13","0","0","13","13","7.3846153846154"
"2","2017","28","Otros","6","12","99","193","25","71","124","264","1.8256578947368"
"2","2017","28","Otros","2","6","1437","3352","114","332","1551","3684","1"
"2","2017","28","Hotel","16","40","167","320","17","34","184","354","1"
"2","2017","28","Hotel","12","35","96","193","265","414","361","607","1.7272727272727"
"2","2017","28","Otros","5","5","29","34","11","13","40","47","3.65625"
"2","2017","28","Otros","11","32","47","196","0","0","47","196","1"
"2","2017","28","Otros","9","30","0","0","6","168","6","168","2.3333333333333"
"2","2017","28","Otros","11","15","2","29","0","0","2","29","1"
"2","2017","28","Hotel","8","2","28","52","7","13","35","65","1"
"2","2017","28","Otros","9","30","14","16","0","0","14","16","2.3333333333333"
"2","2017","28","Otros","10","27","66","225","4","5","70","230","3"
"2","2017","28","Hotel","15","27","48","48","3","3","51","51","1"
"2","2017","28","Hotel","3","7","32","32","0","0","32","32","1"
"2","2017","28","Otros","6","12","80","140","0","0","80","140","1.8256578947368"
"2","2017","28","Otros","12","27","25","26","18","18","43","44","3.4285714285714"
"2","2017","28","Otros","2","6","9","28","1","1","10","29","5"
"2","2017","28","Otros","6","27","60","190","0","0","60","190","3.960088691796"
"2","2017","28","Hotel","10","11","200","461","15","38","215","499","1"
"2","2017","28","Otros","2","1","10","70","0","0","10","70","1"
"2","2017","28","Hotel","4","13","0","0","0","0","0","0","1"
"2","2017","28","Otros","11","36","60","60","2","2","62","62","5.1904761904762"
"2","2017","0","Hotel","11","32","0","0","0","0","0","0","1"
"2","2017","28","Otros","2","27","8","224","0","0","8","224","1"
"2","2017","28","Otros","12","27","4","4","13","13","17","17","3.4285714285714"
"2","2017","28","Hotel","8","2","121","190","8","8","129","198","3"
"2","2017","28","Hotel","16","20","49","114","0","0","49","114","1"
"2","2017","28","Otros","12","35","0","0","104","136","104","136","3.5"
"2","2017","28","Otros","13","14","75","168","7","27","82","195","1"
"2","2017","28","Hotel","16","19","103","357","0","0","103","357","1"
"2","2017","28","Otros","2","27","49","252","0","0","49","252","3.2"
"2","2017","28","Hotel","6","27","19","19","0","0","19","19","3"
"2","2017","28","Hotel","8","3","238","705","63","164","301","869","4.1111111111111"
"2","2017","28","Hotel","12","24","83","130","250","405","333","535","1"
"2","2017","28","Hotel","15","27","203","278","32","88","235","366","1"
"2","2017","28","Otros","8","3","199","600","30","49","229","649","10"
"2","2017","28","Hotel","16","20","62","381","46","380","108","761","1"
"2","2017","28","Hotel","6","28","125","139","0","0","125","139","2.4"
"2","2017","28","Otros","7","17","77","298","0","0","77","298","3"
"2","2017","28","Otros","2","1","54","101","10","15","64","116","5.5"
"2","2017","28","Hotel","11","36","213","346","175","233","388","579","2.375"
"2","2017","28","Otros","4","13","238","947","0","0","238","947","1"
"2","2017","28","Hotel","12","35","136","329","83","109","219","438","2"
"2","2017","28","Otros","2","6","177","1239","0","0","177","1239","1"
"2","2017","0","Otros","8","34","0","0","0","0","0","0","5.75"
"2","2017","28","Hotel","11","15","8","8","0","0","8","8","1"
"2","2017","28","Otros","12","27","64","128","35","69","99","197","1"
"2","2017","28","Otros","15","27","16","40","0","0","16","40","1.4222222222222"
"2","2017","28","Otros","16","40","37","89","28","100","65","189","1"
"2","2017","28","Otros","12","27","4","16","6","32","10","48","1"
"2","2017","28","Hotel","13","14","293","600","36","80","329","680","1"
"2","2017","28","Otros","3","4","65","92","41","43","106","135","1"
"2","2017","28","Hotel","13","14","244","470","34","58","278","528","1"
"2","2017","28","Hotel","9","30","108","216","14","28","122","244","1"
"2","2017","28","Hotel","4","13","302","510","157","206","459","716","5.4"
"2","2017","28","Otros","6","27","14","23","0","0","14","23","3.960088691796"
"2","2017","21","Hotel","15","27","13","37","16","42","29","79","1"
"2","2017","28","Hotel","2","29","30","110","83","313","113","423","2"
"2","2017","28","Hotel","13","33","13","21","50","94","63","115","2"
"2","2017","28","Hotel","12","35","96","193","265","414","361","607","1.7272727272727"
"2","2017","28","Hotel","13","14","516","1050","38","67","554","1117","1"
"2","2017","28","Otros","6","25","75","208","0","0","75","208","2.3846153846154"
"2","2017","28","Hotel","8","2","18","63","9","23","27","86","3"
"2","2017","28","Otros","2","29","25","89","54","186","79","275","1"
"2","2017","28","Otros","4","39","91","163","0","0","91","163","2.2222222222222"
"2","2017","28","Otros","6","12","103","117","15","26","118","143","1.8256578947368"
"2","2017","28","Otros","13","33","91","237","3","6","94","243","1"
"2","2017","28","Otros","13","33","62","87","8","10","70","97","5.125"
"2","2017","28","Hotel","4","13","50","111","33","84","83","195","5.4"
"2","2017","28","Otros","12","24","49","115","71","111","120","226","1"
"2","2017","28","Hotel","7","27","345","620","0","0","345","620","4.1666666666667"
"2","2017","28","Hotel","4","13","545","1383","144","245","689","1628","1"
"2","2017","28","","5","8","17","24","21","34","38","58","1"
"2","2017","28","Otros","8","2","158","338","29","42","187","380","6.4285714285714"
"2","2017","28","Otros","6","27","142","533","0","0","142","533","3.6666666666667"
"2","2017","28","Otros","2","6","50","50","30","30","80","80","1"
"2","2017","28","","6","10","105","136","6","26","111","162","1"
"2","2017","28","Hotel","2","29","36","48","92","134","128","182","2"
"2","2017","28","","14","31","103","159","557","1756","660","1915","1"
"2","2017","28","Hotel","16","27","7654","24989","0","0","7654","24989","1"
"2","2017","28","Hotel","12","35","80","129","125","184","205","313","1.7272727272727"
"2","2017","28","","12","35","3163","3587","3761","4067","6924","7654","1"
"2","2017","28","","9","26","30","71","0","0","30","71","1"
"2","2017","28","Otros","11","32","364","561","0","0","364","561","2.2857142857143"
"2","2017","28","Otros","12","24","56","114","96","195","152","309","9.2"
"2","2017","28","Hotel","6","25","45","65","0","0","45","65","1"
"2","2017","28","Otros","7","17","70","426","0","0","70","426","3"
"2","2017","28","Otros","11","32","96","201","2","2","98","203","2.2857142857143"
"2","2017","28","Hotel","16","19","197","394","2","2","199","396","4"
"2","2017","28","Otros","8","3","50","190","35","67","85","257","14.75"
"2","2017","28","Hotel","7","17","35","81","0","0","35","81","1"
"2","2017","28","Otros","13","33","0","0","57","85","57","85","5.125"
"2","2017","28","Otros","16","27","12","62","0","0","12","62","13.818181818182"
"2","2017","28","Otros","6","12","186","306","9","11","195","317","1.8256578947368"
"2","2017","28","Otros","2","29","8","24","4","4","12","28","3.28"
"2","2017","28","Hotel","14","27","164","169","50","50","214","219","1"
"2","2017","28","Otros","2","1","1","1","0","0","1","1","1"
"2","2017","28","Otros","11","32","68","178","0","0","68","178","2.2857142857143"
"2","2017","28","Otros","2","27","3","7","0","0","3","7","1"
"2","2017","28","Hotel","2","29","25","50","59","118","84","168","1"
"2","2017","28","Hotel","4","13","31","249","0","0","31","249","3.2"
"2","2017","28","Hotel","4","21","128","1120","0","0","128","1120","3"
"2","2017","28","Otros","7","27","274","535","0","0","274","535","4.8333333333333"
"2","2017","28","","3","4","91","199","69","165","160","364","1"
"2","2017","28","Hotel","6","27","23","27","21","29","44","56","3"
"2","2017","28","Otros","16","19","73","154","0","0","73","154","10.263157894737"
"2","2017","0","Otros","11","32","0","0","0","0","0","0","2.2857142857143"
"2","2017","28","Otros","3","7","26","30","20","38","46","68","2"
"2","2017","28","Otros","5","5","41","68","32","65","73","133","3.65625"
"2","2017","24","Otros","15","27","1008","1008","0","0","1008","1008","1.4222222222222"
"2","2017","28","Otros","6","25","255","611","0","0","255","611","2.3846153846154"
"2","2017","28","","10","27","77","150","23","33","100","183","1"
"2","2017","28","Otros","2","29","53","89","171","245","224","334","3.28"
"2","2017","28","Otros","12","35","7","17","55","63","62","80","3.5"
"2","2017","28","Otros","16","19","80","324","0","0","80","324","10.263157894737"
"2","2017","28","Otros","9","26","46","73","0","0","46","73","3.8888888888889"
"2","2017","28","Hotel","13","33","124","136","50","50","174","186","2"
"2","2017","28","Otros","11","32","10","72","0","0","10","72","2.2857142857143"
"2","2017","28","Otros","9","22","27","62","0","0","27","62","7.6428571428571"
"2","2017","28","Otros","6","27","11","101","0","0","11","101","3.960088691796"
"2","2017","28","Otros","15","27","77","93","0","0","77","93","1.4222222222222"
"2","2017","28","Otros","11","32","161","168","36","36","197","204","2.2857142857143"
"2","2017","0","Otros","11","15","0","0","0","0","0","0","2.3571428571429"
"2","2017","8","Otros","9","37","3","24","0","0","3","24","4.5"
"2","2017","28","Otros","5","9","54","70","27","35","81","105","4.0454545454545"
"2","2017","28","Hotel","10","27","36","40","0","0","36","40","2.25"
"2","2017","28","Otros","6","28","8","57","1","16","9","73","4.65"
"2","2017","28","Otros","4","13","67","104","25","32","92","136","3.4"
"2","2017","28","Otros","2","1","1","1","0","0","1","1","1"
"2","2017","28","Otros","2","29","50","102","49","98","99","200","3.28"
"2","2017","28","Hotel","8","3","143","374","11","37","154","411","4.1111111111111"
"2","2017","28","Otros","16","19","288","1787","0","0","288","1787","1.3333333333333"
"2","2017","28","Otros","12","35","15","15","64","71","79","86","3.5"
"2","2017","28","Hotel","12","35","48","70","224","278","272","348","1.7272727272727"
"2","2017","28","Otros","12","35","44","52","24","26","68","78","3.5"
"2","2017","28","Otros","2","29","34","54","81","135","115","189","3.28"
"2","2017","28","Hotel","7","27","321","466","8","10","329","476","1"
"2","2017","28","Hotel","9","22","70","106","5","6","75","112","2.5555555555556"
"2","2017","28","Hotel","12","35","62","134","208","266","270","400","1.7272727272727"
"2","2017","28","Otros","15","16","194","455","66","172","260","627","2"
"2","2017","28","Hotel","15","27","15","15","0","0","15","15","1"
"2","2017","28","Otros","4","13","57","57","0","0","57","57","3.4"
"2","2017","28","Hotel","8","34","129","229","73","111","202","340","2.5714285714286"
"2","2017","28","Hotel","16","20","760","770","0","0","760","770","1"
"2","2017","28","Hotel","6","28","316","316","104","104","420","420","2.4"
"2","2017","28","Hotel","15","27","70","196","9","12","79","208","1"
"2","2017","28","Otros","12","35","168","511","96","192","264","703","3.5"
"2","2017","28","Otros","11","15","34","36","0","0","34","36","2.3571428571429"
"2","2017","28","Otros","11","15","120","585","11","130","131","715","2.3571428571429"
"2","2017","28","Otros","11","36","132","318","69","109","201","427","5.1904761904762"
"2","2017","28","Hotel","11","36","54","134","8","22","62","156","2.375"
"2","2017","28","Hotel","6","12","91","243","0","0","91","243","5"
"2","2017","28","Otros","8","3","185","317","50","51","235","368","10"
"2","2017","28","Otros","10","27","20","30","46","75","66","105","4.84"
"2","2017","28","Otros","8","3","52","237","15","35","67","272","10"
"2","2017","28","Otros","6","25","113","208","0","0","113","208","2.3846153846154"
"2","2017","28","Hotel","2","27","76","109","0","0","76","109","1"
"2","2017","28","Hotel","10","18","108","540","177","517","285","1057","3.2"
"2","2017","28","Otros","11","32","158","1122","0","0","158","1122","1"
"2","2017","28","Hotel","6","10","870","1072","406","564","1276","1636","1"
"2","2017","28","Otros","4","13","165","177","24","34","189","211","1"
"2","2017","28","Otros","11","32","87","191","15","41","102","232","2.2857142857143"
"2","2017","0","Otros","2","27","0","0","0","0","0","0","1"
"2","2017","28","Otros","4","13","66","1848","0","0","66","1848","1"
"2","2017","28","","12","24","120","215","876","1551","996","1766","1"
"2","2017","28","Hotel","16","27","304","464","0","0","304","464","5.8571428571429"
"2","2017","28","Hotel","7","38","104","284","18","18","122","302","1"
"2","2017","28","Hotel","6","12","427","427","0","0","427","427","1"
"3","2017","31","Hotel","14","31","3216","5175","8731","10636","11947","15811","1"
"3","2017","31","Hotel","14","31","590","906","2693","7669","3283","8575","1"
"3","2017","31","Hotel","14","31","1278","1626","2211","7785","3489","9411","1"
"3","2017","31","Hotel","11","32","107","157","26","62","133","219","1"
"3","2017","31","Hotel","14","27","3056","5031","624","1030","3680","6061","1"
"3","2017","31","Otros","11","32","118","215","0","0","118","215","2.2857142857143"
"3","2017","31","Hotel","14","31","224","297","4412","5535","4636","5832","5.4"
"3","2017","31","Hotel","15","16","900","3252","62","269","962","3521","1"
"3","2017","31","Hotel","14","31","1040","2117","1135","3531","2175","5648","5.4"
"3","2017","31","Hotel","12","24","3292","3300","4331","7370","7623","10670","1"
"3","2017","31","Hotel","16","40","1157","1981","880","1836","2037","3817","1"
"3","2017","31","Hotel","6","12","1296","1709","55","73","1351","1782","1"
"3","2017","31","Hotel","10","23","1415","2371","226","500","1641","2871","1"
"3","2017","31","Hotel","14","31","1804","3053","371","749","2175","3802","5.4"
"3","2017","31","Hotel","3","4","607","1271","158","1749","765","3020","1"
"3","2017","31","","11","32","290","469","49","86","339","555","1"
"3","2017","31","Hotel","6","12","446","750","149","1634","595","2384","1"
"3","2017","31","Hotel","6","12","2489","3233","329","396","2818","3629","1"
"3","2017","31","Hotel","9","26","2176","4281","546","788","2722","5069","1"
"3","2017","31","Hotel","2","1","2453","3679","301","432","2754","4111","1"
"3","2017","31","Hotel","9","26","741","1622","391","2875","1132","4497","1"
"3","2017","31","Hotel","6","12","657","1106","130","131","787","1237","1"
"3","2017","31","Hotel","14","31","86","115","5200","7956","5286","8071","5.4"
"3","2017","31","Hotel","11","32","130","245","7","21","137","266","1"
"3","2017","31","Hotel","2","6","1946","2572","333","546","2279","3118","1"
"3","2017","31","Hotel","16","40","1399","2380","1582","2590","2981","4970","1"
"3","2017","31","Hotel","14","27","957","2165","644","1747","1601","3912","1"
"3","2017","31","Otros","11","36","238","444","18","36","256","480","1"
"3","2017","31","Hotel","10","23","837","1288","586","1117","1423","2405","1"
"3","2017","31","Hotel","14","31","201","509","983","3463","1184","3972","7.8"
"3","2017","31","Hotel","7","17","780","1401","72","181","852","1582","1"
"3","2017","31","Hotel","2","1","2423","2905","147","312","2570","3217","2"
"3","2017","31","Hotel","2","1","1737","2507","331","676","2068","3183","2"
"3","2017","31","Hotel","4","13","910","1626","270","496","1180","2122","1"
"3","2017","31","Hotel","2","1","2418","2589","218","242","2636","2831","2"
"3","2017","31","Hotel","10","27","1574","3398","719","1285","2293","4683","1"
"3","2017","31","Hotel","14","27","1258","2037","1487","2324","2745","4361","1"
"3","2017","31","Hotel","14","27","2093","2775","1079","1851","3172","4626","1"
"3","2017","31","Hotel","6","12","1291","2621","92","247","1383","2868","1"
"3","2017","31","Hotel","6","12","1558","1967","755","895","2313","2862","1"
"3","2017","31","Hotel","13","27","1804","3967","13","29","1817","3996","1"
"3","2017","31","Hotel","14","31","269","554","1713","3637","1982","4191","7.8"
"3","2017","31","Hotel","6","12","1323","2322","271","477","1594","2799","1"
"3","2017","31","Hotel","16","27","2464","4635","90","168","2554","4803","1"
"3","2017","31","","10","27","162","435","17","25","179","460","1"
"3","2017","31","Hotel","10","18","798","1571","801","1668","1599","3239","1"
"3","2017","31","Hotel","9","37","1820","3319","388","732","2208","4051","1"
"3","2017","31","Hotel","16","27","1200","4802","0","0","1200","4802","1"
"3","2017","31","Hotel","15","16","624","1145","126","323","750","1468","2"
"3","2017","31","Hotel","2","1","1156","1985","237","405","1393","2390","2"
"3","2017","31","Hotel","3","4","598","1337","154","307","752","1644","1"
"3","2017","31","Hotel","16","40","1184","1829","1384","2100","2568","3929","1"
"3","2017","31","Hotel","7","17","2922","3850","633","769","3555","4619","1"
"3","2017","31","Hotel","12","24","879","1440","2140","2848","3019","4288","1"
"3","2017","31","Hotel","12","35","814","1536","1583","2645","2397","4181","1"
"3","2017","31","Hotel","2","6","342","785","15","15","357","800","1"
"3","2017","31","Hotel","13","33","1191","1200","387","424","1578","1624","1"
"3","2017","31","Hotel","10","27","1261","2038","816","1169","2077","3207","1"
"3","2017","31","Hotel","10","23","1237","1807","252","414","1489","2221","1"
"3","2017","31","Hotel","11","36","1376","2171","350","1145","1726","3316","1"
"3","2017","31","Hotel","8","34","1514","2229","30","30","1544","2259","1"
"3","2017","31","Hotel","2","6","637","1627","284","453","921","2080","1"
"3","2017","31","Hotel","14","31","381","799","1242","2104","1623","2903","7.8"
"3","2017","31","Hotel","11","36","2029","3013","216","344","2245","3357","1"
"3","2017","31","","10","27","0","0","232","498","232","498","1"
"3","2017","31","Hotel","14","31","1806","2665","2892","6843","4698","9508","5.4"
"3","2017","31","Hotel","4","13","2820","2834","11","14","2831","2848","1"
"3","2017","31","Hotel","6","28","914","1087","94","123","1008","1210","1"
"3","2017","31","Otros","14","31","55","87","282","420","337","507","2.8"
"3","2017","31","Otros","16","27","50","50","0","0","50","50","2"
"3","2017","31","Hotel","2","1","973","1746","97","242","1070","1988","2"
"3","2017","31","Hotel","10","18","939","1532","866","1414","1805","2946","1"
"3","2017","31","Hotel","7","17","896","1354","220","330","1116","1684","1"
"3","2017","31","Hotel","12","24","549","1540","594","1933","1143","3473","1"
"3","2017","31","Hotel","10","18","1143","2120","662","1197","1805","3317","1"
"3","2017","31","Hotel","2","1","4128","4769","59","97","4187","4866","1"
"3","2017","31","Hotel","10","18","516","1261","430","956","946","2217","1"
"3","2017","31","Hotel","6","28","1706","2235","406","466","2112","2701","1"
"3","2017","31","Hotel","5","5","715","1878","516","1222","1231","3100","1"
"3","2017","31","Hotel","4","13","802","875","46","118","848","993","1"
"3","2017","31","Hotel","10","18","1669","2138","990","1571","2659","3709","1"
"3","2017","31","Hotel","16","40","1122","1706","245","419","1367","2125","1"
"3","2017","31","Hotel","8","3","1017","2196","312","708","1329","2904","1"
"3","2017","31","Hotel","15","16","1610","2867","307","581","1917","3448","2"
"3","2017","31","Hotel","14","31","155","323","267","1149","422","1472","7.8"
"3","2017","31","Hotel","13","33","78","101","492","894","570","995","1"
"3","2017","31","Hotel","15","16","742","1137","349","555","1091","1692","2"
"3","2017","31","Otros","4","21","143","215","6","12","149","227","1"
"3","2017","31","Hotel","6","10","790","1342","0","0","790","1342","1"
"3","2017","31","Hotel","16","19","278","458","34","59","312","517","1"
"3","2017","31","Hotel","16","27","702","2112","6","17","708","2129","1"
"3","2017","31","Hotel","10","11","2799","3694","262","449","3061","4143","1"
"3","2017","31","Otros","10","23","397","766","25","56","422","822","1"
"3","2017","31","Hotel","12","35","156","262","287","516","443","778","1"
"3","2017","31","Hotel","11","36","515","955","503","850","1018","1805","1"
"3","2017","31","Hotel","14","31","106","479","171","1663","277","2142","17.4"
"3","2017","31","Hotel","10","18","498","1291","860","1973","1358","3264","3.2"
"3","2017","31","Hotel","4","13","310","495","121","185","431","680","1"
"3","2017","31","Hotel","6","12","336","487","87","222","423","709","5"
"3","2017","31","Hotel","6","10","505","692","65","126","570","818","1"
"3","2017","31","Otros","5","5","305","504","129","404","434","908","3.65625"
"3","2017","31","Hotel","12","24","766","834","1139","1696","1905","2530","1"
"3","2017","31","Hotel","8","3","1301","2486","227","453","1528","2939","1"
"3","2017","31","Hotel","13","27","734","1227","0","0","734","1227","2.75"
"3","2017","31","Hotel","15","16","218","902","54","342","272","1244","4"
"3","2017","31","Otros","15","16","359","1242","65","237","424","1479","2"
"3","2017","31","Otros","16","20","382","592","12","12","394","604","1"
"3","2017","31","Hotel","3","4","703","1215","11","12","714","1227","1"
"3","2017","31","Hotel","11","36","111","139","0","0","111","139","1"
"3","2017","31","Hotel","2","6","386","702","122","185","508","887","1"
"3","2017","31","Hotel","8","34","765","1322","157","269","922","1591","1"
"3","2017","31","Hotel","4","13","169","360","0","0","169","360","3.2"
"3","2017","31","Hotel","13","27","473","891","8","14","481","905","2.75"
"3","2017","31","Hotel","2","29","351","657","907","1609","1258","2266","1"
"3","2017","31","Otros","11","36","100","288","2","18","102","306","1"
"3","2017","31","","10","11","16","16","0","0","16","16","1"
"3","2017","31","Hotel","4","13","783","1127","45","85","828","1212","1"
"3","2017","31","Hotel","16","40","2020","3032","886","1331","2906","4363","5.6666666666667"
"3","2017","31","Hotel","10","23","720","1263","877","1731","1597","2994","2.8"
"3","2017","31","Hotel","8","34","466","737","588","1116","1054","1853","1"
"3","2017","31","Hotel","5","5","433","1134","296","500","729","1634","1"
"3","2017","31","Hotel","3","4","74","158","87","166","161","324","3"
"3","2017","31","Hotel","9","26","146","542","10","19","156","561","1"
"3","2017","31","Hotel","8","34","533","731","494","931","1027","1662","1"
"3","2017","31","Hotel","7","17","208","422","131","334","339","756","4"
"3","2017","31","Hotel","4","13","155","503","25","60","180","563","3.2"
"3","2017","31","Hotel","12","35","42","108","576","2196","618","2304","1"
"3","2017","31","Hotel","16","40","1495","2988","2837","5672","4332","8660","1"
"3","2017","31","Hotel","9","26","244","1068","99","549","343","1617","1"
"3","2017","31","","6","27","157","626","23","285","180","911","1"
"3","2017","31","Hotel","9","26","245","367","12","18","257","385","1"
"3","2017","31","Hotel","4","13","138","268","72","81","210","349","3.2"
"3","2017","31","Hotel","6","28","637","848","105","119","742","967","1"
"3","2017","31","","2","29","61","130","689","2180","750","2310","1"
"3","2017","31","Hotel","13","33","1291","1727","195","327","1486","2054","1"
"3","2017","31","Hotel","8","3","1013","2305","321","708","1334","3013","1"
"3","2017","31","Hotel","14","27","498","670","1081","1631","1579","2301","1"
"3","2017","31","Hotel","16","40","515","919","0","0","515","919","5.6666666666667"
"3","2017","31","Hotel","12","24","310","600","520","930","830","1530","1"
"3","2017","31","Hotel","10","18","1493","1806","319","499","1812","2305","3.2"
"3","2017","31","Otros","15","16","143","143","2","2","145","145","9"
"3","2017","31","Hotel","6","10","678","818","0","0","678","818","1"
"3","2017","31","Hotel","10","11","648","1185","152","367","800","1552","1"
"3","2017","31","Otros","6","10","119","276","0","0","119","276","3.8518518518518"
"3","2017","31","Otros","10","23","21","53","0","0","21","53","1"
"3","2017","31","Hotel","10","23","282","434","502","948","784","1382","2.8"
"3","2017","31","Hotel","6","12","262","791","12","23","274","814","5"
"3","2017","31","Hotel","6","27","126","269","2","2","128","271","3"
"3","2017","31","Hotel","10","23","459","768","447","990","906","1758","2.8"
"3","2017","31","","4","39","83","161","0","0","83","161","1"
"3","2017","31","Hotel","8","34","211","278","689","950","900","1228","1"
"3","2017","31","Hotel","8","34","555","877","490","768","1045","1645","1"
"3","2017","31","Otros","4","39","8","8","0","0","8","8","2.2222222222222"
"3","2017","31","Otros","13","14","315","693","0","0","315","693","1"
"3","2017","31","Hotel","10","23","408","592","207","259","615","851","2.8"
"3","2017","31","Otros","13","14","258","541","0","0","258","541","1"
"3","2017","31","Hotel","12","24","286","422","532","925","818","1347","1"
"3","2017","31","","6","25","185","265","0","0","185","265","1"
"3","2017","31","Hotel","15","27","288","459","9","21","297","480","1"
"3","2017","31","Hotel","12","35","34","49","565","1001","599","1050","1"
"3","2017","31","Hotel","16","40","506","1621","594","1792","1100","3413","1"
"3","2017","31","Hotel","16","27","29","29","20","20","49","49","1"
"3","2017","31","Hotel","9","30","65","142","0","0","65","142","1"
"3","2017","31","Hotel","4","13","283","617","44","76","327","693","3.2"
"3","2017","31","Hotel","2","29","92","262","294","997","386","1259","1"
"3","2017","31","Hotel","16","20","586","716","507","762","1093","1478","1"
"3","2017","31","Hotel","5","5","656","1216","242","338","898","1554","1"
"3","2017","31","Hotel","13","33","791","1252","92","171","883","1423","1"
"3","2017","31","Otros","16","19","157","201","0","0","157","201","1.3333333333333"
"3","2017","31","Hotel","12","24","154","396","336","765","490","1161","1"
"3","2017","31","","8","2","295","471","66","84","361","555","1"
"3","2017","31","Hotel","12","35","13","61","255","1587","268","1648","1"
"3","2017","31","Hotel","16","27","70","90","562","680","632","770","2.5"
"3","2017","31","Otros","16","27","319","542","21","30","340","572","2"
"3","2017","31","Hotel","8","34","411","592","343","604","754","1196","1"
"3","2017","31","Otros","8","3","248","538","12","24","260","562","1"
"3","2017","31","Hotel","7","27","185","274","97","353","282","627","1"
"3","2017","31","Hotel","4","39","198","334","11","16","209","350","1"
"3","2017","31","Hotel","15","16","335","460","75","102","410","562","4"
"3","2017","31","Hotel","4","39","6","12","6","8","12","20","1"
"3","2017","31","Hotel","4","39","232","376","9","15","241","391","1"
"3","2017","31","Hotel","15","16","157","903","16","28","173","931","4"
"3","2017","31","Hotel","14","31","271","439","198","304","469","743","17.4"
"3","2017","31","Hotel","8","34","327","459","424","624","751","1083","1"
"3","2017","31","Hotel","6","28","286","375","79","88","365","463","1"
"3","2017","31","Hotel","7","17","661","977","206","628","867","1605","4"
"3","2017","31","Otros","7","27","210","630","0","0","210","630","1"
"3","2017","31","Hotel","11","36","1660","1768","89","216","1749","1984","1"
"3","2017","31","Otros","4","21","167","309","3","3","170","312","1"
"3","2017","31","Otros","15","16","99","137","36","73","135","210","2"
"3","2017","31","Otros","7","17","273","866","109","129","382","995","3"
"3","2017","31","Hotel","7","38","133","164","17","23","150","187","1"
"3","2017","31","Hotel","16","27","352","420","12","23","364","443","2.5"
"3","2017","31","Hotel","2","6","53","115","14","17","67","132","2.2"
"3","2017","31","Hotel","11","36","333","597","152","263","485","860","1"
"3","2017","31","Hotel","6","28","80","97","23","33","103","130","1"
"3","2017","31","Hotel","6","12","86","113","0","0","86","113","5"
"3","2017","31","Otros","9","22","40","128","1","2","41","130","1"
"3","2017","31","","13","14","128","158","3","5","131","163","2"
"3","2017","31","Hotel","2","29","26","76","461","1279","487","1355","1"
"3","2017","31","Hotel","2","29","10","39","89","296","99","335","1"
"3","2017","31","Otros","4","13","268","286","19","19","287","305","1"
"3","2017","31","Hotel","15","16","100","199","29","68","129","267","4"
"3","2017","31","Hotel","2","1","137","344","29","80","166","424","6.4"
"3","2017","31","Otros","7","27","88","140","0","0","88","140","1"
"3","2017","31","Otros","13","33","64","66","2","3","66","69","5.125"
"3","2017","31","","4","21","381","515","21","40","402","555","1"
"3","2017","31","Hotel","6","10","365","365","2","2","367","367","1"
"3","2017","31","Hotel","11","36","103","227","18","54","121","281","1"
"3","2017","31","Otros","14","31","142","249","175","329","317","578","2.8"
"3","2017","31","Hotel","7","27","160","298","13","58","173","356","1"
"3","2017","31","Otros","6","10","16","384","0","0","16","384","3.8518518518518"
"3","2017","31","Hotel","4","39","38","44","17","17","55","61","2.6"
"3","2017","31","Otros","8","2","11","35","26","46","37","81","6.4285714285714"
"3","2017","31","Otros","11","36","53","129","11","15","64","144","5.1904761904762"
"3","2017","31","Hotel","13","33","141","141","103","103","244","244","1"
"3","2017","31","","3","4","102","171","48","72","150","243","1"
"3","2017","31","Hotel","7","17","239","639","56","161","295","800","4"
"3","2017","31","Hotel","8","2","137","191","32","40","169","231","1"
"3","2017","31","Otros","15","16","222","286","43","62","265","348","2"
"3","2017","31","Hotel","10","11","386","688","7","7","393","695","1"
"3","2017","31","Hotel","16","19","249","492","0","0","249","492","1"
"3","2017","31","Hotel","10","23","85","135","91","141","176","276","4"
"3","2017","31","","7","38","180","212","84","119","264","331","1"
"3","2017","31","Hotel","7","27","114","467","3","3","117","470","1"
"3","2017","31","Hotel","11","36","470","1146","145","321","615","1467","1"
"3","2017","31","Hotel","16","40","192","283","11","26","203","309","16.333333333333"
"3","2017","8","Hotel","16","19","6","10","0","0","6","10","1"
"3","2017","31","Hotel","16","19","28","39","0","0","28","39","1"
"3","2017","31","Hotel","16","20","62","98","0","0","62","98","1"
"3","2017","31","Hotel","10","11","221","334","26","33","247","367","1"
"3","2017","31","Otros","7","27","34","34","0","0","34","34","4.8333333333333"
"3","2017","31","Otros","7","27","14","16","0","0","14","16","1"
"3","2017","31","Hotel","7","27","56","62","0","0","56","62","4.1666666666667"
"3","2017","31","Otros","13","14","88","133","6","6","94","139","1"
"3","2017","31","Otros","11","15","46","63","0","0","46","63","2.3571428571429"
"3","2017","31","Otros","10","27","31","57","26","29","57","86","4.84"
"3","2017","31","Otros","14","31","134","134","2023","2023","2157","2157","2.8"
"3","2017","31","Otros","11","36","42","55","8","10","50","65","5.1904761904762"
"3","2017","31","Hotel","16","19","67","78","8","16","75","94","1"
"3","2017","25","","14","27","106","150","12","16","118","166","2.6666666666667"
"3","2017","31","Hotel","16","40","130","136","10","10","140","146","5.6666666666667"
"3","2017","31","Hotel","10","27","13","44","0","0","13","44","2.25"
"3","2017","31","Otros","2","29","47","127","240","716","287","843","3.28"
"3","2017","31","Hotel","13","27","0","0","80","129","80","129","1"
"3","2017","31","Otros","9","22","49","62","0","0","49","62","1"
"3","2017","31","Hotel","2","27","81","141","2","28","83","169","1"
"3","2017","31","Hotel","8","34","313","413","536","758","849","1171","1"
"3","2017","31","Hotel","7","27","239","370","3","3","242","373","1"
"3","2017","31","Hotel","15","16","181","347","66","113","247","460","4"
"3","2017","31","Hotel","16","20","80","213","44","51","124","264","1"
"3","2017","31","Otros","4","13","23","214","0","0","23","214","1"
"3","2017","31","Hotel","2","1","178","680","9","10","187","690","6.4"
"3","2017","31","Otros","11","32","21","61","0","0","21","61","2.2857142857143"
"3","2017","31","Hotel","2","29","9","49","181","1241","190","1290","1"
"3","2017","31","Hotel","16","27","167","178","66","84","233","262","2.5"
"3","2017","31","Hotel","10","18","108","340","0","0","108","340","3.2"
"3","2017","31","Otros","11","36","553","802","78","84","631","886","1"
"3","2017","31","Otros","13","14","41","89","3","6","44","95","1"
"3","2017","31","Hotel","7","27","139","185","0","0","139","185","1"
"3","2017","31","Otros","7","17","166","178","8","8","174","186","3"
"3","2017","31","Otros","14","31","213","413","215","586","428","999","2.8"
"3","2017","31","Hotel","2","29","85","231","467","1422","552","1653","1"
"3","2017","31","Hotel","8","3","82","178","152","287","234","465","1"
"3","2017","31","Hotel","8","34","273","370","133","258","406","628","2.5714285714286"
"3","2017","31","Hotel","8","34","205","264","188","503","393","767","2.5714285714286"
"3","2017","31","Hotel","12","35","170","320","188","318","358","638","1"
"3","2017","31","Hotel","11","32","349","669","14","29","363","698","1"
"3","2017","31","Hotel","13","33","257","569","57","57","314","626","2"
"3","2017","31","Hotel","10","23","198","358","167","291","365","649","2.8"
"3","2017","31","Hotel","12","35","166","657","42","45","208","702","1"
"3","2017","31","","16","40","291","439","100","216","391","655","3.0555555555556"
"3","2017","31","Otros","16","19","8","14","0","0","8","14","1.3333333333333"
"3","2017","31","Otros","16","20","38","114","0","0","38","114","1"
"3","2017","31","Hotel","6","12","106","835","7","18","113","853","5"
"3","2017","31","Hotel","16","19","188","256","0","0","188","256","4"
"3","2017","31","Hotel","12","24","128","291","185","490","313","781","1"
"3","2017","31","Hotel","12","24","172","332","249","305","421","637","3"
"3","2017","0","Hotel","8","3","0","0","0","0","0","0","1"
"3","2017","31","Hotel","5","9","9","12","0","0","9","12","1"
"3","2017","31","Hotel","16","27","150","343","14","60","164","403","2.5"
"3","2017","31","Otros","10","23","36","36","0","0","36","36","7"
"3","2017","31","Otros","13","14","79","151","1","2","80","153","7.3846153846154"
"3","2017","31","Otros","2","6","106","435","11","20","117","455","1"
"3","2017","4","Hotel","15","16","9","10","5","6","14","16","7.8"
"3","2017","31","Hotel","8","3","125","250","10","15","135","265","1"
"3","2017","31","Hotel","8","34","329","508","305","557","634","1065","1"
"3","2017","31","Hotel","8","3","63","125","58","100","121","225","1"
"3","2017","31","","2","29","158","280","63","171","221","451","1"
"3","2017","31","Hotel","2","1","253","541","13","32","266","573","6.4"
"3","2017","31","Hotel","7","17","114","202","24","30","138","232","4"
"3","2017","31","Otros","7","17","207","539","28","110","235","649","3"
"3","2017","31","Hotel","16","40","136","253","265","576","401","829","5.6666666666667"
"3","2017","31","Hotel","12","24","171","333","382","611","553","944","1"
"3","2017","31","Hotel","14","31","279","499","293","899","572","1398","17.4"
"3","2017","0","Hotel","9","26","0","0","0","0","0","0","1"
"3","2017","31","Hotel","6","12","49","74","0","0","49","74","5"
"3","2017","31","Otros","5","9","26","29","12","12","38","41","4.0454545454545"
"3","2017","31","Otros","5","9","10","11","11","14","21","25","4.0454545454545"
"3","2017","31","Otros","15","27","84","86","5","5","89","91","1.4222222222222"
"3","2017","31","Hotel","8","34","1","1","1","1","2","2","2.5714285714286"
"3","2017","31","Hotel","10","18","307","654","212","421","519","1075","7.75"
"3","2017","31","Hotel","15","16","369","806","41","90","410","896","7.8"
"3","2017","31","Hotel","2","29","84","183","303","912","387","1095","1"
"3","2017","31","Hotel","4","39","113","251","26","29","139","280","2.6"
"3","2017","31","Otros","4","39","79","136","0","0","79","136","2.2222222222222"
"3","2017","31","Hotel","4","13","69","107","59","100","128","207","5.4"
"3","2017","31","Otros","10","23","23","46","0","0","23","46","7"
"3","2017","31","Otros","14","31","89","125","515","1149","604","1274","20.2"
"3","2017","31","Hotel","3","4","126","362","34","55","160","417","2.6"
"3","2017","31","Hotel","10","23","65","105","60","118","125","223","4"
"3","2017","31","Otros","9","22","256","1209","0","0","256","1209","1"
"3","2017","31","Hotel","12","24","148","306","297","454","445","760","3"
"3","2017","31","Hotel","13","14","17","20","0","0","17","20","1"
"3","2017","31","Hotel","12","35","143","406","180","233","323","639","1.7272727272727"
"3","2017","31","Hotel","6","28","459","665","0","0","459","665","1"
"3","2017","31","","6","28","59","165","0","0","59","165","1"
"3","2017","31","Hotel","12","24","412","931","218","513","630","1444","3"
"3","2017","7","Otros","5","9","2","2","0","0","2","2","4.0454545454545"
"3","2017","31","Hotel","16","20","58","61","1","6","59","67","1"
"3","2017","31","Hotel","4","21","256","452","45","75","301","527","3"
"3","2017","31","Otros","10","11","35","54","7","8","42","62","11.764705882353"
"3","2017","31","Otros","13","14","16","32","0","0","16","32","7.3846153846154"
"3","2017","31","Otros","16","27","42","60","0","0","42","60","13.818181818182"
"3","2017","20","Hotel","9","26","340","340","0","0","340","340","1"
"3","2017","31","Hotel","16","27","276","798","277","456","553","1254","2.5"
"3","2017","31","Hotel","3","4","758","1737","168","340","926","2077","3"
"3","2017","31","Otros","16","27","104","104","0","0","104","104","2"
"3","2017","31","Otros","16","19","786","1318","0","0","786","1318","1.3333333333333"
"3","2017","31","Hotel","6","12","660","905","14","16","674","921","5"
"3","2017","31","Hotel","2","1","219","416","37","56","256","472","6.4"
"3","2017","31","Hotel","10","11","399","730","79","133","478","863","1"
"3","2017","31","Otros","10","23","120","120","6","6","126","126","1"
"3","2017","31","Otros","10","27","579","676","212","240","791","916","4.84"
"3","2017","31","Hotel","16","27","143","212","16","42","159","254","2.5"
"3","2017","31","Hotel","6","28","186","229","22","26","208","255","1"
"3","2017","31","Hotel","4","13","46","95","23","33","69","128","5.4"
"3","2017","31","Hotel","14","27","503","687","4","4","507","691","8.5"
"3","2017","31","Hotel","10","27","139","194","456","593","595","787","1"
"3","2017","31","Hotel","13","27","133","245","85","149","218","394","4.2"
"3","2017","31","Hotel","3","4","530","769","19","33","549","802","3"
"3","2017","31","Otros","4","13","135","168","0","0","135","168","3.4"
"3","2017","31","Otros","11","15","38","41","0","0","38","41","2.3571428571429"
"3","2017","31","Otros","6","10","82","827","0","0","82","827","3.8518518518518"
"3","2017","31","Otros","2","1","70","98","24","44","94","142","1"
"3","2017","31","","6","12","107","437","0","0","107","437","1"
"3","2017","31","Otros","10","23","296","824","48","99","344","923","1"
"3","2017","31","Hotel","16","19","82","148","0","0","82","148","4"
"3","2017","31","Hotel","10","11","34","204","0","0","34","204","5.6666666666667"
"3","2017","31","Hotel","10","23","122","147","28","44","150","191","4"
"3","2017","31","Otros","14","31","27","68","147","388","174","456","2.8"
"3","2017","31","Otros","13","27","5","5","0","0","5","5","12.2"
"3","2017","31","Hotel","2","1","289","1057","0","0","289","1057","6.4"
"3","2017","31","Hotel","16","19","56","65","0","0","56","65","4"
"3","2017","31","Otros","12","35","35","51","15","19","50","70","3.5"
"3","2017","31","Otros","15","16","143","454","76","139","219","593","2"
"3","2017","31","Otros","9","22","188","376","33","66","221","442","1"
"3","2017","31","Hotel","10","27","256","397","810","1131","1066","1528","1"
"3","2017","31","Hotel","2","27","88","116","10","13","98","129","3.6"
"3","2017","31","Hotel","16","20","89","237","35","48","124","285","1"
"3","2017","31","Hotel","10","18","0","0","22","107","22","107","7.75"
"3","2017","31","Hotel","6","12","351","361","0","0","351","361","5"
"3","2017","31","Hotel","2","27","95","409","1","13","96","422","3.6"
"3","2017","31","Hotel","15","16","104","194","3","4","107","198","7.8"
"3","2017","31","Hotel","10","23","65","65","16","16","81","81","4"
"3","2017","31","Hotel","11","32","43","49","18","18","61","67","1"
"3","2017","31","Hotel","14","27","201","486","53","192","254","678","8.5"
"3","2017","31","Otros","10","11","63","89","3","3","66","92","11.764705882353"
"3","2017","31","Hotel","2","27","93","204","9","12","102","216","3.6"
"3","2017","31","Otros","13","14","342","643","2","4","344","647","7.3846153846154"
"3","2017","31","Hotel","2","1","110","140","6","6","116","146","6.4"
"3","2017","31","Otros","7","17","229","585","21","66","250","651","17.166666666667"
"3","2017","31","Otros","10","23","39","111","12","48","51","159","7"
"3","2017","31","Hotel","13","27","178","178","10","10","188","188","2.75"
"3","2017","31","Otros","10","18","26","54","54","106","80","160","10.25"
"3","2017","31","Otros","5","9","25","305","0","0","25","305","4.0454545454545"
"3","2017","31","Hotel","4","39","28","34","2","2","30","36","2.6"
"3","2017","31","Otros","16","27","26","78","0","0","26","78","13.818181818182"
"3","2017","31","Hotel","14","27","26","52","33","76","59","128","8.5"
"3","2017","31","Hotel","10","11","211","259","64","162","275","421","5.6666666666667"
"3","2017","31","Hotel","10","18","203","294","105","203","308","497","7.75"
"3","2017","31","Otros","14","31","63","78","165","267","228","345","20.2"
"3","2017","31","Otros","11","32","26","52","4","6","30","58","2.2857142857143"
"3","2017","31","Otros","5","5","4","4","0","0","4","4","3.65625"
"3","2017","31","Otros","6","25","49","81","4","4","53","85","2.3846153846154"
"3","2017","31","Hotel","3","4","48","145","5","10","53","155","2.6"
"3","2017","31","Otros","7","27","173","245","24","52","197","297","4.8333333333333"
"3","2017","31","Otros","2","29","73","136","150","199","223","335","3.28"
"3","2017","31","Hotel","2","29","61","75","237","290","298","365","1"
"3","2017","31","Otros","4","21","52","89","4","12","56","101","1"
"3","2017","13","Hotel","7","27","15","50","0","0","15","50","4.1666666666667"
"3","2017","31","Otros","5","5","20","47","12","23","32","70","3.65625"
"3","2017","31","Otros","11","36","65","102","39","67","104","169","5.1904761904762"
"3","2017","31","Hotel","7","27","348","348","0","0","348","348","4.1666666666667"
"3","2017","31","Hotel","16","20","11","21","2","2","13","23","1"
"3","2017","31","Hotel","12","24","136","224","237","334","373","558","3"
"3","2017","31","Hotel","9","26","215","344","51","103","266","447","1.5"
"3","2017","31","Hotel","7","17","193","623","44","136","237","759","10"
"3","2017","31","Hotel","9","37","252","382","31","43","283","425","3.4"
"3","2017","31","Hotel","5","5","335","530","218","316","553","846","2.1428571428571"
"3","2017","31","Otros","6","27","67","134","0","0","67","134","3.960088691796"
"3","2017","31","Hotel","9","37","49","61","13","19","62","80","3.4"
"3","2017","31","Otros","10","27","70","102","0","0","70","102","4.84"
"3","2017","31","Otros","8","3","193","435","24","32","217","467","10"
"3","2017","31","Otros","16","20","87","99","4","4","91","103","3.0769230769231"
"3","2017","31","Otros","9","22","38","74","0","0","38","74","7.6428571428571"
"3","2017","31","Otros","10","27","254","336","75","92","329","428","4.84"
"3","2017","31","Otros","10","23","94","110","22","27","116","137","7"
"3","2017","31","Otros","2","6","278","278","101","101","379","379","1"
"3","2017","31","Otros","4","39","15","16","2","2","17","18","2.2222222222222"
"3","2017","31","Hotel","2","27","70","126","29","38","99","164","1"
"3","2017","31","Hotel","14","31","31","61","118","427","149","488","24"
"3","2017","31","Otros","2","29","68","143","88","135","156","278","3.28"
"3","2017","31","Otros","8","3","170","510","0","0","170","510","10"
"3","2017","31","","13","14","21","39","32","71","53","110","1"
"3","2017","31","Hotel","6","10","179","244","24","26","203","270","6.6"
"3","2017","31","Hotel","8","34","175","242","99","165","274","407","2.5714285714286"
"3","2017","31","Hotel","9","22","120","512","0","0","120","512","2.5555555555556"
"3","2017","31","Hotel","2","6","129","205","52","108","181","313","2.2"
"3","2017","31","Hotel","10","27","89","140","331","402","420","542","2.25"
"3","2017","31","Otros","14","27","123","123","0","0","123","123","11.833333333333"
"3","2017","31","Otros","6","12","302","531","16","32","318","563","1.8256578947368"
"3","2017","31","Hotel","6","27","168","168","0","0","168","168","3"
"3","2017","31","Hotel","5","5","41","64","50","87","91","151","2.1428571428571"
"3","2017","31","Hotel","5","5","84","147","39","48","123","195","2.1428571428571"
"3","2017","31","Hotel","13","27","279","279","5","5","284","284","4.2"
"3","2017","31","Hotel","2","27","105","113","0","0","105","113","3.6"
"3","2017","31","Hotel","8","3","48","48","64","64","112","112","4.1111111111111"
"3","2017","31","Otros","11","36","64","217","2","8","66","225","5.1904761904762"
"3","2017","31","Otros","9","30","225","389","0","0","225","389","2.3333333333333"
"3","2017","31","Otros","16","19","29","49","0","0","29","49","10.263157894737"
"3","2017","31","Hotel","14","31","65","78","308","871","373","949","17.4"
"3","2017","31","Hotel","2","1","302","353","9","12","311","365","6.4"
"3","2017","31","Hotel","16","40","826","1386","604","988","1430","2374","5.6666666666667"
"3","2017","31","Otros","7","17","280","494","57","151","337","645","17.166666666667"
"3","2017","31","Hotel","13","27","429","595","139","908","568","1503","2.75"
"3","2017","31","Hotel","14","31","143","205","505","899","648","1104","24"
"3","2017","31","Otros","3","4","33","71","9","17","42","88","12.2"
"3","2017","31","Otros","8","34","202","261","331","475","533","736","5.75"
"3","2017","31","Hotel","9","22","74","92","8","11","82","103","2.5555555555556"
"3","2017","31","Hotel","4","21","80","168","7","16","87","184","3"
"3","2017","31","Hotel","6","27","109","217","0","0","109","217","3"
"3","2017","31","Hotel","12","35","59","95","74","99","133","194","1.7272727272727"
"3","2017","31","Hotel","2","29","11","41","116","305","127","346","2"
"3","2017","31","Otros","10","11","91","128","9","13","100","141","11.764705882353"
"3","2017","31","Hotel","6","10","69","93","9","9","78","102","6.6"
"3","2017","31","Hotel","13","14","61","107","48","98","109","205","2"
"3","2017","31","Otros","16","27","191","275","0","0","191","275","13.818181818182"
"3","2017","31","Otros","6","27","16","16","0","0","16","16","3.960088691796"
"3","2017","31","Hotel","16","40","49","92","590","1169","639","1261","5.6666666666667"
"3","2017","31","Otros","6","10","10","14","0","0","10","14","3.8518518518518"
"3","2017","31","Otros","10","23","5","5","0","0","5","5","7"
"3","2017","31","Hotel","6","28","215","261","30","30","245","291","1"
"3","2017","31","Otros","7","38","317","457","170","375","487","832","2.75"
"3","2017","31","Hotel","6","12","159","239","0","0","159","239","5"
"3","2017","31","Hotel","13","27","321","472","0","0","321","472","4.2"
"3","2017","31","Otros","4","21","24","68","0","0","24","68","4.8333333333333"
"3","2017","31","Hotel","16","27","73","206","6","6","79","212","5.8571428571429"
"3","2017","31","Hotel","5","5","50","180","50","80","100","260","2.1428571428571"
"3","2017","31","Otros","12","24","34","75","101","169","135","244","9.2"
"3","2017","31","Otros","15","16","107","151","32","53","139","204","9"
"3","2017","31","Hotel","8","27","205","205","37","37","242","242","4.5"
"3","2017","31","Hotel","9","22","52","249","1","1","53","250","2.5555555555556"
"3","2017","31","Hotel","10","11","146","231","57","96","203","327","5.6666666666667"
"3","2017","31","Hotel","8","3","61","93","69","136","130","229","4.1111111111111"
"3","2017","31","Hotel","6","10","502","738","3","45","505","783","6.6"
"3","2017","31","Otros","9","26","20","30","0","0","20","30","3.8888888888889"
"3","2017","31","Hotel","4","39","57","171","9","48","66","219","2.6"
"3","2017","31","Otros","6","27","42","112","0","0","42","112","3.960088691796"
"3","2017","31","Otros","6","12","148","202","0","0","148","202","1.8256578947368"
"3","2017","31","Hotel","6","27","63","135","0","0","63","135","3"
"3","2017","31","Otros","5","9","77","137","39","51","116","188","4.0454545454545"
"3","2017","31","Hotel","2","27","43","43","9","9","52","52","3.6"
"3","2017","31","Hotel","2","29","20","119","230","700","250","819","1"
"3","2017","31","Hotel","4","13","55","220","4","7","59","227","5.4"
"3","2017","31","","11","15","14","280","0","0","14","280","1"
"3","2017","31","Hotel","6","10","270","321","14","18","284","339","6.6"
"3","2017","31","Otros","6","12","34","164","4","4","38","168","1.8256578947368"
"3","2017","31","Otros","10","18","101","173","36","65","137","238","10.25"
"3","2017","31","Otros","9","22","141","252","3","15","144","267","7.6428571428571"
"3","2017","31","","14","27","99","130","13","21","112","151","1"
"3","2017","31","Hotel","16","27","72","149","4","4","76","153","5.8571428571429"
"3","2017","31","Otros","2","29","12","24","53","94","65","118","3.28"
"3","2017","31","Otros","13","33","37","41","0","0","37","41","5.125"
"3","2017","31","Otros","13","33","7","9","17","19","24","28","5.125"
"3","2017","31","Otros","6","10","118","349","0","0","118","349","3.8518518518518"
"3","2017","31","Hotel","10","18","60","105","159","305","219","410","7.75"
"3","2017","31","Hotel","14","31","100","150","59","164","159","314","24"
"3","2017","31","Hotel","4","21","72","72","8","9","80","81","3"
"3","2017","31","Hotel","3","4","42","258","5","52","47","310","2.6"
"3","2017","31","Otros","8","27","121","153","3","3","124","156","1"
"3","2017","31","Otros","6","27","10","33","0","0","10","33","3.960088691796"
"3","2017","31","Hotel","6","25","454","508","0","0","454","508","1"
"3","2017","31","Otros","6","12","184","362","12","65","196","427","1.8256578947368"
"3","2017","31","Hotel","6","27","31","52","0","0","31","52","3"
"3","2017","31","Otros","6","27","18","18","0","0","18","18","3.960088691796"
"3","2017","31","Otros","6","10","19","81","0","0","19","81","3.8518518518518"
"3","2017","31","Otros","6","12","112","269","0","0","112","269","1.8256578947368"
"3","2017","31","Otros","5","5","19","42","9","17","28","59","3.65625"
"3","2017","31","Hotel","12","24","82","201","59","148","141","349","3"
"3","2017","31","Hotel","15","16","38","75","20","68","58","143","7.8"
"3","2017","31","Otros","4","13","54","55","4","4","58","59","3.4"
"3","2017","31","Hotel","2","29","122","346","80","224","202","570","1"
"3","2017","31","Hotel","4","21","7","16","0","0","7","16","3"
"3","2017","31","Hotel","10","27","136","186","413","788","549","974","2.25"
"3","2017","31","Hotel","8","3","261","435","100","144","361","579","4.1111111111111"
"3","2017","31","Hotel","12","27","77","157","25","32","102","189","1"
"3","2017","31","Otros","5","5","143","217","28","51","171","268","3.65625"
"3","2017","31","Otros","13","14","2","14","0","0","2","14","7.3846153846154"
"3","2017","31","Otros","10","11","340","539","0","0","340","539","11.764705882353"
"3","2017","31","Otros","16","40","223","289","11","24","234","313","28.142857142857"
"3","2017","31","Hotel","11","36","198","537","44","106","242","643","1"
"3","2017","31","Otros","8","34","96","276","59","98","155","374","5.75"
"3","2017","31","Hotel","7","17","89","161","16","19","105","180","10"
"3","2017","31","Otros","12","35","134","291","15","27","149","318","3.5"
"3","2017","28","Otros","5","9","37","40","8","11","45","51","4.0454545454545"
"3","2017","31","Hotel","9","22","43","69","0","0","43","69","2.5555555555556"
"3","2017","31","Otros","2","29","45","87","51","102","96","189","3.28"
"3","2017","31","Otros","2","29","36","85","45","91","81","176","3.28"
"3","2017","31","Hotel","10","27","90","217","129","167","219","384","2.25"
"3","2017","31","Hotel","16","19","115","197","7","11","122","208","4"
"3","2017","31","Hotel","16","40","149","453","0","0","149","453","16.333333333333"
"3","2017","31","Hotel","8","27","180","241","32","32","212","273","4.5"
"3","2017","31","Otros","13","14","15","20","0","0","15","20","7.3846153846154"
"3","2017","31","Hotel","7","27","36","40","0","0","36","40","4.1666666666667"
"3","2017","31","Otros","2","6","1","1","0","0","1","1","5"
"3","2017","31","Hotel","7","17","273","837","32","111","305","948","10"
"3","2017","31","Hotel","3","4","75","128","68","151","143","279","2.6"
"3","2017","31","Otros","6","12","18","98","0","0","18","98","1.8256578947368"
"3","2017","31","Otros","6","10","10","10","0","0","10","10","3.8518518518518"
"3","2017","31","Hotel","16","40","36","64","14","34","50","98","16.333333333333"
"3","2017","31","Otros","4","39","29","69","0","0","29","69","2.2222222222222"
"3","2017","31","Otros","13","14","23","46","0","0","23","46","7.3846153846154"
"3","2017","31","Otros","7","38","98","166","18","32","116","198","2.75"
"3","2017","31","Hotel","11","32","70","83","0","0","70","83","1"
"3","2017","31","Otros","11","36","182","331","10","22","192","353","5.1904761904762"
"3","2017","31","Hotel","4","21","73","121","16","26","89","147","3"
"3","2017","31","Otros","3","4","4","10","4","11","8","21","12.2"
"3","2017","31","Otros","5","9","42","58","19","42","61","100","4.0454545454545"
"3","2017","31","Hotel","8","27","98","131","0","0","98","131","4.5"
"3","2017","31","","7","17","189","645","14","72","203","717","1"
"3","2017","31","Otros","16","20","68","217","17","42","85","259","3.0769230769231"
"3","2017","31","Otros","4","21","79","110","11","15","90","125","4.8333333333333"
"3","2017","31","Otros","13","33","59","83","41","54","100","137","5.125"
"3","2017","30","","12","35","0","0","240","1021","240","1021","1"
"3","2017","31","Hotel","13","33","1","1","4","4","5","5","2"
"3","2017","31","Otros","4","39","6","9","0","0","6","9","2.2222222222222"
"3","2017","31","Otros","10","18","58","143","41","125","99","268","10.25"
"3","2017","31","Otros","6","27","52","89","0","0","52","89","3.960088691796"
"3","2017","31","Hotel","4","39","66","178","0","0","66","178","2.6"
"3","2017","31","Otros","14","31","53","103","86","176","139","279","20.2"
"3","2017","31","Hotel","2","29","40","106","313","698","353","804","2"
"3","2017","31","Hotel","9","26","244","387","0","0","244","387","1.5"
"3","2017","31","Otros","12","35","4","5","4","7","8","12","3.5"
"3","2017","31","Hotel","14","27","107","144","51","65","158","209","8.5"
"3","2017","31","Otros","11","36","200","429","37","123","237","552","5.1904761904762"
"3","2017","31","Otros","16","20","218","467","80","218","298","685","3.0769230769231"
"3","2017","31","Otros","4","39","5","9","0","0","5","9","2.2222222222222"
"3","2017","31","Otros","7","27","180","209","12","12","192","221","4.8333333333333"
"3","2017","31","Otros","6","27","92","156","0","0","92","156","3.960088691796"
"3","2017","31","Otros","5","8","15","420","0","0","15","420","5"
"3","2017","31","Otros","9","37","136","227","21","23","157","250","4.5"
"3","2017","31","Hotel","2","6","62","284","0","0","62","284","5.5"
"3","2017","31","Hotel","10","27","106","122","196","213","302","335","2.25"
"3","2017","31","Hotel","9","30","121","128","36","66","157","194","1"
"3","2017","31","Otros","4","13","23","44","4","4","27","48","3.4"
"3","2017","31","Hotel","5","5","275","275","80","80","355","355","1"
"3","2017","31","Otros","7","38","125","226","2","4","127","230","2.75"
"3","2017","31","Hotel","13","14","4","8","2","6","6","14","1"
"3","2017","31","Otros","5","9","53","97","12","20","65","117","4.0454545454545"
"3","2017","31","Otros","5","8","5","7","7","7","12","14","5"
"3","2017","31","Otros","10","27","73","110","40","54","113","164","4.84"
"3","2017","31","Hotel","13","14","28","57","5","11","33","68","1"
"3","2017","31","Otros","11","15","7","7","0","0","7","7","2.3571428571429"
"3","2017","31","Hotel","9","22","135","210","0","0","135","210","2.5555555555556"
"3","2017","31","Otros","11","36","98","235","17","34","115","269","5.1904761904762"
"3","2017","31","Hotel","10","18","1790","3986","1979","4174","3769","8160","1"
"3","2017","31","Hotel","6","12","188","341","0","0","188","341","5"
"3","2017","31","","2","29","208","623","642","1551","850","2174","1"
"3","2017","31","Hotel","16","27","1164","2331","21","33","1185","2364","1"
"3","2017","31","","14","31","400","805","422","1864","822","2669","1"
"3","2017","31","Hotel","8","3","27","53","43","65","70","118","4.1111111111111"
"3","2017","31","Otros","13","33","123","183","86","158","209","341","5.125"
"3","2017","31","","14","27","38","53","0","0","38","53","2.6666666666667"
"3","2017","31","Otros","9","22","12","20","0","0","12","20","7.6428571428571"
"3","2017","31","Hotel","10","11","28","44","8","14","36","58","5.6666666666667"
"3","2017","31","Otros","6","12","12","28","0","0","12","28","1.8256578947368"
"3","2017","31","Hotel","8","3","121","167","40","47","161","214","4.1111111111111"
"3","2017","31","Otros","6","12","133","191","6","14","139","205","1.8256578947368"
"3","2017","31","Hotel","8","27","167","193","2","4","169","197","4.5"
"3","2017","31","Hotel","6","28","166","214","32","41","198","255","2.4"
"3","2017","31","Otros","6","25","49","261","0","0","49","261","2.3846153846154"
"3","2017","31","Otros","6","25","53","86","0","0","53","86","2.3846153846154"
"3","2017","31","Hotel","11","36","732","1976","0","0","732","1976","1"
"3","2017","31","Otros","2","6","13","36","233","709","246","745","5"
"3","2017","31","Hotel","14","31","49","65","147","334","196","399","24"
"3","2017","16","Otros","4","21","27","49","0","0","27","49","4.8333333333333"
"3","2017","31","Otros","7","38","8","64","0","0","8","64","2.75"
"3","2017","31","Otros","13","14","69","76","0","0","69","76","7.3846153846154"
"3","2017","31","Otros","2","29","26","40","32","45","58","85","3.28"
"3","2017","31","Otros","3","4","82","82","38","38","120","120","12.2"
"3","2017","31","Hotel","3","4","357","780","23","31","380","811","3"
"3","2017","31","Otros","7","27","169","184","27","27","196","211","1"
"3","2017","31","Otros","7","17","79","90","0","0","79","90","3"
"3","2017","31","Hotel","12","27","134","309","24","24","158","333","1"
"3","2017","31","Otros","5","5","62","62","14","14","76","76","3.65625"
"3","2017","31","Hotel","6","10","260","366","18","22","278","388","6.6"
"3","2017","31","Otros","10","18","13","48","19","64","32","112","10.25"
"3","2017","31","Otros","8","27","45","79","0","0","45","79","9.4"
"3","2017","31","Otros","8","3","86","200","32","66","118","266","10"
"3","2017","31","Hotel","16","27","18","56","0","0","18","56","5.8571428571429"
"3","2017","31","Otros","6","10","31","72","0","0","31","72","3.8518518518518"
"3","2017","31","Hotel","2","6","45","57","0","0","45","57","5.5"
"3","2017","31","Hotel","8","3","5","10","0","0","5","10","4.1111111111111"
"3","2017","31","Otros","10","11","49","62","37","58","86","120","11.764705882353"
"3","2017","31","Otros","6","27","5","155","0","0","5","155","3.960088691796"
"3","2017","31","Otros","15","16","5","9","0","0","5","9","9"
"3","2017","31","Otros","5","5","60","74","91","100","151","174","3.65625"
"3","2017","31","Otros","10","27","78","131","44","60","122","191","4.84"
"3","2017","31","Hotel","7","38","58","78","10","11","68","89","1"
"3","2017","31","Hotel","13","27","6","6","0","0","6","6","4.2"
"3","2017","31","Hotel","16","20","88","115","0","0","88","115","1"
"3","2017","31","Otros","10","27","29","29","0","0","29","29","4.84"
"3","2017","31","Hotel","3","7","80","120","12","12","92","132","1"
"3","2017","31","Otros","2","29","103","107","17","21","120","128","3.28"
"3","2017","31","Otros","10","18","8","30","0","0","8","30","10.25"
"3","2017","31","Otros","9","22","200","408","0","0","200","408","7.6428571428571"
"3","2017","31","Otros","15","27","27","27","4","4","31","31","1.4222222222222"
"3","2017","31","Otros","11","36","4","14","0","0","4","14","5.1904761904762"
"3","2017","31","Otros","5","5","5","5","0","0","5","5","3.65625"
"3","2017","31","Otros","2","29","17","51","31","73","48","124","3.28"
"3","2017","31","Hotel","9","22","111","111","14","14","125","125","2.5555555555556"
"3","2017","31","Otros","11","32","5","7","0","0","5","7","2.2857142857143"
"3","2017","31","Hotel","10","27","180","311","191","218","371","529","1"
"3","2017","31","Otros","16","27","89","129","0","0","89","129","2"
"3","2017","31","Hotel","16","20","55","75","0","0","55","75","1"
"3","2017","31","Otros","11","15","22","40","0","0","22","40","2.3571428571429"
"3","2017","31","Otros","7","17","62","139","0","0","62","139","3"
"3","2017","31","Otros","5","8","34","60","8","15","42","75","5"
"3","2017","31","Hotel","13","33","82","108","15","24","97","132","2"
"3","2017","31","Otros","5","9","93","150","81","130","174","280","4.0454545454545"
"3","2017","31","Otros","10","27","99","143","96","151","195","294","4.84"
"3","2017","31","Otros","9","22","52","90","0","0","52","90","7.6428571428571"
"3","2017","31","Otros","16","40","70","134","0","0","70","134","28.142857142857"
"3","2017","31","Hotel","16","40","96","96","8","8","104","104","1"
"3","2017","31","Otros","15","16","69","332","0","0","69","332","9"
"3","2017","31","Hotel","8","2","34","38","13","15","47","53","3"
"3","2017","31","Otros","8","3","36","55","0","0","36","55","10"
"3","2017","31","Otros","7","17","33","63","4","8","37","71","17.166666666667"
"3","2017","31","Otros","16","20","38","82","4","6","42","88","3.0769230769231"
"3","2017","31","Otros","6","27","22","44","0","0","22","44","3.960088691796"
"3","2017","31","Otros","12","35","19","48","202","327","221","375","3.5"
"3","2017","31","Otros","6","28","130","523","37","74","167","597","4.65"
"3","2017","31","Otros","6","28","263","472","22","34","285","506","4.65"
"3","2017","31","Hotel","8","34","65","103","151","249","216","352","2.5714285714286"
"3","2017","31","Hotel","16","20","1025","2048","6","8","1031","2056","1"
"3","2017","31","Hotel","2","6","163","294","10","10","173","304","2.2"
"3","2017","31","Hotel","7","27","41","46","0","0","41","46","4.1666666666667"
"3","2017","31","Hotel","10","23","108","115","14","15","122","130","4"
"3","2017","31","Hotel","9","26","25","28","9","15","34","43","1.5"
"3","2017","31","Otros","8","27","52","52","7","7","59","59","9.4"
"3","2017","31","Otros","10","27","5","7","6","8","11","15","4.84"
"3","2017","31","Otros","11","15","14","23","1","1","15","24","2.3571428571429"
"3","2017","31","Otros","16","20","11","13","0","0","11","13","3.0769230769231"
"3","2017","31","Otros","11","32","122","135","0","0","122","135","1"
"3","2017","31","Otros","16","27","68","68","0","0","68","68","13.818181818182"
"3","2017","31","Otros","9","37","77","93","0","0","77","93","4.5"
"3","2017","31","Hotel","2","29","11","24","12","42","23","66","2"
"3","2017","31","Hotel","2","1","89","336","0","0","89","336","6.4"
"3","2017","31","Otros","5","8","11","13","8","8","19","21","5"
"3","2017","31","Otros","9","37","60","82","63","129","123","211","4.5"
"3","2017","31","Otros","7","38","205","350","0","0","205","350","2.75"
"3","2017","31","Otros","11","32","72","110","10","16","82","126","1"
"3","2017","31","Otros","4","39","23","44","2","30","25","74","2.2222222222222"
"3","2017","31","Hotel","11","36","42","92","16","88","58","180","2.375"
"3","2017","31","Otros","10","23","22","40","4","10","26","50","7"
"3","2017","31","Hotel","15","16","566","1282","187","501","753","1783","2"
"3","2017","31","Otros","2","29","38","76","128","283","166","359","3.28"
"3","2017","31","Hotel","6","12","1362","1687","20","20","1382","1707","1"
"3","2017","31","Hotel","11","15","32","58","0","0","32","58","1"
"3","2017","31","Otros","4","21","333","747","52","139","385","886","1"
"3","2017","31","Otros","16","19","94","223","0","0","94","223","10.263157894737"
"3","2017","31","","9","37","436","604","8","14","444","618","1"
"3","2017","31","Otros","10","27","98","256","95","147","193","403","4.84"
"3","2017","31","Otros","11","15","66","70","2","2","68","72","2.3571428571429"
"3","2017","31","Hotel","2","29","32","96","100","312","132","408","2"
"3","2017","31","Hotel","10","27","211","269","164","288","375","557","1"
"3","2017","31","Hotel","11","36","123","683","9","16","132","699","2.375"
"3","2017","31","Hotel","9","37","115","173","16","30","131","203","3.4"
"3","2017","31","Otros","14","27","4","8","6","12","10","20","11.833333333333"
"3","2017","31","Otros","7","38","128","209","0","0","128","209","1"
"3","2017","31","Hotel","2","1","67","97","0","0","67","97","6.4"
"3","2017","31","Otros","2","29","1","1","82","166","83","167","3.28"
"3","2017","31","Hotel","6","27","12","14","6","36","18","50","3"
"3","2017","31","Otros","5","9","14","137","0","0","14","137","4.0454545454545"
"3","2017","31","Hotel","2","1","174","232","0","0","174","232","6.4"
"3","2017","31","Hotel","3","7","19","34","26","37","45","71","1"
"3","2017","31","Otros","7","38","111","125","100","142","211","267","2.75"
"3","2017","31","Otros","7","17","12","23","0","0","12","23","17.166666666667"
"3","2017","31","Otros","7","38","37","55","1","6","38","61","2.75"
"3","2017","31","Otros","4","21","19","19","3","6","22","25","4.8333333333333"
"3","2017","31","Otros","2","1","28","32","5","6","33","38","5.5"
"3","2017","31","Otros","12","35","57","67","56","61","113","128","3.5"
"3","2017","31","Otros","12","35","16","22","23","35","39","57","3.5"
"3","2017","31","Otros","4","21","45","58","12","18","57","76","4.8333333333333"
"3","2017","31","Otros","12","24","50","50","30","40","80","90","9.2"
"3","2017","31","Otros","16","19","6","6","0","0","6","6","10.263157894737"
"3","2017","31","Otros","10","11","45","76","4","7","49","83","11.764705882353"
"3","2017","31","Otros","16","19","32","51","0","0","32","51","10.263157894737"
"3","2017","31","Hotel","2","27","44","44","7","7","51","51","1"
"3","2017","31","Otros","6","28","52","57","0","0","52","57","4.65"
"3","2017","31","Otros","10","18","170","210","68","179","238","389","10.25"
"3","2017","31","Otros","14","27","31","73","2","4","33","77","11.833333333333"
"3","2017","31","Hotel","11","32","49","69","2","2","51","71","1"
"3","2017","31","Otros","8","27","2","2","0","0","2","2","9.4"
"3","2017","31","Hotel","12","35","133","291","104","177","237","468","1.7272727272727"
"3","2017","31","Otros","13","14","13","41","0","0","13","41","7.3846153846154"
"3","2017","31","Otros","11","36","34","40","4","4","38","44","5.1904761904762"
"3","2017","31","Otros","16","20","18","21","0","0","18","21","3.0769230769231"
"3","2017","31","Hotel","14","31","175","175","965","3965","1140","4140","7.8"
"3","2017","31","Otros","2","27","192","252","32","89","224","341","3.2"
"3","2017","31","","16","40","305","976","0","0","305","976","3.0555555555556"
"3","2017","31","Hotel","11","36","55","125","43","81","98","206","2.375"
"3","2017","31","Hotel","9","22","18","22","0","0","18","22","2.5555555555556"
"3","2017","31","Otros","2","29","14","47","43","110","57","157","3.28"
"3","2017","31","Hotel","10","27","15","18","122","148","137","166","2.25"
"3","2017","31","Otros","10","27","13","67","0","0","13","67","4.84"
"3","2017","31","Hotel","16","19","24","25","0","0","24","25","4"
"3","2017","23","Otros","2","6","10","16","1","1","11","17","5"
"3","2017","31","Otros","7","27","84","121","0","0","84","121","4.8333333333333"
"3","2017","31","Hotel","2","6","114","890","0","0","114","890","5.5"
"3","2017","31","Hotel","6","28","7","7","10","15","17","22","2.4"
"3","2017","31","Otros","6","10","142","616","0","0","142","616","3.8518518518518"
"3","2017","31","Hotel","6","27","2","2","0","0","2","2","3"
"3","2017","31","Otros","5","5","34","45","9","12","43","57","3.65625"
"3","2017","31","Otros","12","24","64","118","70","102","134","220","9.2"
"3","2017","31","Hotel","8","2","55","111","22","36","77","147","3"
"3","2017","31","Hotel","11","32","17","45","5","10","22","55","1"
"3","2017","31","Otros","10","18","8","28","41","89","49","117","10.25"
"3","2017","31","Hotel","9","37","88","122","32","40","120","162","3.4"
"3","2017","31","Otros","5","9","75","107","84","168","159","275","4.0454545454545"
"3","2017","31","Otros","12","24","43","99","32","68","75","167","9.2"
"3","2017","31","Otros","9","22","5","7","5","5","10","12","7.6428571428571"
"3","2017","31","Otros","2","29","6","14","26","86","32","100","3.28"
"3","2017","31","Otros","10","23","0","0","2","26","2","26","7"
"3","2017","31","Otros","10","27","135","149","19","87","154","236","4.84"
"3","2017","31","Otros","10","11","30","30","0","0","30","30","11.764705882353"
"3","2017","31","Otros","8","3","51","104","0","0","51","104","10"
"3","2017","31","Otros","14","31","46","68","504","779","550","847","20.2"
"3","2017","31","Otros","2","29","109","287","286","676","395","963","3.28"
"3","2017","0","Otros","6","25","0","0","0","0","0","0","1"
"3","2017","31","Hotel","15","16","10","28","0","0","10","28","7.8"
"3","2017","31","Hotel","15","27","58","75","36","288","94","363","1"
"3","2017","31","Otros","10","27","5","5","0","0","5","5","4.84"
"3","2017","31","Otros","10","23","51","51","2","2","53","53","7"
"3","2017","31","Otros","6","27","41","196","0","0","41","196","3.960088691796"
"3","2017","31","Otros","16","40","201","257","0","0","201","257","28.142857142857"
"3","2017","31","Otros","11","36","209","291","16","33","225","324","5.1904761904762"
"3","2017","31","Otros","8","34","55","87","15","18","70","105","5.75"
"3","2017","31","Otros","6","12","45","109","4","8","49","117","1.8256578947368"
"3","2017","31","Otros","6","10","124","194","0","0","124","194","3.8518518518518"
"3","2017","31","Hotel","4","21","195","457","37","61","232","518","3"
"3","2017","31","Hotel","11","36","72","163","55","127","127","290","2.375"
"3","2017","31","Otros","5","8","138","183","102","147","240","330","5"
"3","2017","31","Hotel","7","17","126","170","0","0","126","170","10"
"3","2017","31","Hotel","11","36","325","583","34","53","359","636","1"
"3","2017","31","Otros","9","30","32","40","0","0","32","40","2.3333333333333"
"3","2017","31","Hotel","12","35","57","107","128","228","185","335","1.7272727272727"
"3","2017","31","Otros","2","1","74","152","26","40","100","192","5.5"
"3","2017","31","Hotel","6","25","8","16","0","0","8","16","1"
"3","2017","31","Otros","5","5","5","155","0","0","5","155","3.65625"
"3","2017","31","Otros","2","29","32","51","85","192","117","243","3.28"
"3","2017","31","Hotel","2","6","18","30","7","8","25","38","5.5"
"3","2017","31","Otros","7","17","16","40","2","4","18","44","17.166666666667"
"3","2017","31","Hotel","8","2","8","8","17","17","25","25","3"
"3","2017","31","Hotel","13","14","16","24","0","0","16","24","1"
"3","2017","31","Otros","7","38","30","62","22","40","52","102","2.75"
"3","2017","31","Hotel","14","31","15","20","155","305","170","325","24"
"3","2017","31","Hotel","5","5","36","65","82","100","118","165","2.1428571428571"
"3","2017","31","Otros","2","27","0","0","11","11","11","11","3.2"
"3","2017","31","Otros","5","8","55","74","34","64","89","138","5"
"3","2017","31","Otros","3","4","43","82","39","97","82","179","12.2"
"3","2017","31","Otros","13","14","6","10","0","0","6","10","7.3846153846154"
"3","2017","31","Otros","9","37","41","62","5","16","46","78","4.5"
"3","2017","31","Hotel","10","23","808","1008","95","168","903","1176","1"
"3","2017","31","Otros","11","32","25","25","5","5","30","30","2.2857142857143"
"3","2017","31","Otros","11","15","1","1","0","0","1","1","2.3571428571429"
"3","2017","31","Otros","8","3","154","999","4","8","158","1007","10"
"3","2017","31","Otros","16","20","81","221","0","0","81","221","3.0769230769231"
"3","2017","31","Otros","8","3","22","56","0","0","22","56","10"
"3","2017","31","Otros","16","27","105","105","0","0","105","105","2"
"3","2017","31","Hotel","16","19","17","21","0","0","17","21","4"
"3","2017","31","Hotel","16","27","29","79","6","92","35","171","5.8571428571429"
"3","2017","31","Otros","9","26","31","53","6","6","37","59","3.8888888888889"
"3","2017","31","Otros","5","5","13","20","9","17","22","37","3.65625"
"3","2017","31","Otros","14","27","7","9","0","0","7","9","11.833333333333"
"3","2017","31","Hotel","5","5","16","59","27","148","43","207","2.1428571428571"
"3","2017","31","Hotel","12","24","71","199","123","258","194","457","3"
"3","2017","31","Otros","16","27","19","61","0","0","19","61","13.818181818182"
"3","2017","31","Otros","8","3","18","34","22","48","40","82","1"
"3","2017","31","Otros","13","27","192","271","0","0","192","271","12.2"
"3","2017","31","Hotel","16","40","72","94","24","41","96","135","16.333333333333"
"3","2017","31","Otros","11","36","22","44","3","6","25","50","1"
"3","2017","31","Otros","10","27","5","25","15","15","20","40","4.84"
"3","2017","31","Otros","9","22","34","84","0","0","34","84","7.6428571428571"
"3","2017","31","Hotel","5","5","23","30","37","62","60","92","2.1428571428571"
"3","2017","31","Otros","2","29","43","115","49","88","92","203","3.28"
"3","2017","25","Otros","2","29","3","9","1","3","4","12","3.28"
"3","2017","31","Hotel","13","14","25","25","0","0","25","25","1"
"3","2017","31","Otros","6","25","4","4","0","0","4","4","2.3846153846154"
"3","2017","31","Otros","2","1","20","25","0","0","20","25","5.5"
"3","2017","31","Hotel","12","27","37","41","42","46","79","87","1"
"3","2017","31","Hotel","13","27","28","28","0","0","28","28","4.2"
"3","2017","31","Otros","6","12","94","224","0","0","94","224","1.8256578947368"
"3","2017","31","Otros","6","27","18","18","0","0","18","18","3.960088691796"
"3","2017","31","Otros","6","25","16","16","0","0","16","16","2.3846153846154"
"3","2017","31","Hotel","6","28","14","64","2","4","16","68","2.5833333333333"
"3","2017","31","Otros","5","5","5","6","2","2","7","8","3.65625"
"3","2017","31","Otros","5","9","7","14","7","10","14","24","4.0454545454545"
"3","2017","31","Otros","5","8","7","13","0","0","7","13","5"
"3","2017","31","Hotel","2","29","63","140","53","151","116","291","1"
"3","2017","31","Otros","5","5","85","151","63","87","148","238","3.65625"
"3","2017","31","Hotel","9","26","30","79","5","11","35","90","1.5"
"3","2017","31","Otros","9","30","9","71","0","0","9","71","2.3333333333333"
"3","2017","31","Otros","11","15","14","33","8","12","22","45","2.3571428571429"
"3","2017","31","Hotel","16","27","4","6","5","5","9","11","5.8571428571429"
"3","2017","31","Otros","9","30","34","36","0","0","34","36","2.3333333333333"
"3","2017","31","Otros","2","29","23","81","16","77","39","158","3.28"
"3","2017","31","Otros","7","38","33","56","39","49","72","105","2.75"
"3","2017","31","Otros","4","21","62","206","27","83","89","289","4.8333333333333"
"3","2017","31","Otros","9","22","49","83","0","0","49","83","7.6428571428571"
"3","2017","31","Otros","9","22","53","92","0","0","53","92","7.6428571428571"
"3","2017","31","Otros","13","27","8","20","0","0","8","20","12.2"
"3","2017","31","Hotel","11","36","2005","2120","39","63","2044","2183","1"
"3","2017","31","Otros","13","33","4","7","9","14","13","21","5.125"
"3","2017","31","Otros","11","36","152","349","106","252","258","601","5.1904761904762"
"3","2017","31","Otros","12","35","55","114","215","338","270","452","3.5"
"3","2017","31","Otros","12","35","22","47","13","30","35","77","3.5"
"3","2017","31","Otros","10","11","43","69","12","20","55","89","11.764705882353"
"3","2017","31","Otros","12","24","25","50","30","30","55","80","9.2"
"3","2017","31","Otros","16","20","22","42","0","0","22","42","3.0769230769231"
"3","2017","2","Hotel","7","27","8","8","0","0","8","8","1"
"3","2017","31","Otros","6","12","34","44","0","0","34","44","1.8256578947368"
"3","2017","31","Otros","11","32","53","370","6","16","59","386","2.2857142857143"
"3","2017","31","Otros","6","28","514","603","5","5","519","608","4.65"
"3","2017","31","Otros","8","34","1","1","0","0","1","1","5.75"
"3","2017","31","Otros","16","27","44","45","0","0","44","45","13.818181818182"
"3","2017","31","Otros","10","11","7","7","0","0","7","7","11.764705882353"
"3","2017","31","Otros","6","10","26","46","0","0","26","46","3.8518518518518"
"3","2017","31","Otros","8","3","1","1","0","0","1","1","10"
"3","2017","31","Hotel","16","20","48","66","58","146","106","212","1"
"3","2017","31","Hotel","11","32","132","266","18","32","150","298","1"
"3","2017","31","Otros","8","27","15","21","11","13","26","34","9.4"
"3","2017","31","Otros","12","27","20","34","15","21","35","55","3.4285714285714"
"3","2017","31","Otros","6","10","48","82","0","0","48","82","3.8518518518518"
"3","2017","31","Otros","6","10","80","237","0","0","80","237","3.8518518518518"
"3","2017","31","Otros","5","8","14","16","5","15","19","31","5"
"3","2017","31","Otros","5","8","66","74","67","67","133","141","5"
"3","2017","31","Hotel","9","26","60","105","6","13","66","118","1.5"
"3","2017","31","Hotel","13","14","40","40","4","4","44","44","1"
"3","2017","31","Otros","10","18","60","224","47","186","107","410","10.25"
"3","2017","31","Otros","8","2","36","43","35","39","71","82","6.4285714285714"
"3","2017","31","Otros","7","27","10","16","0","0","10","16","4.8333333333333"
"3","2017","2","Otros","2","29","2","4","0","0","2","4","3.28"
"3","2017","31","Otros","11","32","1","1","0","0","1","1","2.2857142857143"
"3","2017","31","Otros","9","30","29","64","0","0","29","64","2.3333333333333"
"3","2017","31","Otros","2","29","13","45","5","17","18","62","3.28"
"3","2017","31","Otros","5","5","6","42","0","0","6","42","3.65625"
"3","2017","31","Otros","11","15","20","32","0","0","20","32","2.3571428571429"
"3","2017","15","Otros","10","23","17","17","10","10","27","27","7"
"3","2017","31","Otros","11","36","92","143","30","43","122","186","5.1904761904762"
"3","2017","31","Hotel","3","7","15","19","61","100","76","119","1"
"3","2017","31","Otros","10","27","4","4","2","2","6","6","4.84"
"3","2017","31","Otros","2","27","5","5","0","0","5","5","3.2"
"3","2017","31","Otros","12","35","38","62","91","158","129","220","3.5"
"3","2017","31","Otros","10","27","19","32","16","34","35","66","4.84"
"3","2017","31","Otros","16","40","26","77","165","425","191","502","28.142857142857"
"3","2017","31","Hotel","8","3","424","1198","163","366","587","1564","4.1111111111111"
"3","2017","31","Otros","9","22","35","88","0","0","35","88","7.6428571428571"
"3","2017","31","Otros","13","14","16","35","0","0","16","35","7.3846153846154"
"3","2017","31","Otros","5","9","2","4","1","1","3","5","4.0454545454545"
"3","2017","31","Otros","10","18","42","48","79","126","121","174","10.25"
"3","2017","31","Otros","6","25","136","230","0","0","136","230","2.3846153846154"
"3","2017","31","Otros","9","22","68","152","0","0","68","152","7.6428571428571"
"3","2017","31","Otros","10","27","36","157","9","13","45","170","4.84"
"3","2017","31","Otros","16","20","38","60","2","2","40","62","3.0769230769231"
"3","2017","31","Hotel","7","17","63","125","2","4","65","129","10"
"3","2017","31","Otros","15","27","37","37","0","0","37","37","1.4222222222222"
"3","2017","31","Otros","12","35","19","55","68","101","87","156","3.5"
"3","2017","31","Otros","12","35","23","33","225","294","248","327","3.5"
"3","2017","31","Otros","3","7","9","9","0","0","9","9","2"
"3","2017","31","Otros","10","11","2","2","1","2","3","4","11.764705882353"
"3","2017","31","Otros","12","24","3","3","7","7","10","10","9.2"
"3","2017","31","Otros","10","23","14","28","0","0","14","28","7"
"3","2017","31","Otros","7","27","7","13","0","0","7","13","4.8333333333333"
"3","2017","31","","10","18","2","16","0","0","2","16","1"
"3","2017","31","Otros","16","27","0","0","6","6","6","6","13.818181818182"
"3","2017","31","Hotel","2","29","7","21","17","51","24","72","1"
"3","2017","31","Otros","14","27","30","60","0","0","30","60","11.833333333333"
"3","2017","31","Otros","11","32","59","84","0","0","59","84","2.2857142857143"
"3","2017","31","Otros","16","19","35","89","0","0","35","89","1"
"3","2017","31","Otros","16","27","41","78","0","0","41","78","13.818181818182"
"3","2017","31","Otros","8","3","22","60","16","112","38","172","10"
"3","2017","31","Otros","16","27","50","79","0","0","50","79","13.818181818182"
"3","2017","31","Otros","16","20","76","141","0","0","76","141","3.0769230769231"
"3","2017","31","Otros","16","40","118","218","24","46","142","264","28.142857142857"
"3","2017","31","Hotel","11","36","43","113","26","47","69","160","2.375"
"3","2017","31","Otros","6","10","31","54","0","0","31","54","3.8518518518518"
"3","2017","31","Otros","7","38","138","370","47","113","185","483","2.75"
"3","2017","31","Otros","13","14","6","10","0","0","6","10","7.3846153846154"
"3","2017","31","Otros","9","30","34","35","0","0","34","35","2.3333333333333"
"3","2017","31","Otros","13","27","17","36","0","0","17","36","12.2"
"3","2017","31","Otros","10","27","25","25","18","36","43","61","4.84"
"3","2017","31","Otros","6","25","3","3","16","25","19","28","2.3846153846154"
"3","2017","31","Otros","9","26","17","32","0","0","17","32","3.8888888888889"
"3","2017","31","Otros","10","18","2","4","14","34","16","38","10.25"
"3","2017","31","Otros","2","29","18","47","0","0","18","47","3.28"
"3","2017","31","Otros","6","25","5","5","0","0","5","5","2.3846153846154"
"3","2017","31","Otros","5","9","23","42","5","10","28","52","4.0454545454545"
"3","2017","31","Otros","5","9","28","34","14","31","42","65","4.0454545454545"
"3","2017","31","Hotel","9","37","61","95","6","18","67","113","3.4"
"3","2017","31","Hotel","7","38","109","269","5","9","114","278","1"
"3","2017","31","Otros","7","27","32","36","0","0","32","36","4.8333333333333"
"3","2017","31","Otros","5","9","5","5","0","0","5","5","4.0454545454545"
"3","2017","31","Otros","10","27","7","7","19","50","26","57","4.84"
"3","2017","31","Otros","7","27","42","42","0","0","42","42","4.8333333333333"
"3","2017","31","Otros","16","40","45","78","36","72","81","150","28.142857142857"
"3","2017","31","Otros","10","23","41","41","5","5","46","46","7"
"3","2017","31","Otros","15","16","110","317","24","39","134","356","9"
"3","2017","31","Otros","3","7","11","20","69","169","80","189","2"
"3","2017","31","Otros","7","17","70","118","12","40","82","158","17.166666666667"
"3","2017","31","Otros","8","27","58","65","5","5","63","70","9.4"
"3","2017","31","Otros","9","22","24","122","0","0","24","122","7.6428571428571"
"3","2017","31","Otros","16","19","2","2","0","0","2","2","10.263157894737"
"3","2017","31","","15","27","12","18","0","0","12","18","1"
"3","2017","31","Hotel","10","11","45","45","27","27","72","72","5.6666666666667"
"3","2017","31","Otros","2","27","10","40","17","38","27","78","3.2"
"3","2017","31","Otros","8","2","33","38","43","55","76","93","6.4285714285714"
"3","2017","31","Otros","5","5","4","6","1","1","5","7","3.65625"
"3","2017","31","Otros","12","35","7","11","19","23","26","34","3.5"
"3","2017","31","Otros","8","3","8","14","18","47","26","61","10"
"3","2017","31","Otros","12","24","13","22","36","98","49","120","9.2"
"3","2017","31","Otros","11","32","53","156","3","5","56","161","2.2857142857143"
"3","2017","31","Otros","10","27","31","53","76","111","107","164","4.84"
"3","2017","31","Otros","11","15","39","73","0","0","39","73","2.3571428571429"
"3","2017","31","Otros","5","8","2","2","18","22","20","24","5"
"3","2017","31","Otros","14","27","16","16","0","0","16","16","11.833333333333"
"3","2017","31","Otros","13","27","143","196","0","0","143","196","12.2"
"3","2017","31","Hotel","10","18","295","295","113","113","408","408","3.2"
"3","2017","31","Otros","10","27","25","25","19","19","44","44","4.84"
"3","2017","31","Otros","11","32","13","20","0","0","13","20","1"
"3","2017","31","Otros","9","37","35","190","0","0","35","190","4.5"
"3","2017","31","Otros","12","35","28","45","194","290","222","335","3.5"
"3","2017","31","Otros","8","34","103","152","81","123","184","275","5.75"
"3","2017","31","Hotel","16","40","20","37","72","143","92","180","16.333333333333"
"3","2017","31","Hotel","10","11","12","113","24","36","36","149","5.6666666666667"
"3","2017","31","Otros","7","27","8","40","0","0","8","40","4.8333333333333"
"3","2017","31","Hotel","7","38","2","2","0","0","2","2","1"
"3","2017","31","Otros","6","27","2","16","0","0","2","16","3.960088691796"
"3","2017","31","Otros","6","10","40","128","0","0","40","128","3.8518518518518"
"3","2017","31","Otros","6","25","101","161","0","0","101","161","1"
"3","2017","31","Otros","6","25","15","27","0","0","15","27","2.3846153846154"
"3","2017","31","Otros","6","27","136","471","0","0","136","471","3.960088691796"
"3","2017","31","Otros","6","27","108","142","13","21","121","163","3.960088691796"
"3","2017","31","Otros","5","5","38","67","3","9","41","76","3.65625"
"3","2017","31","Otros","5","5","9","13","0","0","9","13","3.65625"
"3","2017","31","Otros","3","4","16","36","0","0","16","36","12.2"
"3","2017","31","Otros","10","23","22","50","0","0","22","50","7"
"3","2017","31","Otros","8","3","16","47","0","0","16","47","10"
"3","2017","31","Otros","5","5","9","15","7","7","16","22","3.65625"
"3","2017","31","Otros","5","8","16","35","11","19","27","54","5"
"3","2017","31","Otros","6","10","24","42","0","0","24","42","3.8518518518518"
"3","2017","31","Otros","16","19","13","27","0","0","13","27","10.263157894737"
"3","2017","31","Otros","11","15","69","112","0","0","69","112","2.3571428571429"
"3","2017","31","Otros","7","38","43","53","0","0","43","53","2.75"
"3","2017","31","Otros","11","32","114","164","305","305","419","469","2.2857142857143"
"3","2017","31","Otros","8","2","33","63","0","0","33","63","6.4285714285714"
"3","2017","31","Otros","10","27","15","20","8","22","23","42","4.84"
"3","2017","31","Otros","6","27","2","6","0","0","2","6","3.960088691796"
"3","2017","31","Otros","11","32","45","67","5","6","50","73","2.2857142857143"
"3","2017","31","Otros","8","34","7","8","37","58","44","66","5.75"
"3","2017","31","Otros","11","32","2","6","0","0","2","6","2.2857142857143"
"3","2017","31","Otros","10","11","12","22","0","0","12","22","11.764705882353"
"3","2017","31","Otros","11","32","2","2","2","6","4","8","2.2857142857143"
"3","2017","31","Otros","14","31","0","0","18","34","18","34","20.2"
"3","2017","31","Hotel","14","31","146","233","617","1815","763","2048","17.4"
"3","2017","31","Otros","11","36","154","292","31","64","185","356","5.1904761904762"
"3","2017","31","Hotel","15","16","1349","2457","274","505","1623","2962","2"
"3","2017","10","Otros","15","27","2","2","0","0","2","2","1.4222222222222"
"3","2017","31","Otros","5","5","7","17","7","12","14","29","3.65625"
"3","2017","31","Otros","8","34","5","5","9","9","14","14","5.75"
"3","2017","31","Otros","7","27","20","51","0","0","20","51","4.8333333333333"
"3","2017","31","Otros","12","35","24","26","20","20","44","46","3.5"
"3","2017","31","Otros","5","5","52","86","1","2","53","88","3.65625"
"3","2017","31","Otros","10","11","4","12","0","0","4","12","11.764705882353"
"3","2017","31","Otros","10","11","1","2","1","1","2","3","11.764705882353"
"3","2017","31","Otros","9","30","6","120","0","0","6","120","2.3333333333333"
"3","2017","31","Otros","8","2","18","32","1","2","19","34","6.4285714285714"
"3","2017","31","Otros","10","27","70","114","63","69","133","183","4.84"
"3","2017","31","Otros","5","9","22","28","3","3","25","31","4.0454545454545"
"3","2017","31","Otros","6","27","24","43","0","0","24","43","3.960088691796"
"3","2017","31","Otros","6","10","102","189","10","20","112","209","3.8518518518518"
"3","2017","31","Otros","6","10","36","69","2","4","38","73","3.8518518518518"
"3","2017","31","Otros","6","27","22","29","0","0","22","29","3.960088691796"
"3","2017","31","Otros","6","12","5","44","0","0","5","44","1.8256578947368"
"3","2017","31","Otros","6","10","32","79","0","0","32","79","3.8518518518518"
"3","2017","31","Otros","6","10","24","40","0","0","24","40","3.8518518518518"
"3","2017","31","Otros","6","27","3","4","0","0","3","4","3.960088691796"
"3","2017","31","Otros","6","12","24","34","0","0","24","34","1.8256578947368"
"3","2017","31","Otros","6","10","23","49","0","0","23","49","3.8518518518518"
"3","2017","31","Hotel","6","25","42","84","0","0","42","84","1"
"3","2017","31","Otros","6","27","12","12","0","0","12","12","3.960088691796"
"3","2017","31","Otros","5","9","27","43","23","42","50","85","4.0454545454545"
"3","2017","31","Otros","5","5","24","38","12","16","36","54","3.65625"
"3","2017","31","Otros","5","5","39","45","0","0","39","45","3.65625"
"3","2017","31","Otros","5","5","72","106","23","48","95","154","3.65625"
"3","2017","31","Otros","11","36","85","195","0","0","85","195","5.1904761904762"
"3","2017","31","Hotel","6","10","282","1067","28","48","310","1115","1"
"3","2017","31","Otros","5","9","16","20","2","3","18","23","4.0454545454545"
"3","2017","31","Otros","5","8","13","19","19","43","32","62","5"
"3","2017","0","Hotel","15","27","0","0","0","0","0","0","1"
"3","2017","31","Hotel","3","4","203","1115","42","158","245","1273","3"
"3","2017","31","Otros","3","7","43","43","41","41","84","84","1"
"3","2017","31","Otros","7","38","154","346","12","38","166","384","2.75"
"3","2017","31","Hotel","10","27","31","54","82","100","113","154","1"
"3","2017","23","Hotel","12","35","2","2","42","102","44","104","1.7272727272727"
"3","2017","31","Hotel","10","27","15","16","0","0","15","16","2.25"
"3","2017","31","Hotel","7","17","506","887","101","186","607","1073","4"
"3","2017","11","Hotel","16","19","30","32","12","24","42","56","4"
"3","2017","31","Hotel","2","6","371","924","0","0","371","924","2.2"
"3","2017","31","Otros","5","5","103","354","25","116","128","470","3.65625"
"3","2017","31","Otros","12","24","41","66","82","142","123","208","9.2"
"3","2017","31","Otros","5","8","9","9","0","0","9","9","5"
"3","2017","31","Otros","4","13","156","192","14","14","170","206","1"
"3","2017","31","Otros","10","11","128","128","0","0","128","128","11.764705882353"
"3","2017","31","Otros","12","35","37","50","125","158","162","208","3.5"
"3","2017","31","Otros","10","23","90","98","6","8","96","106","7"
"3","2017","31","Otros","11","36","586","1413","126","228","712","1641","5.1904761904762"
"3","2017","31","Otros","12","35","60","98","133","170","193","268","3.5"
"3","2017","31","Otros","11","36","62","173","27","64","89","237","5.1904761904762"
"3","2017","31","Otros","8","2","100","303","0","0","100","303","6.4285714285714"
"3","2017","31","Otros","9","30","39","62","0","0","39","62","2.3333333333333"
"3","2017","31","Otros","11","36","91","168","46","89","137","257","5.1904761904762"
"3","2017","31","Otros","6","10","39","41","0","0","39","41","3.8518518518518"
"3","2017","31","Otros","10","18","34","56","0","0","34","56","10.25"
"3","2017","31","Otros","7","27","15","86","0","0","15","86","4.8333333333333"
"3","2017","31","Otros","16","20","89","534","28","168","117","702","1"
"3","2017","31","Otros","9","22","11","19","0","0","11","19","7.6428571428571"
"3","2017","31","Otros","5","5","192","295","15","38","207","333","3.65625"
"3","2017","31","Otros","12","35","60","68","56","63","116","131","3.5"
"3","2017","31","Otros","10","11","55","78","4","6","59","84","11.764705882353"
"3","2017","31","Otros","10","11","12","43","0","0","12","43","11.764705882353"
"3","2017","27","Otros","5","9","62","87","2","6","64","93","4.0454545454545"
"3","2017","31","Otros","5","5","4","124","0","0","4","124","3.65625"
"3","2017","31","Otros","12","35","7","14","56","93","63","107","3.5"
"3","2017","31","Otros","7","38","116","270","18","49","134","319","2.75"
"3","2017","31","Hotel","12","35","10","20","90","200","100","220","1.7272727272727"
"3","2017","31","Otros","13","14","76","106","0","0","76","106","1"
"3","2017","31","Otros","5","5","23","33","8","22","31","55","3.65625"
"3","2017","31","Hotel","9","26","9","22","1","3","10","25","1.5"
"3","2017","31","Hotel","16","19","34","46","0","0","34","46","1"
"3","2017","31","Otros","16","19","77","104","0","0","77","104","10.263157894737"
"3","2017","31","Otros","9","30","29","58","3","3","32","61","2.3333333333333"
"3","2017","31","Otros","16","19","10","10","0","0","10","10","10.263157894737"
"3","2017","31","Otros","16","19","100","281","0","0","100","281","10.263157894737"
"3","2017","31","Otros","9","26","1","1","0","0","1","1","3.8888888888889"
"3","2017","31","Otros","16","40","3","5","0","0","3","5","28.142857142857"
"3","2017","31","Hotel","16","27","18","35","0","0","18","35","5.8571428571429"
"3","2017","31","Otros","16","19","10","22","0","0","10","22","10.263157894737"
"3","2017","31","Otros","16","19","56","87","0","0","56","87","10.263157894737"
"3","2017","31","","9","30","115","164","98","126","213","290","1"
"3","2017","31","Otros","16","19","33","47","0","0","33","47","10.263157894737"
"3","2017","31","Otros","10","11","20","41","1","5","21","46","11.764705882353"
"3","2017","31","Otros","11","36","25","25","0","0","25","25","5.1904761904762"
"3","2017","31","Otros","16","19","7","11","0","0","7","11","10.263157894737"
"3","2017","31","Otros","16","19","167","218","0","0","167","218","1.3333333333333"
"3","2017","31","Otros","16","19","25","35","0","0","25","35","10.263157894737"
"3","2017","31","Otros","10","18","14","34","37","77","51","111","10.25"
"3","2017","31","Otros","16","19","29","69","0","0","29","69","10.263157894737"
"3","2017","31","Otros","16","19","21","30","0","0","21","30","1.3333333333333"
"3","2017","31","","9","26","492","1478","0","0","492","1478","1"
"3","2017","31","Otros","16","19","16","26","0","0","16","26","10.263157894737"
"3","2017","31","Otros","16","19","50","74","10","10","60","84","10.263157894737"
"3","2017","31","Hotel","8","2","379","850","53","96","432","946","1"
"3","2017","31","Otros","6","10","39","48","0","0","39","48","3.8518518518518"
"3","2017","31","Otros","6","12","28","35","0","0","28","35","1.8256578947368"
"3","2017","31","Hotel","16","19","346","1620","16","86","362","1706","1"
"3","2017","31","Otros","3","7","18","20","16","28","34","48","2"
"3","2017","31","Hotel","2","6","2495","2495","924","924","3419","3419","1"
"3","2017","31","Hotel","3","4","416","638","144","193","560","831","2.6"
"3","2017","31","Hotel","16","40","1991","3021","1332","2150","3323","5171","1"
"3","2017","31","Otros","16","27","152","188","0","0","152","188","13.818181818182"
"3","2017","31","Hotel","6","28","261","346","78","109","339","455","2.4"
"3","2017","31","Hotel","8","34","752","1239","310","552","1062","1791","1"
"3","2017","31","Otros","9","30","15","225","0","0","15","225","2.3333333333333"
"3","2017","31","Hotel","10","18","34","34","186","186","220","220","1"
"3","2017","31","Hotel","9","30","186","346","0","0","186","346","1"
"3","2017","31","Hotel","15","27","5","5","0","0","5","5","1"
"3","2017","31","Hotel","9","22","54","132","0","0","54","132","2.5555555555556"
"3","2017","31","","11","15","18","20","2","2","20","22","1"
"3","2017","31","Otros","6","12","40","50","0","0","40","50","1.8256578947368"
"3","2017","31","Hotel","15","27","80","1760","0","0","80","1760","1"
"3","2017","31","Otros","15","27","46","46","0","0","46","46","1.4222222222222"
"3","2017","31","Otros","15","27","4","4","0","0","4","4","1.4222222222222"
"3","2017","31","Otros","2","1","13","13","11","11","24","24","1"
"3","2017","31","Otros","12","24","6","8","6","7","12","15","9.2"
"3","2017","31","Otros","5","5","19","23","5","8","24","31","3.65625"
"3","2017","31","Hotel","7","27","169","194","39","44","208","238","1"
"3","2017","31","Otros","16","20","104","147","0","0","104","147","3.0769230769231"
"3","2017","31","","10","11","180","365","10","38","190","403","1"
"3","2017","31","Hotel","16","40","68","292","8","16","76","308","16.333333333333"
"3","2017","31","Otros","12","35","12","18","3","5","15","23","3.5"
"3","2017","31","Hotel","6","27","30","30","10","44","40","74","3"
"3","2017","31","Otros","5","5","39","49","0","0","39","49","3.65625"
"3","2017","31","Hotel","6","27","37","43","10","12","47","55","3"
"3","2017","31","Otros","6","25","27","29","0","0","27","29","2.3846153846154"
"3","2017","31","Hotel","15","27","51","108","10","10","61","118","1"
"3","2017","31","Otros","5","9","29","32","48","55","77","87","4.0454545454545"
"3","2017","31","Hotel","15","27","11","22","4","4","15","26","1"
"3","2017","31","Hotel","5","9","23","39","0","0","23","39","1"
"3","2017","31","Hotel","8","34","81","146","83","142","164","288","2.5714285714286"
"3","2017","31","Hotel","15","27","2","4","0","0","2","4","1"
"3","2017","31","Hotel","6","27","219","436","4","4","223","440","3"
"3","2017","31","Otros","6","27","115","230","0","0","115","230","1"
"3","2017","31","Otros","12","27","4","4","13","13","17","17","3.4285714285714"
"3","2017","31","Hotel","2","27","413","876","48","198","461","1074","1"
"3","2017","31","Hotel","2","6","26","580","0","0","26","580","1"
"3","2017","31","Otros","2","6","46","46","0","0","46","46","1"
"3","2017","31","Hotel","4","39","378","378","0","0","378","378","1"
"3","2017","31","Hotel","6","10","179","250","18","21","197","271","1"
"3","2017","31","Otros","5","8","30","46","48","72","78","118","5"
"3","2017","31","Hotel","13","33","717","1037","219","281","936","1318","1"
"3","2017","31","Hotel","13","33","0","0","40","600","40","600","1"
"3","2017","31","Otros","11","32","135","385","46","87","181","472","2.2857142857143"
"3","2017","31","Hotel","9","26","1823","3646","608","1216","2431","4862","1"
"3","2017","31","Hotel","16","20","61","93","6","10","67","103","1"
"3","2017","31","Otros","16","20","6","6","8","8","14","14","3.0769230769231"
"3","2017","31","","16","40","998","1686","25","132","1023","1818","1"
"3","2017","31","Hotel","15","16","1382","2705","259","656","1641","3361","1"
"3","2017","31","Hotel","5","9","13","25","13","34","26","59","1"
"3","2017","31","Otros","7","38","32","81","5","5","37","86","2.75"
"3","2017","31","Otros","2","6","132","1844","0","0","132","1844","1"
"3","2017","31","Otros","2","6","37","153","0","0","37","153","1"
"3","2017","31","Hotel","15","27","260","837","22","22","282","859","1"
"3","2017","31","Otros","7","38","75","124","0","0","75","124","2.75"
"3","2017","31","Otros","2","1","45","216","31","31","76","247","1"
"3","2017","31","Otros","8","3","51","70","5","5","56","75","10"
"3","2017","31","Otros","11","36","18","51","0","0","18","51","5.1904761904762"
"3","2017","31","Otros","16","20","25","33","0","0","25","33","3.0769230769231"
"3","2017","31","Otros","8","3","413","892","0","0","413","892","1"
"3","2017","31","Otros","4","39","30","41","0","0","30","41","2.2222222222222"
"3","2017","31","Otros","5","5","367","710","160","339","527","1049","3.65625"
"3","2017","31","Otros","12","27","2","20","19","23","21","43","3.4285714285714"
"3","2017","31","Otros","7","27","32","144","10","50","42","194","1"
"3","2017","31","Hotel","2","6","9","13","22","37","31","50","1"
"3","2017","31","Hotel","14","27","109","165","116","171","225","336","1"
"3","2017","31","Hotel","16","19","637","965","340","2050","977","3015","1"
"3","2017","31","","2","1","49","446","0","0","49","446","1"
"3","2017","31","Hotel","2","27","60","106","8","58","68","164","1"
"3","2017","31","Otros","16","20","151","195","0","0","151","195","1"
"3","2017","0","Otros","13","14","0","0","0","0","0","0","1"
"3","2017","31","Hotel","11","36","97","128","9","10","106","138","2.375"
"3","2017","31","Otros","13","14","8","120","0","0","8","120","7.3846153846154"
"3","2017","31","Otros","12","27","8","10","0","0","8","10","3.4285714285714"
"3","2017","31","Hotel","2","6","254","501","28","30","282","531","2.2"
"3","2017","31","Otros","2","6","107","3210","0","0","107","3210","1"
"3","2017","31","Otros","10","27","14","27","0","0","14","27","4.84"
"3","2017","31","Otros","12","27","4","7","2","2","6","9","3.4285714285714"
"3","2017","31","Otros","13","14","23","89","0","0","23","89","7.3846153846154"
"3","2017","31","Otros","6","12","149","289","26","53","175","342","1.8256578947368"
"3","2017","31","Otros","2","6","744","1104","80","171","824","1275","1"
"3","2017","31","Hotel","12","35","57","107","128","228","185","335","1.7272727272727"
"3","2017","31","Otros","5","5","28","35","0","0","28","35","3.65625"
"3","2017","31","Otros","9","30","0","0","6","186","6","186","2.3333333333333"
"3","2017","31","Hotel","8","2","4","4","3","3","7","7","1"
"3","2017","31","Otros","9","30","5","5","0","0","5","5","2.3333333333333"
"3","2017","31","Hotel","15","27","13","13","0","0","13","13","1"
"3","2017","31","Hotel","3","7","18","18","3","3","21","21","1"
"3","2017","26","Otros","6","12","385","535","0","0","385","535","1.8256578947368"
"3","2017","31","Otros","12","27","29","29","20","20","49","49","3.4285714285714"
"3","2017","31","Otros","2","6","15","39","1","2","16","41","5"
"3","2017","31","Otros","6","27","26","69","0","0","26","69","3.960088691796"
"3","2017","31","Hotel","10","11","188","460","23","53","211","513","1"
"3","2017","31","Otros","2","1","7","49","0","0","7","49","1"
"3","2017","31","Otros","11","36","30","30","6","6","36","36","5.1904761904762"
"3","2017","31","Hotel","11","32","0","0","0","0","0","0","1"
"3","2017","31","Otros","2","27","17","66","0","0","17","66","1"
"3","2017","31","Otros","12","27","3","3","3","3","6","6","3.4285714285714"
"3","2017","31","Hotel","8","2","46","46","0","0","46","46","3"
"3","2017","31","Hotel","16","20","42","54","0","0","42","54","1"
"3","2017","31","Otros","12","35","0","0","122","182","122","182","3.5"
"3","2017","31","Otros","13","14","15","28","3","9","18","37","1"
"3","2017","31","Otros","2","27","33","74","0","0","33","74","3.2"
"3","2017","31","Hotel","6","27","13","13","0","0","13","13","3"
"3","2017","31","Hotel","8","3","98","211","37","65","135","276","4.1111111111111"
"3","2017","28","Hotel","15","27","109","195","4","4","113","199","1"
"3","2017","31","Otros","8","3","65","139","7","10","72","149","10"
"3","2017","0","Hotel","16","20","0","0","0","0","0","0","1"
"3","2017","31","Hotel","6","28","51","147","0","0","51","147","2.4"
"3","2017","31","Otros","2","1","55","126","8","16","63","142","5.5"
"3","2017","31","Hotel","11","36","108","169","229","478","337","647","2.375"
"3","2017","31","Otros","4","13","98","825","1","3","99","828","1"
"3","2017","31","Otros","2","6","195","1365","0","0","195","1365","1"
"3","2017","31","Otros","8","34","82","134","89","131","171","265","5.75"
"3","2017","31","Hotel","11","15","3","3","0","0","3","3","1"
"3","2017","31","Otros","15","27","12","21","0","0","12","21","1.4222222222222"
"3","2017","31","Hotel","13","14","106","174","8","14","114","188","1"
"3","2017","31","Hotel","13","14","156","351","18","40","174","391","1"
"3","2017","31","Hotel","9","30","50","54","22","32","72","86","1"
"3","2017","31","Hotel","4","13","213","356","128","201","341","557","5.4"
"3","2017","31","Otros","6","27","3","6","0","0","3","6","3.960088691796"
"3","2017","20","Hotel","15","27","7","14","0","0","7","14","1"
"3","2017","31","Hotel","2","29","16","67","89","290","105","357","2"
"3","2017","31","Hotel","13","33","84","218","42","84","126","302","2"
"3","2017","31","Hotel","12","35","57","107","128","228","185","335","1.7272727272727"
"3","2017","31","Hotel","13","14","78","1091","14","44","92","1135","1"
"3","2017","31","Otros","6","25","33","49","0","0","33","49","2.3846153846154"
"3","2017","31","Hotel","8","2","4","6","2","4","6","10","3"
"3","2017","31","Otros","4","39","31","55","0","0","31","55","2.2222222222222"
"3","2017","31","Otros","6","12","110","144","9","20","119","164","1.8256578947368"
"3","2017","31","Otros","13","33","35","66","43","59","78","125","5.125"
"3","2017","31","Hotel","4","13","63","236","0","0","63","236","5.4"
"3","2017","31","Hotel","7","27","136","248","6","6","142","254","4.1666666666667"
"3","2017","31","Hotel","4","13","750","2045","120","120","870","2165","1"
"3","2017","31","","5","8","9","19","0","0","9","19","1"
"3","2017","31","Otros","8","2","41","69","12","13","53","82","6.4285714285714"
"3","2017","31","Otros","2","6","2","2","21","21","23","23","1"
"3","2017","31","","6","10","0","0","0","0","0","0","1"
"3","2017","31","Hotel","2","29","36","49","85","126","121","175","2"
"3","2017","31","","14","31","114","181","478","1398","592","1579","1"
"3","2017","31","Hotel","16","27","3352","13409","0","0","3352","13409","1"
"3","2017","31","Hotel","12","35","80","148","101","130","181","278","1.7272727272727"
"3","2017","31","","12","35","3163","3587","3761","4067","6924","7654","1"
"3","2017","31","","9","26","28","61","0","0","28","61","1"
"3","2017","31","Otros","11","32","213","272","0","0","213","272","2.2857142857143"
"3","2017","31","Otros","12","24","63","164","79","134","142","298","9.2"
"3","2017","31","Hotel","6","25","30","40","0","0","30","40","1"
"3","2017","31","Otros","11","32","27","50","0","0","27","50","2.2857142857143"
"3","2017","31","Hotel","16","19","86","163","2","4","88","167","4"
"3","2017","31","Otros","13","33","26","35","0","0","26","35","5.125"
"3","2017","31","Otros","16","27","23","97","0","0","23","97","13.818181818182"
"3","2017","31","Otros","6","12","140","321","0","0","140","321","1.8256578947368"
"3","2017","31","Otros","2","29","0","0","2","10","2","10","3.28"
"3","2017","31","Hotel","14","27","68","165","85","114","153","279","1"
"3","2017","31","Otros","2","1","1","1","0","0","1","1","1"
"3","2017","31","Otros","11","32","10","10","0","0","10","10","2.2857142857143"
"3","2017","31","Otros","2","27","1","1","0","0","1","1","1"
"3","2017","31","Hotel","2","29","72","286","8","20","80","306","1"
"3","2017","31","Hotel","4","13","80","339","0","0","80","339","3.2"
"3","2017","31","Hotel","4","21","6","18","0","0","6","18","3"
"3","2017","31","Otros","7","27","80","114","0","0","80","114","4.8333333333333"
"3","2017","31","","3","4","98","178","76","133","174","311","1"
"3","2017","31","Hotel","6","27","11","19","4","4","15","23","3"
"3","2017","31","Otros","16","19","26","26","0","0","26","26","10.263157894737"
"3","2017","31","Otros","11","32","51","104","21","23","72","127","2.2857142857143"
"3","2017","31","Otros","3","7","18","36","37","55","55","91","2"
"3","2017","31","Otros","5","5","21","40","44","73","65","113","3.65625"
"3","2017","24","Otros","15","27","1008","1008","0","0","1008","1008","1.4222222222222"
"3","2017","31","Otros","6","25","64","74","2","2","66","76","2.3846153846154"
"3","2017","31","","10","27","23","30","15","18","38","48","1"
"3","2017","31","Otros","2","29","38","79","169","254","207","333","3.28"
"3","2017","31","Otros","12","35","11","15","50","57","61","72","3.5"
"3","2017","31","Otros","16","19","10","22","0","0","10","22","10.263157894737"
"3","2017","31","Otros","9","26","40","63","0","0","40","63","3.8888888888889"
"3","2017","31","Hotel","13","33","40","40","69","69","109","109","2"
"3","2017","31","Otros","11","32","14","26","2","2","16","28","2.2857142857143"
"3","2017","31","Otros","9","22","8","22","0","0","8","22","7.6428571428571"
"3","2017","31","Otros","6","27","10","310","0","0","10","310","3.960088691796"
"3","2017","31","Otros","15","27","53","53","0","0","53","53","1.4222222222222"
"3","2017","31","Otros","11","32","96","96","16","16","112","112","2.2857142857143"
"3","2017","31","Otros","11","15","42","69","1","1","43","70","2.3571428571429"
"3","2017","31","Otros","9","37","3","90","0","0","3","90","4.5"
"3","2017","31","Otros","5","9","42","50","14","31","56","81","4.0454545454545"
"3","2017","31","Hotel","10","27","16","26","0","0","16","26","2.25"
"3","2017","31","Otros","6","28","12","150","0","0","12","150","4.65"
"3","2017","31","Otros","4","13","27","36","19","25","46","61","3.4"
"3","2017","31","Otros","2","1","1","1","0","0","1","1","1"
"3","2017","31","Otros","2","29","37","74","49","98","86","172","3.28"
"3","2017","31","Hotel","8","3","22","38","3","7","25","45","4.1111111111111"
"3","2017","31","Otros","16","19","123","386","0","0","123","386","1.3333333333333"
"3","2017","31","Otros","12","35","7","7","48","55","55","62","3.5"
"3","2017","31","Hotel","12","35","18","40","190","240","208","280","1.7272727272727"
"3","2017","31","Otros","12","35","6","11","60","92","66","103","3.5"
"3","2017","31","Otros","2","29","56","102","69","122","125","224","3.28"
"3","2017","31","Hotel","7","27","105","158","9","9","114","167","1"
"3","2017","31","Hotel","9","22","30","46","1","2","31","48","2.5555555555556"
"3","2017","31","Hotel","12","35","18","39","173","283","191","322","1.7272727272727"
"3","2017","31","Otros","15","16","96","256","24","68","120","324","2"
"3","2017","31","Hotel","15","27","2","2","0","0","2","2","1"
"3","2017","31","Otros","4","13","21","21","0","0","21","21","3.4"
"3","2017","31","Hotel","8","34","97","183","45","94","142","277","2.5714285714286"
"3","2017","0","Hotel","16","20","0","0","0","0","0","0","1"
"3","2017","31","Hotel","6","28","174","174","67","67","241","241","2.4"
"3","2017","31","Hotel","15","27","76","295","8","57","84","352","1"
"3","2017","31","Otros","12","35","157","389","110","251","267","640","3.5"
"3","2017","31","Otros","11","15","29","55","0","0","29","55","2.3571428571429"
"3","2017","31","Otros","11","15","80","179","0","0","80","179","2.3571428571429"
"3","2017","18","Otros","11","36","97","172","64","89","161","261","5.1904761904762"
"3","2017","31","Hotel","11","36","62","112","30","42","92","154","2.375"
"3","2017","31","Hotel","6","12","101","186","0","0","101","186","5"
"3","2017","31","Otros","8","3","75","111","46","66","121","177","10"
"3","2017","31","Otros","10","27","18","30","21","38","39","68","4.84"
"3","2017","31","Otros","8","3","11","25","22","54","33","79","10"
"3","2017","31","Otros","6","25","6","6","0","0","6","6","2.3846153846154"
"3","2017","31","Hotel","2","27","139","249","0","0","139","249","1"
"3","2017","31","Hotel","10","18","11","44","283","737","294","781","3.2"
"3","2017","31","Otros","11","32","89","208","16","59","105","267","1"
"3","2017","31","Hotel","6","10","697","882","294","402","991","1284","1"
"3","2017","31","Otros","11","32","54","93","6","12","60","105","2.2857142857143"
"3","2017","0","Otros","2","27","0","0","0","0","0","0","1"
"3","2017","31","","12","24","101","272","654","1785","755","2057","1"
"3","2017","31","Hotel","16","27","238","301","0","0","238","301","5.8571428571429"
"3","2017","31","Hotel","7","38","52","476","8","11","60","487","1"
"3","2017","31","Hotel","6","12","1272","1272","2","5","1274","1277","1"
"4","2017","30","Hotel","14","31","1315","2000","7366","8967","8681","10967","1"
"4","2017","30","Hotel","14","31","462","905","2584","6920","3046","7825","1"
"4","2017","30","Hotel","14","31","1032","1328","1771","6433","2803","7761","1"
"4","2017","30","Hotel","11","32","61","110","12","32","73","142","1"
"4","2017","30","Hotel","14","27","2826","4656","577","954","3403","5610","1"
"4","2017","30","Otros","11","32","76","113","0","0","76","113","2.2857142857143"
"4","2017","30","Hotel","14","31","223","307","3691","4350","3914","4657","5.4"
"4","2017","30","Hotel","15","16","1200","2983","69","248","1269","3231","1"
"4","2017","30","Hotel","14","31","1485","3868","908","3505","2393","7373","5.4"
"4","2017","30","Hotel","12","24","2583","3221","2664","5174","5247","8395","1"
"4","2017","30","Hotel","16","40","1041","1707","502","1058","1543","2765","1"
"4","2017","30","Hotel","6","12","1380","1834","38","108","1418","1942","1"
"4","2017","30","Hotel","10","23","866","1306","131","238","997","1544","1"
"4","2017","30","Hotel","14","31","1862","2944","381","695","2243","3639","5.4"
"4","2017","30","Hotel","3","4","843","1651","51","277","894","1928","1"
"4","2017","30","","11","32","249","306","20","38","269","344","1"
"4","2017","30","Hotel","6","12","663","1212","72","242","735","1454","1"
"4","2017","30","Hotel","6","12","2319","3114","274","382","2593","3496","1"
"4","2017","30","Hotel","9","26","3036","5806","228","312","3264","6118","1"
"4","2017","30","Hotel","2","1","520","1770","42","209","562","1979","1"
"4","2017","30","Hotel","9","26","741","1622","391","2877","1132","4499","1"
"4","2017","30","Hotel","6","12","487","814","47","107","534","921","1"
"4","2017","30","Hotel","14","31","49","60","5433","7949","5482","8009","5.4"
"4","2017","30","Hotel","11","32","178","272","0","0","178","272","1"
"4","2017","30","Hotel","2","6","1512","2882","358","614","1870","3496","1"
"4","2017","30","Hotel","16","40","1421","2705","1174","1756","2595","4461","1"
"4","2017","30","Hotel","14","27","903","1988","535","1313","1438","3301","1"
"4","2017","30","Otros","11","36","140","276","0","0","140","276","1"
"4","2017","30","Hotel","10","23","830","1355","778","1282","1608","2637","1"
"4","2017","30","Hotel","14","31","312","759","643","3080","955","3839","7.8"
"4","2017","30","Hotel","7","17","489","970","60","154","549","1124","1"
"4","2017","30","Hotel","2","1","2178","2694","196","213","2374","2907","2"
"4","2017","30","Hotel","2","1","1742","2722","370","879","2112","3601","2"
"4","2017","30","Hotel","4","13","776","1349","375","666","1151","2015","1"
"4","2017","30","Hotel","2","1","1521","1678","253","274","1774","1952","2"
"4","2017","30","Hotel","10","27","1210","2366","737","1480","1947","3846","1"
"4","2017","30","Hotel","14","27","966","1370","2000","2589","2966","3959","1"
"4","2017","30","Hotel","14","27","1861","2476","977","1955","2838","4431","1"
"4","2017","30","Hotel","6","12","1312","2748","69","262","1381","3010","1"
"4","2017","30","Hotel","6","12","1447","1785","693","800","2140","2585","1"
"4","2017","30","Hotel","13","27","1967","3954","2","2","1969","3956","1"
"4","2017","30","Hotel","14","31","199","388","1722","4605","1921","4993","7.8"
"4","2017","30","Hotel","6","12","1252","1792","258","366","1510","2158","1"
"4","2017","30","Hotel","16","27","2230","4068","265","463","2495","4531","1"
"4","2017","30","","10","27","26","39","6","8","32","47","1"
"4","2017","30","Hotel","10","18","529","1199","630","1108","1159","2307","1"
"4","2017","30","Hotel","9","37","1653","2984","254","418","1907","3402","1"
"4","2017","30","Hotel","16","27","822","3290","0","0","822","3290","1"
"4","2017","30","Hotel","15","16","824","1480","134","328","958","1808","2"
"4","2017","30","Hotel","2","1","914","1664","188","342","1102","2006","2"
"4","2017","30","Hotel","3","4","574","1273","174","322","748","1595","1"
"4","2017","30","Hotel","16","40","1213","1849","836","1266","2049","3115","1"
"4","2017","30","Hotel","7","17","2774","3284","305","374","3079","3658","1"
"4","2017","30","Hotel","12","24","1197","1959","1264","2030","2461","3989","1"
"4","2017","30","Hotel","12","35","1122","2216","776","1438","1898","3654","1"
"4","2017","30","Hotel","2","6","346","794","24","24","370","818","1"
"4","2017","30","Hotel","13","33","1265","1303","462","481","1727","1784","1"
"4","2017","30","Hotel","10","27","1072","1585","749","1025","1821","2610","1"
"4","2017","30","Hotel","10","23","1192","1820","243","454","1435","2274","1"
"4","2017","30","Hotel","11","36","876","1420","308","771","1184","2191","1"
"4","2017","30","Hotel","8","34","1390","2051","41","85","1431","2136","1"
"4","2017","30","Hotel","2","6","519","1486","160","294","679","1780","1"
"4","2017","30","Hotel","14","31","635","1047","1284","1930","1919","2977","7.8"
"4","2017","30","Hotel","11","36","1933","2868","174","286","2107","3154","1"
"4","2017","30","","10","27","147","267","234","361","381","628","1"
"4","2017","30","Hotel","14","31","1074","1466","2553","6754","3627","8220","5.4"
"4","2017","30","Hotel","4","13","2261","2275","3","6","2264","2281","1"
"4","2017","30","Hotel","6","28","773","1023","83","155","856","1178","1"
"4","2017","30","Otros","14","31","52","87","287","424","339","511","2.8"
"4","2017","30","Otros","16","27","84","84","8","8","92","92","2"
"4","2017","30","Hotel","2","1","1080","1691","77","156","1157","1847","2"
"4","2017","30","Hotel","10","18","1419","2006","768","1212","2187","3218","1"
"4","2017","30","Hotel","7","17","957","1290","73","129","1030","1419","1"
"4","2017","30","Hotel","12","24","572","1444","425","1382","997","2826","1"
"4","2017","30","Hotel","10","18","770","1385","449","816","1219","2201","1"
"4","2017","30","Hotel","2","1","3639","4256","61","96","3700","4352","1"
"4","2017","30","Hotel","10","18","737","1195","369","744","1106","1939","1"
"4","2017","30","Hotel","6","28","1398","1862","284","364","1682","2226","1"
"4","2017","30","Hotel","5","5","1657","1657","242","242","1899","1899","1"
"4","2017","30","Hotel","4","13","661","719","63","129","724","848","1"
"4","2017","30","Hotel","10","18","1064","2395","448","819","1512","3214","1"
"4","2017","30","Hotel","16","40","875","1317","237","312","1112","1629","1"
"4","2017","30","Hotel","8","3","2039","4437","556","1205","2595","5642","1"
"4","2017","30","Hotel","15","16","1100","1311","227","436","1327","1747","2"
"4","2017","30","Hotel","14","31","138","230","239","888","377","1118","7.8"
"4","2017","30","Hotel","13","33","587","720","377","742","964","1462","1"
"4","2017","30","Hotel","15","16","558","820","132","226","690","1046","2"
"4","2017","30","Otros","4","21","675","971","7","7","682","978","1"
"4","2017","30","Hotel","6","10","829","1510","0","0","829","1510","1"
"4","2017","30","Hotel","16","19","243","379","37","75","280","454","1"
"4","2017","30","Hotel","16","27","752","1998","11","23","763","2021","1"
"4","2017","30","Hotel","10","11","1685","2418","153","269","1838","2687","1"
"4","2017","30","Otros","10","23","250","653","8","27","258","680","1"
"4","2017","30","Hotel","12","35","109","546","208","618","317","1164","1"
"4","2017","30","Hotel","11","36","640","1140","357","565","997","1705","1"
"4","2017","30","Hotel","14","31","50","282","138","1560","188","1842","17.4"
"4","2017","30","Hotel","10","18","423","1026","570","1517","993","2543","3.2"
"4","2017","30","Hotel","4","13","384","549","36","69","420","618","1"
"4","2017","30","Hotel","6","12","359","554","124","281","483","835","5"
"4","2017","30","Hotel","6","10","581","812","90","160","671","972","1"
"4","2017","30","Otros","5","5","215","397","72","154","287","551","3.65625"
"4","2017","30","Hotel","12","24","504","634","556","1016","1060","1650","1"
"4","2017","30","Hotel","8","3","821","1681","225","437","1046","2118","1"
"4","2017","30","Hotel","13","27","550","1015","0","0","550","1015","2.75"
"4","2017","30","Hotel","15","16","445","957","156","518","601","1475","4"
"4","2017","30","Otros","15","16","245","679","16","93","261","772","2"
"4","2017","30","Otros","16","20","278","523","0","0","278","523","1"
"4","2017","30","Hotel","3","4","620","966","82","82","702","1048","1"
"4","2017","30","Hotel","11","36","78","106","0","0","78","106","1"
"4","2017","30","Hotel","2","6","338","592","90","160","428","752","1"
"4","2017","30","Hotel","8","34","719","1241","147","254","866","1495","1"
"4","2017","30","Hotel","4","13","3","6","3","8","6","14","3.2"
"4","2017","30","Hotel","13","27","880","1666","0","0","880","1666","2.75"
"4","2017","30","Hotel","2","29","437","862","738","1484","1175","2346","1"
"4","2017","30","Otros","11","36","166","368","0","0","166","368","1"
"4","2017","30","","10","11","5","5","0","0","5","5","1"
"4","2017","30","Hotel","4","13","743","1081","77","139","820","1220","1"
"4","2017","30","Hotel","16","40","2011","3020","855","1285","2866","4305","5.6666666666667"
"4","2017","30","Hotel","10","23","620","1026","662","1432","1282","2458","2.8"
"4","2017","30","Hotel","8","34","283","409","171","320","454","729","1"
"4","2017","30","Hotel","5","5","470","951","50","150","520","1101","1"
"4","2017","30","Hotel","3","4","73","151","89","177","162","328","3"
"4","2017","30","Hotel","9","26","85","299","6","12","91","311","1"
"4","2017","30","Hotel","8","34","327","483","224","370","551","853","1"
"4","2017","30","Hotel","7","17","187","367","47","117","234","484","4"
"4","2017","30","Hotel","4","13","146","309","34","82","180","391","3.2"
"4","2017","30","Hotel","12","35","57","173","314","1196","371","1369","1"
"4","2017","30","Hotel","16","40","964","1926","1217","2432","2181","4358","1"
"4","2017","30","Hotel","9","26","290","562","66","189","356","751","1"
"4","2017","30","","6","27","159","238","19","32","178","270","1"
"4","2017","30","Hotel","9","26","222","439","6","8","228","447","1"
"4","2017","30","Hotel","4","13","127","226","29","43","156","269","3.2"
"4","2017","30","Hotel","6","28","469","581","42","59","511","640","1"
"4","2017","30","","2","29","80","236","685","2115","765","2351","1"
"4","2017","30","Hotel","13","33","1292","1604","122","234","1414","1838","1"
"4","2017","30","Hotel","8","3","238","510","57","121","295","631","1"
"4","2017","30","Hotel","14","27","484","578","862","1281","1346","1859","1"
"4","2017","30","Hotel","16","40","311","531","0","0","311","531","5.6666666666667"
"4","2017","30","Hotel","12","24","407","661","487","738","894","1399","1"
"4","2017","30","Hotel","10","18","912","1683","147","282","1059","1965","3.2"
"4","2017","30","Otros","15","16","159","159","8","8","167","167","9"
"4","2017","30","Hotel","6","10","530","552","0","0","530","552","1"
"4","2017","30","Hotel","10","11","589","1068","54","169","643","1237","1"
"4","2017","30","Otros","6","10","92","130","4","8","96","138","3.8518518518518"
"4","2017","30","Otros","10","23","64","128","0","0","64","128","1"
"4","2017","30","Hotel","10","23","349","607","391","883","740","1490","2.8"
"4","2017","30","Hotel","6","12","127","197","27","52","154","249","5"
"4","2017","30","Hotel","6","27","219","312","0","0","219","312","3"
"4","2017","30","Hotel","10","23","373","602","351","851","724","1453","2.8"
"4","2017","30","","4","39","68","77","0","0","68","77","1"
"4","2017","30","Hotel","8","34","274","336","538","759","812","1095","1"
"4","2017","30","Hotel","8","34","429","562","472","681","901","1243","1"
"4","2017","30","Otros","4","39","1","2","0","0","1","2","2.2222222222222"
"4","2017","30","Otros","13","14","364","728","0","0","364","728","1"
"4","2017","30","Hotel","10","23","274","350","107","125","381","475","2.8"
"4","2017","30","Otros","13","14","379","1305","0","0","379","1305","1"
"4","2017","30","Hotel","12","24","203","322","408","760","611","1082","1"
"4","2017","30","","6","25","140","298","0","0","140","298","1"
"4","2017","30","Hotel","15","27","324","526","4","4","328","530","1"
"4","2017","30","Hotel","12","35","94","171","84","224","178","395","1"
"4","2017","30","Hotel","16","40","320","1920","988","3469","1308","5389","1"
"4","2017","30","Hotel","16","27","105","245","148","310","253","555","1"
"4","2017","30","Hotel","9","30","130","290","0","0","130","290","1"
"4","2017","30","Hotel","4","13","202","465","23","65","225","530","3.2"
"4","2017","30","Hotel","2","29","95","329","227","858","322","1187","1"
"4","2017","30","Hotel","16","20","458","488","313","346","771","834","1"
"4","2017","30","Hotel","5","5","380","1039","251","531","631","1570","1"
"4","2017","30","Hotel","13","33","728","1151","83","158","811","1309","1"
"4","2017","30","Otros","16","19","109","176","0","0","109","176","1.3333333333333"
"4","2017","30","Hotel","12","24","133","384","256","724","389","1108","1"
"4","2017","30","","8","2","340","633","60","74","400","707","1"
"4","2017","30","Hotel","12","35","32","238","171","886","203","1124","1"
"4","2017","30","Hotel","16","27","52","65","572","636","624","701","2.5"
"4","2017","30","Otros","16","27","563","913","16","26","579","939","2"
"4","2017","30","Hotel","8","34","321","451","372","622","693","1073","1"
"4","2017","30","Otros","8","3","143","515","0","0","143","515","1"
"4","2017","30","Hotel","7","27","215","385","0","0","215","385","1"
"4","2017","30","Hotel","4","39","186","270","7","20","193","290","1"
"4","2017","30","Hotel","15","16","383","481","91","117","474","598","4"
"4","2017","30","Hotel","4","39","3","5","0","0","3","5","1"
"4","2017","30","Hotel","4","39","159","303","1","1","160","304","1"
"4","2017","30","Hotel","15","16","213","790","9","23","222","813","4"
"4","2017","30","Hotel","14","31","199","353","222","636","421","989","17.4"
"4","2017","30","Hotel","8","34","261","411","297","408","558","819","1"
"4","2017","30","Hotel","6","28","213","278","34","45","247","323","1"
"4","2017","30","Hotel","7","17","696","1279","82","163","778","1442","4"
"4","2017","30","Otros","7","27","9","11","0","0","9","11","1"
"4","2017","30","Hotel","11","36","1564","1901","60","115","1624","2016","1"
"4","2017","30","Otros","4","21","112","130","120","176","232","306","1"
"4","2017","30","Otros","15","16","100","141","41","69","141","210","2"
"4","2017","30","Otros","7","17","229","453","24","63","253","516","3"
"4","2017","30","Hotel","7","38","146","198","19","26","165","224","1"
"4","2017","30","Hotel","16","27","462","567","13","36","475","603","2.5"
"4","2017","30","Hotel","2","6","75","135","3","3","78","138","2.2"
"4","2017","30","Hotel","11","36","359","655","93","169","452","824","1"
"4","2017","30","Hotel","6","28","102","144","16","23","118","167","1"
"4","2017","30","Hotel","6","12","59","92","0","0","59","92","5"
"4","2017","30","Otros","9","22","42","122","0","0","42","122","1"
"4","2017","30","","13","14","113","331","0","0","113","331","2"
"4","2017","30","Hotel","2","29","25","75","421","847","446","922","1"
"4","2017","30","Hotel","2","29","62","176","68","227","130","403","1"
"4","2017","30","Otros","4","13","273","299","13","13","286","312","1"
"4","2017","30","Hotel","15","16","71","166","34","76","105","242","4"
"4","2017","30","Hotel","2","1","92","274","0","0","92","274","6.4"
"4","2017","30","Otros","7","27","81","165","0","0","81","165","1"
"4","2017","30","Otros","13","33","21","42","0","0","21","42","5.125"
"4","2017","30","","4","21","367","419","8","12","375","431","1"
"4","2017","30","Hotel","6","10","353","353","4","4","357","357","1"
"4","2017","30","Hotel","11","36","100","254","0","0","100","254","1"
"4","2017","30","Otros","14","31","72","166","182","387","254","553","2.8"
"4","2017","30","Hotel","7","27","177","254","7","46","184","300","1"
"4","2017","30","Otros","6","10","15","360","0","0","15","360","3.8518518518518"
"4","2017","30","Hotel","4","39","48","54","2","2","50","56","2.6"
"4","2017","30","Otros","8","2","16","36","16","26","32","62","6.4285714285714"
"4","2017","30","Otros","11","36","127","204","11","19","138","223","5.1904761904762"
"4","2017","30","Hotel","13","33","123","123","17","17","140","140","1"
"4","2017","30","","3","4","90","162","62","79","152","241","1"
"4","2017","30","Hotel","7","17","255","717","44","104","299","821","4"
"4","2017","30","Hotel","8","2","162","257","9","9","171","266","1"
"4","2017","30","Otros","15","16","181","265","43","65","224","330","2"
"4","2017","26","Hotel","10","11","505","528","5","5","510","533","1"
"4","2017","30","Hotel","16","19","330","507","0","0","330","507","1"
"4","2017","30","Hotel","10","23","148","205","103","143","251","348","4"
"4","2017","30","","7","38","262","276","59","81","321","357","1"
"4","2017","30","Hotel","7","27","108","442","6","79","114","521","1"
"4","2017","30","Hotel","11","36","404","961","88","211","492","1172","1"
"4","2017","30","Hotel","16","40","174","262","13","23","187","285","16.333333333333"
"4","2017","30","Hotel","16","19","48","80","0","0","48","80","1"
"4","2017","30","Hotel","16","19","8","18","0","0","8","18","1"
"4","2017","30","Hotel","16","20","66","96","0","0","66","96","1"
"4","2017","30","Hotel","10","11","211","318","25","34","236","352","1"
"4","2017","30","Otros","7","27","66","116","4","4","70","120","4.8333333333333"
"4","2017","30","Otros","7","27","26","30","0","0","26","30","1"
"4","2017","30","Hotel","7","27","37","44","0","0","37","44","4.1666666666667"
"4","2017","30","Otros","13","14","156","423","0","0","156","423","1"
"4","2017","30","Otros","11","15","54","73","0","0","54","73","2.3571428571429"
"4","2017","30","Otros","10","27","14","19","31","31","45","50","4.84"
"4","2017","30","Otros","14","31","190","190","2591","2591","2781","2781","2.8"
"4","2017","30","Otros","11","36","38","68","10","13","48","81","5.1904761904762"
"4","2017","30","Hotel","16","19","44","44","0","0","44","44","1"
"4","2017","30","","14","27","152","194","0","0","152","194","2.6666666666667"
"4","2017","30","Hotel","16","40","64","66","12","12","76","78","5.6666666666667"
"4","2017","30","Hotel","10","27","8","13","0","0","8","13","2.25"
"4","2017","30","Otros","2","29","122","276","255","590","377","866","3.28"
"4","2017","30","Hotel","13","27","8","10","21","25","29","35","1"
"4","2017","30","Otros","9","22","86","105","2","2","88","107","1"
"4","2017","30","Hotel","2","27","88","164","3","15","91","179","1"
"4","2017","30","Hotel","8","34","217","295","418","547","635","842","1"
"4","2017","30","Hotel","7","27","271","435","0","0","271","435","1"
"4","2017","30","Hotel","15","16","196","503","69","138","265","641","4"
"4","2017","30","Hotel","16","20","115","159","7","7","122","166","1"
"4","2017","30","Otros","4","13","16","161","0","0","16","161","1"
"4","2017","30","Hotel","2","1","75","144","3","8","78","152","6.4"
"4","2017","30","Otros","11","32","8","24","0","0","8","24","2.2857142857143"
"4","2017","30","Hotel","2","29","13","85","144","1046","157","1131","1"
"4","2017","30","Hotel","16","27","167","178","66","84","233","262","2.5"
"4","2017","30","Hotel","10","18","110","772","58","116","168","888","3.2"
"4","2017","30","Otros","11","36","497","614","31","35","528","649","1"
"4","2017","30","Otros","13","14","45","96","0","0","45","96","1"
"4","2017","30","Hotel","7","27","117","169","0","0","117","169","1"
"4","2017","30","Otros","7","17","57","60","3","6","60","66","3"
"4","2017","30","Otros","14","31","222","422","249","549","471","971","2.8"
"4","2017","30","Hotel","2","29","99","321","323","1017","422","1338","1"
"4","2017","30","Hotel","8","3","186","585","145","244","331","829","1"
"4","2017","30","Hotel","8","34","233","281","135","249","368","530","2.5714285714286"
"4","2017","30","Hotel","8","34","177","222","248","577","425","799","2.5714285714286"
"4","2017","30","Hotel","12","35","120","156","106","165","226","321","1"
"4","2017","30","Hotel","11","32","136","263","3","5","139","268","1"
"4","2017","30","Hotel","13","33","166","283","43","43","209","326","2"
"4","2017","30","Hotel","10","23","195","271","134","239","329","510","2.8"
"4","2017","30","Hotel","12","35","261","1190","13","15","274","1205","1"
"4","2017","30","","16","40","254","354","71","131","325","485","3.0555555555556"
"4","2017","30","Otros","16","19","16","36","0","0","16","36","1.3333333333333"
"4","2017","30","Otros","16","20","35","140","0","0","35","140","1"
"4","2017","30","Hotel","6","12","147","599","9","28","156","627","5"
"4","2017","30","Hotel","16","19","178","233","0","0","178","233","4"
"4","2017","30","Hotel","12","24","127","337","186","356","313","693","1"
"4","2017","30","Hotel","12","24","173","395","120","183","293","578","3"
"4","2017","0","Hotel","8","3","0","0","0","0","0","0","1"
"4","2017","30","Hotel","5","9","0","0","0","0","0","0","1"
"4","2017","30","Hotel","16","27","174","217","21","31","195","248","2.5"
"4","2017","30","Otros","10","23","38","38","0","0","38","38","7"
"4","2017","30","Otros","13","14","84","157","4","4","88","161","7.3846153846154"
"4","2017","30","Otros","2","6","64","246","18","44","82","290","1"
"4","2017","18","Hotel","15","16","19","32","61","67","80","99","7.8"
"4","2017","30","Hotel","8","3","170","615","2","4","172","619","1"
"4","2017","30","Hotel","8","34","264","344","281","511","545","855","1"
"4","2017","30","Hotel","8","3","51","85","52","93","103","178","1"
"4","2017","30","","2","29","93","178","46","134","139","312","1"
"4","2017","30","Hotel","2","1","284","463","8","8","292","471","6.4"
"4","2017","30","Hotel","7","17","79","144","2","2","81","146","4"
"4","2017","30","Otros","7","17","131","308","12","36","143","344","3"
"4","2017","30","Hotel","16","40","144","242","64","126","208","368","5.6666666666667"
"4","2017","30","Hotel","12","24","199","421","279","377","478","798","1"
"4","2017","30","Hotel","14","31","187","518","270","879","457","1397","17.4"
"4","2017","0","Hotel","9","26","0","0","0","0","0","0","1"
"4","2017","30","Hotel","6","12","45","66","0","0","45","66","5"
"4","2017","30","Otros","5","9","19","33","16","30","35","63","4.0454545454545"
"4","2017","30","Otros","5","9","8","10","6","7","14","17","4.0454545454545"
"4","2017","30","Otros","15","27","89","109","0","0","89","109","1.4222222222222"
"4","2017","30","Hotel","8","34","0","0","1","1","1","1","2.5714285714286"
"4","2017","30","Hotel","10","18","297","617","89","209","386","826","7.75"
"4","2017","30","Hotel","15","16","288","536","124","229","412","765","7.8"
"4","2017","30","Hotel","2","29","134","378","222","730","356","1108","1"
"4","2017","30","Hotel","4","39","116","267","1","1","117","268","2.6"
"4","2017","30","Otros","4","39","75","94","1","1","76","95","2.2222222222222"
"4","2017","30","Hotel","4","13","68","106","30","44","98","150","5.4"
"4","2017","30","Otros","10","23","38","76","0","0","38","76","7"
"4","2017","30","Otros","14","31","101","185","388","964","489","1149","20.2"
"4","2017","30","Hotel","3","4","40","72","0","0","40","72","2.6"
"4","2017","30","Hotel","10","23","76","152","25","38","101","190","4"
"4","2017","30","Otros","9","22","103","1000","0","0","103","1000","1"
"4","2017","30","Hotel","12","24","225","442","184","277","409","719","3"
"4","2017","30","Hotel","13","14","14","20","0","0","14","20","1"
"4","2017","30","Hotel","12","35","251","908","119","152","370","1060","1.7272727272727"
"4","2017","30","Hotel","6","28","476","682","0","0","476","682","1"
"4","2017","30","","6","28","64","348","0","0","64","348","1"
"4","2017","30","Hotel","12","24","222","453","129","181","351","634","3"
"4","2017","30","Otros","5","9","8","8","5","5","13","13","4.0454545454545"
"4","2017","30","Hotel","16","20","46","60","0","0","46","60","1"
"4","2017","30","Hotel","4","21","168","300","13","21","181","321","3"
"4","2017","30","Otros","10","11","19","47","3","4","22","51","11.764705882353"
"4","2017","30","Otros","13","14","45","45","0","0","45","45","7.3846153846154"
"4","2017","30","Otros","16","27","87","164","0","0","87","164","13.818181818182"
"4","2017","12","Hotel","9","26","340","340","0","0","340","340","1"
"4","2017","30","Hotel","16","27","377","391","405","663","782","1054","2.5"
"4","2017","30","Hotel","3","4","439","1564","179","469","618","2033","3"
"4","2017","30","Otros","16","27","122","122","2","2","124","124","2"
"4","2017","30","Otros","16","19","482","889","0","0","482","889","1.3333333333333"
"4","2017","30","Hotel","6","12","408","626","0","0","408","626","5"
"4","2017","30","Hotel","2","1","202","339","56","148","258","487","6.4"
"4","2017","30","Hotel","10","11","358","574","32","56","390","630","1"
"4","2017","30","Otros","10","23","83","183","4","4","87","187","1"
"4","2017","30","Otros","10","27","498","547","208","253","706","800","4.84"
"4","2017","30","Hotel","16","27","194","338","20","45","214","383","2.5"
"4","2017","30","Hotel","6","28","122","169","23","31","145","200","1"
"4","2017","30","Hotel","4","13","0","0","11","15","11","15","5.4"
"4","2017","30","Hotel","14","27","464","632","10","10","474","642","8.5"
"4","2017","30","Hotel","10","27","119","162","345","439","464","601","1"
"4","2017","30","Hotel","13","27","77","131","65","102","142","233","4.2"
"4","2017","30","Hotel","3","4","500","825","13","24","513","849","3"
"4","2017","30","Otros","4","13","49","49","1","1","50","50","3.4"
"4","2017","30","Otros","11","15","5","25","0","0","5","25","2.3571428571429"
"4","2017","30","Otros","6","10","99","513","0","0","99","513","3.8518518518518"
"4","2017","30","Otros","2","1","76","85","17","17","93","102","1"
"4","2017","30","","6","12","72","271","0","0","72","271","1"
"4","2017","30","Otros","10","23","263","807","5","5","268","812","1"
"4","2017","30","Hotel","16","19","61","85","0","0","61","85","4"
"4","2017","30","Hotel","10","11","20","120","0","0","20","120","5.6666666666667"
"4","2017","30","Hotel","10","23","57","62","9","9","66","71","4"
"4","2017","30","Otros","14","31","51","127","248","597","299","724","2.8"
"4","2017","30","Otros","13","27","1","2","0","0","1","2","12.2"
"4","2017","30","Hotel","2","1","208","733","0","0","208","733","6.4"
"4","2017","30","Hotel","16","19","48","58","0","0","48","58","4"
"4","2017","30","Otros","12","35","35","44","8","10","43","54","3.5"
"4","2017","30","Otros","15","16","85","192","38","65","123","257","2"
"4","2017","30","Otros","9","22","306","612","20","40","326","652","1"
"4","2017","30","Hotel","10","27","209","307","526","695","735","1002","1"
"4","2017","30","Hotel","2","27","139","176","3","3","142","179","3.6"
"4","2017","30","Hotel","16","20","40","114","29","38","69","152","1"
"4","2017","30","Hotel","10","18","0","0","4","26","4","26","7.75"
"4","2017","30","Hotel","6","12","206","244","0","0","206","244","5"
"4","2017","30","Hotel","2","27","68","250","0","0","68","250","3.6"
"4","2017","30","Hotel","15","16","110","175","4","8","114","183","7.8"
"4","2017","30","Hotel","10","23","59","59","18","18","77","77","4"
"4","2017","30","Hotel","11","32","19","19","7","7","26","26","1"
"4","2017","30","Hotel","14","27","127","242","63","151","190","393","8.5"
"4","2017","30","Otros","10","11","33","37","8","8","41","45","11.764705882353"
"4","2017","30","Hotel","2","27","87","167","11","19","98","186","3.6"
"4","2017","30","Otros","13","14","145","221","2","3","147","224","7.3846153846154"
"4","2017","30","Hotel","2","1","105","157","19","20","124","177","6.4"
"4","2017","30","Otros","7","17","163","417","0","0","163","417","17.166666666667"
"4","2017","30","Otros","10","23","25","131","0","0","25","131","7"
"4","2017","30","Hotel","13","27","190","190","3","3","193","193","2.75"
"4","2017","30","Otros","10","18","0","0","15","19","15","19","10.25"
"4","2017","30","Otros","5","9","38","283","0","0","38","283","4.0454545454545"
"4","2017","30","Hotel","4","39","26","36","13","15","39","51","2.6"
"4","2017","30","Otros","16","27","55","186","0","0","55","186","13.818181818182"
"4","2017","30","Hotel","14","27","27","35","49","138","76","173","8.5"
"4","2017","30","Hotel","10","11","80","192","20","55","100","247","5.6666666666667"
"4","2017","30","Hotel","10","18","120","206","90","146","210","352","7.75"
"4","2017","30","Otros","14","31","98","145","73","141","171","286","20.2"
"4","2017","30","Otros","11","32","29","50","0","0","29","50","2.2857142857143"
"4","2017","30","Otros","5","5","8","8","5","15","13","23","3.65625"
"4","2017","30","Otros","6","25","60","96","0","0","60","96","2.3846153846154"
"4","2017","30","Hotel","3","4","52","135","11","39","63","174","2.6"
"4","2017","30","Otros","7","27","127","259","6","9","133","268","4.8333333333333"
"4","2017","30","Otros","2","29","104","215","171","356","275","571","3.28"
"4","2017","30","Hotel","2","29","63","109","198","285","261","394","1"
"4","2017","30","Otros","4","21","178","407","1","4","179","411","1"
"4","2017","30","Hotel","7","27","14","37","0","0","14","37","4.1666666666667"
"4","2017","30","Otros","5","5","11","37","19","22","30","59","3.65625"
"4","2017","30","Otros","11","36","69","109","78","113","147","222","5.1904761904762"
"4","2017","30","Hotel","7","27","466","556","0","0","466","556","4.1666666666667"
"4","2017","30","Hotel","16","20","18","21","0","0","18","21","1"
"4","2017","30","Hotel","12","24","98","201","140","207","238","408","3"
"4","2017","30","Hotel","9","26","122","219","16","26","138","245","1.5"
"4","2017","30","Hotel","7","17","228","857","4","16","232","873","10"
"4","2017","30","Hotel","9","37","263","349","43","67","306","416","3.4"
"4","2017","30","Hotel","5","5","245","468","111","151","356","619","2.1428571428571"
"4","2017","30","Otros","6","27","70","140","0","0","70","140","3.960088691796"
"4","2017","30","Hotel","9","37","44","94","9","12","53","106","3.4"
"4","2017","30","Otros","10","27","50","58","0","0","50","58","4.84"
"4","2017","30","Otros","8","3","219","429","26","40","245","469","10"
"4","2017","30","Otros","16","20","22","22","2","2","24","24","3.0769230769231"
"4","2017","30","Otros","9","22","16","20","0","0","16","20","7.6428571428571"
"4","2017","30","Otros","10","27","206","341","51","53","257","394","4.84"
"4","2017","30","Otros","10","23","45","58","10","12","55","70","7"
"4","2017","30","Otros","2","6","214","277","107","123","321","400","1"
"4","2017","30","Otros","4","39","15","19","0","0","15","19","2.2222222222222"
"4","2017","30","Hotel","2","27","86","100","22","30","108","130","1"
"4","2017","30","Hotel","14","31","52","72","128","481","180","553","24"
"4","2017","30","Otros","2","29","90","159","109","183","199","342","3.28"
"4","2017","30","Otros","8","3","220","1100","0","0","220","1100","10"
"4","2017","30","","13","14","33","59","15","26","48","85","1"
"4","2017","30","Hotel","6","10","143","165","36","36","179","201","6.6"
"4","2017","30","Hotel","8","34","159","293","91","164","250","457","2.5714285714286"
"4","2017","30","Hotel","9","22","228","1011","0","0","228","1011","2.5555555555556"
"4","2017","30","Hotel","2","6","89","607","23","27","112","634","2.2"
"4","2017","30","Hotel","10","27","118","156","184","239","302","395","2.25"
"4","2017","30","Otros","14","27","196","196","0","0","196","196","11.833333333333"
"4","2017","30","Otros","6","12","267","425","26","36","293","461","1.8256578947368"
"4","2017","30","Hotel","6","27","212","212","3","6","215","218","3"
"4","2017","30","Hotel","5","5","21","46","18","37","39","83","2.1428571428571"
"4","2017","30","Hotel","5","5","90","132","11","34","101","166","2.1428571428571"
"4","2017","30","Hotel","13","27","248","248","0","0","248","248","4.2"
"4","2017","30","Hotel","2","27","151","220","4","6","155","226","3.6"
"4","2017","30","Hotel","8","3","39","39","53","53","92","92","4.1111111111111"
"4","2017","30","Otros","11","36","60","159","24","64","84","223","5.1904761904762"
"4","2017","30","Otros","9","30","33","66","0","0","33","66","2.3333333333333"
"4","2017","30","Otros","16","19","28","52","0","0","28","52","10.263157894737"
"4","2017","30","Hotel","14","31","67","99","356","999","423","1098","17.4"
"4","2017","30","Hotel","2","1","324","379","16","16","340","395","6.4"
"4","2017","30","Hotel","16","40","808","1433","417","702","1225","2135","5.6666666666667"
"4","2017","30","Otros","7","17","286","507","10","14","296","521","17.166666666667"
"4","2017","30","Hotel","13","27","417","533","105","152","522","685","2.75"
"4","2017","30","Hotel","14","31","144","181","327","690","471","871","24"
"4","2017","30","Otros","3","4","33","68","6","15","39","83","12.2"
"4","2017","30","Otros","8","34","178","254","222","335","400","589","5.75"
"4","2017","30","Hotel","9","22","125","167","6","6","131","173","2.5555555555556"
"4","2017","30","Hotel","4","21","80","111","7","11","87","122","3"
"4","2017","30","Hotel","6","27","53","132","0","0","53","132","3"
"4","2017","30","Hotel","12","35","114","210","61","106","175","316","1.7272727272727"
"4","2017","30","Hotel","2","29","33","81","92","280","125","361","2"
"4","2017","30","Otros","10","11","52","74","4","7","56","81","11.764705882353"
"4","2017","30","Hotel","6","10","87","170","0","0","87","170","6.6"
"4","2017","30","Hotel","13","14","45","99","0","0","45","99","2"
"4","2017","30","Otros","16","27","59","88","0","0","59","88","13.818181818182"
"4","2017","30","Otros","6","27","17","17","0","0","17","17","3.960088691796"
"4","2017","30","Hotel","16","40","74","143","409","797","483","940","5.6666666666667"
"4","2017","30","Otros","6","10","136","234","0","0","136","234","3.8518518518518"
"4","2017","30","Otros","10","23","35","54","40","46","75","100","7"
"4","2017","30","Hotel","6","28","176","209","8","13","184","222","1"
"4","2017","30","Otros","7","38","484","695","137","197","621","892","2.75"
"4","2017","30","Hotel","6","12","154","208","2","2","156","210","5"
"4","2017","30","Hotel","13","27","276","493","0","0","276","493","4.2"
"4","2017","30","Otros","4","21","11","28","0","0","11","28","4.8333333333333"
"4","2017","30","Hotel","16","27","73","121","16","20","89","141","5.8571428571429"
"4","2017","30","Hotel","5","5","61","149","24","34","85","183","2.1428571428571"
"4","2017","30","Otros","12","24","36","53","81","104","117","157","9.2"
"4","2017","30","Otros","15","16","66","95","35","51","101","146","9"
"4","2017","30","Hotel","8","27","142","142","26","26","168","168","4.5"
"4","2017","30","Hotel","9","22","44","59","2","2","46","61","2.5555555555556"
"4","2017","30","Hotel","10","11","91","157","45","75","136","232","5.6666666666667"
"4","2017","30","Hotel","8","3","45","83","33","63","78","146","4.1111111111111"
"4","2017","30","Hotel","6","10","302","475","2","4","304","479","6.6"
"4","2017","30","Otros","9","26","9","30","0","0","9","30","3.8888888888889"
"4","2017","30","Hotel","4","39","79","227","4","10","83","237","2.6"
"4","2017","30","Otros","6","27","4","8","4","8","8","16","3.960088691796"
"4","2017","30","Otros","6","12","126","187","0","0","126","187","1.8256578947368"
"4","2017","30","Hotel","6","27","46","86","0","0","46","86","3"
"4","2017","30","Otros","5","9","81","127","23","38","104","165","4.0454545454545"
"4","2017","30","Hotel","2","27","84","84","17","17","101","101","3.6"
"4","2017","30","Hotel","2","29","10","41","181","562","191","603","1"
"4","2017","30","Hotel","4","13","36","174","0","0","36","174","5.4"
"4","2017","30","","11","15","14","280","0","0","14","280","1"
"4","2017","30","Hotel","6","10","236","259","17","20","253","279","6.6"
"4","2017","30","Otros","6","12","36","61","0","0","36","61","1.8256578947368"
"4","2017","30","Otros","10","18","45","95","28","42","73","137","10.25"
"4","2017","30","Otros","9","22","165","271","0","0","165","271","7.6428571428571"
"4","2017","30","","14","27","110","224","32","56","142","280","1"
"4","2017","30","Hotel","16","27","78","101","7","7","85","108","5.8571428571429"
"4","2017","30","Otros","2","29","11","22","50","57","61","79","3.28"
"4","2017","30","Otros","13","33","32","36","0","0","32","36","5.125"
"4","2017","30","Otros","13","33","0","0","4","4","4","4","5.125"
"4","2017","28","Otros","6","10","91","547","0","0","91","547","3.8518518518518"
"4","2017","30","Hotel","10","18","68","114","72","148","140","262","7.75"
"4","2017","30","Hotel","14","31","111","178","60","198","171","376","24"
"4","2017","30","Hotel","4","21","63","73","4","4","67","77","3"
"4","2017","30","Hotel","3","4","148","1036","0","0","148","1036","2.6"
"4","2017","0","Otros","8","27","0","0","0","0","0","0","1"
"4","2017","30","Otros","6","27","7","22","0","0","7","22","3.960088691796"
"4","2017","30","Hotel","6","25","413","490","0","0","413","490","1"
"4","2017","30","Otros","6","12","174","329","0","0","174","329","1.8256578947368"
"4","2017","30","Hotel","6","27","33","67","0","0","33","67","3"
"4","2017","30","Otros","6","27","142","311","0","0","142","311","3.960088691796"
"4","2017","30","Otros","6","10","45","172","0","0","45","172","3.8518518518518"
"4","2017","30","Otros","6","12","59","104","0","0","59","104","1.8256578947368"
"4","2017","30","Otros","5","5","17","27","8","8","25","35","3.65625"
"4","2017","30","Hotel","12","24","25","158","19","38","44","196","3"
"4","2017","30","Hotel","15","16","71","106","13","13","84","119","7.8"
"4","2017","30","Otros","4","13","63","83","0","0","63","83","3.4"
"4","2017","30","Hotel","2","29","167","527","103","361","270","888","1"
"4","2017","30","Hotel","4","21","8","20","0","0","8","20","3"
"4","2017","30","Hotel","10","27","126","173","408","558","534","731","2.25"
"4","2017","30","Hotel","8","3","155","259","51","100","206","359","4.1111111111111"
"4","2017","30","Hotel","12","27","58","71","23","23","81","94","1"
"4","2017","30","Otros","5","5","89","157","41","93","130","250","3.65625"
"4","2017","30","Otros","13","14","12","12","0","0","12","12","7.3846153846154"
"4","2017","30","Otros","10","11","130","563","0","0","130","563","11.764705882353"
"4","2017","30","Otros","16","40","121","214","10","61","131","275","28.142857142857"
"4","2017","30","Hotel","11","36","287","802","68","143","355","945","1"
"4","2017","30","Otros","8","34","84","124","67","115","151","239","5.75"
"4","2017","30","Hotel","7","17","107","138","6","10","113","148","10"
"4","2017","30","Otros","12","35","135","355","7","10","142","365","3.5"
"4","2017","30","Otros","5","9","62","136","11","15","73","151","4.0454545454545"
"4","2017","30","Hotel","9","22","52","71","1","6","53","77","2.5555555555556"
"4","2017","30","Otros","2","29","30","61","35","91","65","152","3.28"
"4","2017","30","Otros","2","29","52","109","52","124","104","233","3.28"
"4","2017","30","Hotel","10","27","59","117","112","161","171","278","2.25"
"4","2017","30","Hotel","16","19","43","83","26","52","69","135","4"
"4","2017","30","Hotel","16","40","92","264","16","48","108","312","16.333333333333"
"4","2017","30","Hotel","8","27","225","279","37","37","262","316","4.5"
"4","2017","30","Otros","13","14","10","14","0","0","10","14","7.3846153846154"
"4","2017","30","Hotel","7","27","17","19","0","0","17","19","4.1666666666667"
"4","2017","30","Otros","2","6","1","1","0","0","1","1","5"
"4","2017","30","Hotel","7","17","288","580","39","69","327","649","10"
"4","2017","30","Hotel","3","4","110","207","46","64","156","271","2.6"
"4","2017","30","Otros","6","12","18","136","0","0","18","136","1.8256578947368"
"4","2017","30","Otros","6","10","26","26","0","0","26","26","3.8518518518518"
"4","2017","30","Hotel","16","40","28","46","16","32","44","78","16.333333333333"
"4","2017","30","Otros","4","39","26","54","9","9","35","63","2.2222222222222"
"4","2017","30","Otros","13","14","43","107","0","0","43","107","7.3846153846154"
"4","2017","30","Otros","7","38","102","160","9","14","111","174","2.75"
"4","2017","30","Hotel","11","32","54","96","0","0","54","96","1"
"4","2017","30","Otros","11","36","136","271","6","15","142","286","5.1904761904762"
"4","2017","30","Hotel","4","21","49","63","8","8","57","71","3"
"4","2017","30","Otros","3","4","5","14","2","2","7","16","12.2"
"4","2017","30","Otros","5","9","34","50","16","29","50","79","4.0454545454545"
"4","2017","30","Hotel","8","27","46","57","0","0","46","57","4.5"
"4","2017","30","","7","17","82","191","0","0","82","191","1"
"4","2017","30","Otros","16","20","43","128","2","4","45","132","3.0769230769231"
"4","2017","30","Otros","4","21","51","52","3","3","54","55","4.8333333333333"
"4","2017","30","Otros","13","33","62","64","42","54","104","118","5.125"
"4","2017","30","","12","35","0","0","265","1121","265","1121","1"
"4","2017","30","Hotel","13","33","5","5","0","0","5","5","2"
"4","2017","30","Otros","4","39","21","22","1","1","22","23","2.2222222222222"
"4","2017","30","Otros","10","18","17","48","15","32","32","80","10.25"
"4","2017","30","Otros","6","27","42","58","3","4","45","62","3.960088691796"
"4","2017","30","Hotel","4","39","62","167","0","0","62","167","2.6"
"4","2017","30","Otros","14","31","21","33","106","212","127","245","20.2"
"4","2017","30","Hotel","2","29","40","123","170","344","210","467","2"
"4","2017","30","Hotel","9","26","189","281","4","10","193","291","1.5"
"4","2017","30","Otros","12","35","6","6","2","8","8","14","3.5"
"4","2017","30","Hotel","14","27","81","115","49","65","130","180","8.5"
"4","2017","30","Otros","11","36","135","333","21","34","156","367","5.1904761904762"
"4","2017","30","Otros","16","20","168","437","10","24","178","461","3.0769230769231"
"4","2017","30","Otros","4","39","3","8","0","0","3","8","2.2222222222222"
"4","2017","30","Otros","7","27","191","273","3","3","194","276","4.8333333333333"
"4","2017","30","Otros","6","27","128","187","2","2","130","189","3.960088691796"
"4","2017","30","Otros","5","8","15","450","0","0","15","450","5"
"4","2017","30","Otros","9","37","101","135","8","8","109","143","4.5"
"4","2017","30","Hotel","2","6","51","171","0","0","51","171","5.5"
"4","2017","30","Hotel","10","27","45","57","76","78","121","135","2.25"
"4","2017","30","Hotel","9","30","118","206","12","21","130","227","1"
"4","2017","30","Otros","4","13","20","67","8","10","28","77","3.4"
"4","2017","30","Hotel","5","5","215","215","31","31","246","246","1"
"4","2017","30","Otros","7","38","102","162","2","4","104","166","2.75"
"4","2017","30","Hotel","13","14","27","37","6","20","33","57","1"
"4","2017","30","Otros","5","9","20","36","10","15","30","51","4.0454545454545"
"4","2017","30","Otros","5","8","9","11","0","0","9","11","5"
"4","2017","30","Otros","10","27","60","85","33","37","93","122","4.84"
"4","2017","30","Hotel","13","14","23","47","7","17","30","64","1"
"4","2017","30","Otros","11","15","3","3","0","0","3","3","2.3571428571429"
"4","2017","30","Hotel","9","22","103","161","0","0","103","161","2.5555555555556"
"4","2017","30","Otros","11","36","37","80","5","6","42","86","5.1904761904762"
"4","2017","30","Hotel","10","18","2015","3415","1488","2871","3503","6286","1"
"4","2017","30","Hotel","6","12","193","355","0","0","193","355","5"
"4","2017","30","","2","29","395","1120","420","960","815","2080","1"
"4","2017","30","Hotel","16","27","1171","2345","11","28","1182","2373","1"
"4","2017","30","","14","31","264","592","489","2055","753","2647","1"
"4","2017","30","Hotel","8","3","17","255","14","98","31","353","4.1111111111111"
"4","2017","30","Otros","13","33","69","155","45","70","114","225","5.125"
"4","2017","30","","14","27","44","56","0","0","44","56","2.6666666666667"
"4","2017","30","Otros","9","22","11","16","0","0","11","16","7.6428571428571"
"4","2017","30","Hotel","10","11","30","54","0","0","30","54","5.6666666666667"
"4","2017","30","Otros","6","12","14","68","0","0","14","68","1.8256578947368"
"4","2017","19","Hotel","8","3","64","107","23","27","87","134","4.1111111111111"
"4","2017","30","Otros","6","12","169","250","0","0","169","250","1.8256578947368"
"4","2017","30","Hotel","8","27","22","91","1","1","23","92","4.5"
"4","2017","30","Hotel","6","28","150","174","16","22","166","196","2.4"
"4","2017","30","Otros","6","25","37","181","0","0","37","181","2.3846153846154"
"4","2017","30","Otros","6","25","21","28","0","0","21","28","2.3846153846154"
"4","2017","30","Hotel","11","36","390","580","0","0","390","580","1"
"4","2017","30","Otros","2","6","25","78","223","609","248","687","5"
"4","2017","30","Hotel","14","31","43","82","125","380","168","462","24"
"4","2017","17","Otros","4","21","24","49","2","2","26","51","4.8333333333333"
"4","2017","30","Otros","7","38","22","28","0","0","22","28","2.75"
"4","2017","30","Otros","13","14","125","150","0","0","125","150","7.3846153846154"
"4","2017","30","Otros","2","29","30","80","22","61","52","141","3.28"
"4","2017","30","Otros","3","4","90","90","44","44","134","134","12.2"
"4","2017","30","Hotel","3","4","419","876","22","31","441","907","3"
"4","2017","30","Otros","7","27","150","186","6","6","156","192","1"
"4","2017","30","Otros","7","17","58","58","3","6","61","64","3"
"4","2017","30","Hotel","12","27","232","376","0","0","232","376","1"
"4","2017","30","Otros","5","5","33","33","2","2","35","35","3.65625"
"4","2017","30","Hotel","6","10","210","250","6","8","216","258","6.6"
"4","2017","30","Otros","10","18","6","8","15","54","21","62","10.25"
"4","2017","30","Otros","8","27","63","109","0","0","63","109","9.4"
"4","2017","30","Otros","8","3","96","274","38","212","134","486","10"
"4","2017","30","Hotel","16","27","13","80","0","0","13","80","5.8571428571429"
"4","2017","30","Otros","6","10","84","180","0","0","84","180","3.8518518518518"
"4","2017","30","Hotel","2","6","36","53","4","6","40","59","5.5"
"4","2017","30","Hotel","8","3","8","10","0","0","8","10","4.1111111111111"
"4","2017","30","Otros","10","11","20","30","34","41","54","71","11.764705882353"
"4","2017","30","Otros","6","27","14","113","0","0","14","113","3.960088691796"
"4","2017","30","Otros","15","16","3","10","0","0","3","10","9"
"4","2017","30","Otros","5","5","38","64","7","15","45","79","3.65625"
"4","2017","30","Otros","10","27","62","138","42","48","104","186","4.84"
"4","2017","30","Hotel","7","38","58","78","16","16","74","94","1"
"4","2017","30","Hotel","13","27","9","9","0","0","9","9","4.2"
"4","2017","30","Hotel","16","20","62","94","0","0","62","94","1"
"4","2017","30","Otros","10","27","18","20","0","0","18","20","4.84"
"4","2017","30","Hotel","3","7","78","122","5","7","83","129","1"
"4","2017","30","Otros","2","29","138","184","5","5","143","189","3.28"
"4","2017","30","Otros","10","18","17","30","0","0","17","30","10.25"
"4","2017","30","Otros","9","22","136","291","0","0","136","291","7.6428571428571"
"4","2017","30","Otros","15","27","63","78","0","0","63","78","1.4222222222222"
"4","2017","30","Otros","11","36","2","4","0","0","2","4","5.1904761904762"
"4","2017","30","Otros","5","5","7","9","0","0","7","9","3.65625"
"4","2017","30","Otros","2","29","21","63","46","124","67","187","3.28"
"4","2017","30","Hotel","9","22","153","153","38","38","191","191","2.5555555555556"
"4","2017","30","Otros","11","32","7","9","0","0","7","9","2.2857142857143"
"4","2017","30","Hotel","10","27","212","358","168","267","380","625","1"
"4","2017","30","Otros","16","27","92","151","0","0","92","151","2"
"4","2017","30","Hotel","16","20","42","67","0","0","42","67","1"
"4","2017","30","Otros","11","15","17","40","0","0","17","40","2.3571428571429"
"4","2017","30","Otros","7","17","69","277","4","27","73","304","3"
"4","2017","30","Otros","5","8","13","13","7","7","20","20","5"
"4","2017","29","Hotel","13","33","62","93","8","10","70","103","2"
"4","2017","30","Otros","5","9","70","116","68","100","138","216","4.0454545454545"
"4","2017","30","Otros","10","27","88","134","77","116","165","250","4.84"
"4","2017","30","Otros","9","22","29","62","0","0","29","62","7.6428571428571"
"4","2017","30","Otros","16","40","25","50","0","0","25","50","28.142857142857"
"4","2017","30","Hotel","16","40","70","81","14","15","84","96","1"
"4","2017","30","Otros","15","16","8","22","6","8","14","30","9"
"4","2017","30","Hotel","8","2","9","9","21","27","30","36","3"
"4","2017","30","Otros","8","3","14","43","0","0","14","43","10"
"4","2017","30","Otros","7","17","27","68","0","0","27","68","17.166666666667"
"4","2017","30","Otros","16","20","64","80","0","0","64","80","3.0769230769231"
"4","2017","30","Otros","6","27","28","49","0","0","28","49","3.960088691796"
"4","2017","30","Otros","12","35","49","67","92","133","141","200","3.5"
"4","2017","30","Otros","6","28","91","333","29","58","120","391","4.65"
"4","2017","30","Otros","6","28","248","714","34","50","282","764","4.65"
"4","2017","30","Hotel","8","34","78","148","123","176","201","324","2.5714285714286"
"4","2017","30","Hotel","16","20","1380","2496","0","0","1380","2496","1"
"4","2017","30","Hotel","2","6","380","773","0","0","380","773","2.2"
"4","2017","30","Hotel","7","27","29","29","0","0","29","29","4.1666666666667"
"4","2017","30","Hotel","10","23","25","28","8","13","33","41","4"
"4","2017","30","Hotel","9","26","43","49","3","4","46","53","1.5"
"4","2017","30","Otros","8","27","29","49","0","0","29","49","9.4"
"4","2017","30","Otros","10","27","26","34","12","13","38","47","4.84"
"4","2017","30","Otros","11","15","15","17","1","1","16","18","2.3571428571429"
"4","2017","30","Otros","16","20","6","7","0","0","6","7","3.0769230769231"
"4","2017","30","Otros","11","32","57","119","0","0","57","119","1"
"4","2017","30","Otros","16","27","54","54","3","3","57","57","13.818181818182"
"4","2017","30","Otros","9","37","100","104","0","0","100","104","4.5"
"4","2017","30","Hotel","2","29","17","34","14","34","31","68","2"
"4","2017","30","Hotel","2","1","130","202","0","0","130","202","6.4"
"4","2017","30","Otros","5","8","8","11","2","2","10","13","5"
"4","2017","30","Otros","9","37","44","60","29","46","73","106","4.5"
"4","2017","30","Otros","7","38","180","361","2","4","182","365","2.75"
"4","2017","30","Otros","11","32","119","294","4","20","123","314","1"
"4","2017","30","Otros","4","39","27","44","6","6","33","50","2.2222222222222"
"4","2017","30","Hotel","11","36","54","158","11","43","65","201","2.375"
"4","2017","30","Otros","10","23","23","35","0","0","23","35","7"
"4","2017","30","Hotel","15","16","583","1202","232","766","815","1968","2"
"4","2017","30","Otros","2","29","33","42","170","409","203","451","3.28"
"4","2017","30","Hotel","6","12","527","791","36","59","563","850","1"
"4","2017","30","Hotel","11","15","282","628","0","0","282","628","1"
"4","2017","30","Otros","4","21","189","427","13","17","202","444","1"
"4","2017","30","Otros","16","19","67","170","0","0","67","170","10.263157894737"
"4","2017","30","","9","37","348","414","3","3","351","417","1"
"4","2017","30","Otros","10","27","79","115","81","91","160","206","4.84"
"4","2017","30","Otros","11","15","96","96","2","2","98","98","2.3571428571429"
"4","2017","30","Hotel","2","29","48","142","80","226","128","368","2"
"4","2017","30","Hotel","10","27","105","127","120","238","225","365","1"
"4","2017","30","Hotel","11","36","141","591","14","28","155","619","2.375"
"4","2017","30","Hotel","9","37","130","205","18","66","148","271","3.4"
"4","2017","30","Otros","14","27","6","52","6","12","12","64","11.833333333333"
"4","2017","30","Otros","7","38","66","101","0","0","66","101","1"
"4","2017","30","Hotel","2","1","24","89","0","0","24","89","6.4"
"4","2017","30","Otros","2","29","8","27","70","265","78","292","3.28"
"4","2017","30","Hotel","6","27","4","30","0","0","4","30","3"
"4","2017","30","Otros","5","9","11","139","0","0","11","139","4.0454545454545"
"4","2017","30","Hotel","2","1","132","182","0","0","132","182","6.4"
"4","2017","30","Hotel","3","7","15","55","34","58","49","113","1"
"4","2017","30","Otros","7","38","85","85","158","158","243","243","2.75"
"4","2017","30","Otros","7","17","19","49","1","3","20","52","17.166666666667"
"4","2017","30","Otros","7","38","23","33","8","24","31","57","2.75"
"4","2017","30","Otros","4","21","20","24","0","0","20","24","4.8333333333333"
"4","2017","30","Otros","2","1","30","36","5","5","35","41","5.5"
"4","2017","30","Otros","12","35","14","18","33","36","47","54","3.5"
"4","2017","30","Otros","12","35","5","6","15","21","20","27","3.5"
"4","2017","30","Otros","4","21","62","84","14","14","76","98","4.8333333333333"
"4","2017","30","Otros","12","24","16","43","14","22","30","65","9.2"
"4","2017","30","Otros","16","19","2","2","0","0","2","2","10.263157894737"
"4","2017","30","Otros","10","11","41","160","5","5","46","165","11.764705882353"
"4","2017","30","Otros","16","19","40","97","0","0","40","97","10.263157894737"
"4","2017","30","Hotel","2","27","36","36","5","5","41","41","1"
"4","2017","30","Otros","6","28","4","5","0","0","4","5","4.65"
"4","2017","30","Otros","10","18","192","274","64","134","256","408","10.25"
"4","2017","30","Otros","14","27","18","45","0","0","18","45","11.833333333333"
"4","2017","30","Hotel","11","32","9","21","4","4","13","25","1"
"4","2017","30","Otros","8","27","23","65","0","0","23","65","9.4"
"4","2017","30","Hotel","12","35","61","118","48","87","109","205","1.7272727272727"
"4","2017","30","Otros","13","14","18","38","0","0","18","38","7.3846153846154"
"4","2017","30","Otros","11","36","30","93","0","0","30","93","5.1904761904762"
"4","2017","30","Otros","16","20","10","11","0","0","10","11","3.0769230769231"
"4","2017","30","Hotel","14","31","175","277","843","2465","1018","2742","7.8"
"4","2017","30","Otros","2","27","191","315","11","40","202","355","3.2"
"4","2017","30","","16","40","236","571","0","0","236","571","3.0555555555556"
"4","2017","30","Hotel","11","36","67","122","24","52","91","174","2.375"
"4","2017","30","Hotel","9","22","18","18","0","0","18","18","2.5555555555556"
"4","2017","30","Otros","2","29","15","37","34","90","49","127","3.28"
"4","2017","30","Hotel","10","27","9","11","81","102","90","113","2.25"
"4","2017","30","Otros","10","27","16","56","0","0","16","56","4.84"
"4","2017","30","Hotel","16","19","8","16","0","0","8","16","4"
"4","2017","30","Otros","2","6","7","11","1","30","8","41","5"
"4","2017","30","Otros","7","27","111","153","0","0","111","153","4.8333333333333"
"4","2017","30","Hotel","2","6","119","895","0","0","119","895","5.5"
"4","2017","30","Hotel","6","28","2","2","6","6","8","8","2.4"
"4","2017","30","Otros","6","10","102","391","0","0","102","391","3.8518518518518"
"4","2017","30","Hotel","6","27","2","2","0","0","2","2","3"
"4","2017","30","Otros","5","5","23","32","2","3","25","35","3.65625"
"4","2017","30","Otros","12","24","43","105","47","63","90","168","9.2"
"4","2017","30","Hotel","8","2","89","166","17","21","106","187","3"
"4","2017","30","Hotel","11","32","15","44","1","1","16","45","1"
"4","2017","30","Otros","10","18","13","33","24","50","37","83","10.25"
"4","2017","30","Hotel","9","37","42","56","13","14","55","70","3.4"
"4","2017","30","Otros","5","9","72","95","40","85","112","180","4.0454545454545"
"4","2017","30","Otros","12","24","8","24","15","22","23","46","9.2"
"4","2017","30","Otros","9","22","8","15","0","0","8","15","7.6428571428571"
"4","2017","30","Otros","2","29","7","19","29","104","36","123","3.28"
"4","2017","30","Otros","10","23","16","44","0","0","16","44","7"
"4","2017","30","Otros","10","27","34","80","0","0","34","80","4.84"
"4","2017","30","Otros","10","11","62","157","0","0","62","157","11.764705882353"
"4","2017","30","Otros","8","3","42","108","1","1","43","109","10"
"4","2017","30","Otros","14","31","98","171","383","626","481","797","20.2"
"4","2017","30","Otros","2","29","228","496","202","554","430","1050","3.28"
"4","2017","0","Otros","6","25","0","0","0","0","0","0","1"
"4","2017","30","Hotel","15","16","13","31","0","0","13","31","7.8"
"4","2017","30","Hotel","15","27","90","159","18","72","108","231","1"
"4","2017","30","Otros","10","27","1","30","0","0","1","30","4.84"
"4","2017","30","Otros","10","23","88","88","0","0","88","88","7"
"4","2017","30","Otros","6","27","22","138","0","0","22","138","3.960088691796"
"4","2017","30","Otros","16","40","88","139","23","36","111","175","28.142857142857"
"4","2017","30","Otros","11","36","99","175","9","17","108","192","5.1904761904762"
"4","2017","30","Otros","8","34","66","107","61","96","127","203","5.75"
"4","2017","30","Otros","6","12","52","130","1","2","53","132","1.8256578947368"
"4","2017","30","Otros","6","10","111","159","8","8","119","167","3.8518518518518"
"4","2017","30","Hotel","4","21","131","318","24","39","155","357","3"
"4","2017","30","Hotel","11","36","72","240","51","98","123","338","2.375"
"4","2017","30","Otros","5","8","115","157","72","92","187","249","5"
"4","2017","30","Hotel","7","17","82","170","0","0","82","170","10"
"4","2017","24","Hotel","11","36","253","299","6","6","259","305","1"
"4","2017","30","Otros","9","30","13","17","2","2","15","19","2.3333333333333"
"4","2017","30","Hotel","12","35","67","151","58","114","125","265","1.7272727272727"
"4","2017","30","Otros","2","1","87","166","30","61","117","227","5.5"
"4","2017","30","Hotel","6","25","40","52","0","0","40","52","1"
"4","2017","30","Otros","5","5","5","115","0","0","5","115","3.65625"
"4","2017","30","Otros","2","29","29","71","95","296","124","367","3.28"
"4","2017","30","Hotel","2","6","18","48","3","3","21","51","5.5"
"4","2017","30","Otros","7","17","11","46","2","2","13","48","17.166666666667"
"4","2017","30","Hotel","8","2","21","28","13","13","34","41","3"
"4","2017","16","Hotel","13","14","36","36","0","0","36","36","1"
"4","2017","30","Otros","7","38","60","116","20","46","80","162","2.75"
"4","2017","30","Hotel","14","31","14","16","64","245","78","261","24"
"4","2017","30","Hotel","5","5","16","29","18","23","34","52","2.1428571428571"
"4","2017","30","Otros","2","27","1","1","0","0","1","1","3.2"
"4","2017","30","Otros","5","8","28","48","15","28","43","76","5"
"4","2017","30","Otros","3","4","31","81","12","13","43","94","12.2"
"4","2017","30","Otros","13","14","4","4","0","0","4","4","7.3846153846154"
"4","2017","30","Otros","9","37","32","53","1","12","33","65","4.5"
"4","2017","30","Hotel","10","23","480","692","54","82","534","774","1"
"4","2017","30","Otros","11","32","27","27","3","3","30","30","2.2857142857143"
"4","2017","30","Otros","11","15","1","4","0","0","1","4","2.3571428571429"
"4","2017","30","Otros","8","3","91","975","0","0","91","975","10"
"4","2017","30","Otros","16","20","51","131","0","0","51","131","3.0769230769231"
"4","2017","30","Otros","8","3","9","21","0","0","9","21","10"
"4","2017","30","Otros","16","27","30","30","0","0","30","30","2"
"4","2017","30","Hotel","16","19","22","38","0","0","22","38","4"
"4","2017","30","Hotel","16","27","30","72","3","3","33","75","5.8571428571429"
"4","2017","30","Otros","9","26","12","26","5","5","17","31","3.8888888888889"
"4","2017","30","Otros","5","5","8","22","0","0","8","22","3.65625"
"4","2017","30","Otros","14","27","8","8","0","0","8","8","11.833333333333"
"4","2017","30","Hotel","5","5","27","92","6","28","33","120","2.1428571428571"
"4","2017","30","Hotel","12","24","92","205","142","264","234","469","3"
"4","2017","30","Otros","16","27","34","97","0","0","34","97","13.818181818182"
"4","2017","30","Otros","8","3","23","72","10","20","33","92","1"
"4","2017","30","Otros","13","27","130","247","0","0","130","247","12.2"
"4","2017","30","Hotel","16","40","43","63","17","34","60","97","16.333333333333"
"4","2017","30","Otros","11","36","26","51","0","0","26","51","1"
"4","2017","30","Otros","10","27","23","29","22","24","45","53","4.84"
"4","2017","30","Otros","9","22","38","81","0","0","38","81","7.6428571428571"
"4","2017","30","Hotel","5","5","12","22","18","38","30","60","2.1428571428571"
"4","2017","30","Otros","2","29","114","314","81","275","195","589","3.28"
"4","2017","25","Otros","2","29","4","4","2","2","6","6","3.28"
"4","2017","30","Hotel","13","14","9","9","0","0","9","9","1"
"4","2017","30","Otros","6","25","4","4","0","0","4","4","2.3846153846154"
"4","2017","30","Otros","2","1","16","23","0","0","16","23","5.5"
"4","2017","30","Hotel","12","27","61","66","31","37","92","103","1"
"4","2017","30","Hotel","13","27","34","34","0","0","34","34","4.2"
"4","2017","30","Otros","6","12","106","310","0","0","106","310","1.8256578947368"
"4","2017","30","Otros","6","27","9","12","0","0","9","12","3.960088691796"
"4","2017","30","Otros","6","25","6","6","0","0","6","6","2.3846153846154"
"4","2017","30","Hotel","6","28","19","55","0","0","19","55","2.5833333333333"
"4","2017","30","Otros","5","5","3","3","0","0","3","3","3.65625"
"4","2017","30","Otros","5","9","7","12","0","0","7","12","4.0454545454545"
"4","2017","30","Otros","5","8","3","3","2","6","5","9","5"
"4","2017","30","Hotel","2","29","121","377","51","134","172","511","1"
"4","2017","30","Otros","5","5","60","103","44","92","104","195","3.65625"
"4","2017","30","Hotel","9","26","43","71","0","0","43","71","1.5"
"4","2017","30","Otros","9","30","8","37","0","0","8","37","2.3333333333333"
"4","2017","30","Otros","11","15","7","7","0","0","7","7","2.3571428571429"
"4","2017","30","Hotel","16","27","3","12","2","2","5","14","5.8571428571429"
"4","2017","30","Otros","9","30","27","31","0","0","27","31","2.3333333333333"
"4","2017","30","Otros","2","29","12","31","18","36","30","67","3.28"
"4","2017","30","Otros","7","38","33","69","40","61","73","130","2.75"
"4","2017","30","Otros","4","21","55","180","15","46","70","226","4.8333333333333"
"4","2017","30","Otros","9","22","21","35","0","0","21","35","7.6428571428571"
"4","2017","30","Otros","9","22","48","81","0","0","48","81","7.6428571428571"
"4","2017","30","Otros","13","27","6","12","0","0","6","12","12.2"
"4","2017","30","Hotel","11","36","1491","1546","27","199","1518","1745","1"
"4","2017","30","Otros","13","33","13","33","4","10","17","43","5.125"
"4","2017","30","Otros","11","36","177","374","94","210","271","584","5.1904761904762"
"4","2017","30","Otros","12","35","44","74","124","211","168","285","3.5"
"4","2017","30","Otros","12","35","5","21","4","6","9","27","3.5"
"4","2017","30","Otros","10","11","25","37","4","8","29","45","11.764705882353"
"4","2017","30","Otros","12","24","9","9","22","44","31","53","9.2"
"4","2017","30","Otros","16","20","19","81","0","0","19","81","3.0769230769231"
"4","2017","20","Hotel","7","27","106","109","9","9","115","118","1"
"4","2017","30","Otros","6","12","16","16","1","2","17","18","1.8256578947368"
"4","2017","30","Otros","11","32","64","146","3","7","67","153","2.2857142857143"
"4","2017","30","Otros","6","28","23","23","0","0","23","23","4.65"
"4","2017","30","Otros","8","34","1","1","0","0","1","1","5.75"
"4","2017","30","Otros","16","27","63","134","0","0","63","134","13.818181818182"
"4","2017","30","Otros","10","11","17","17","0","0","17","17","11.764705882353"
"4","2017","30","Otros","6","10","50","110","0","0","50","110","3.8518518518518"
"4","2017","30","Otros","8","3","8","8","0","0","8","8","10"
"4","2017","30","Hotel","16","20","80","126","46","94","126","220","1"
"4","2017","30","Hotel","11","32","96","186","14","30","110","216","1"
"4","2017","30","Otros","8","27","22","24","6","8","28","32","9.4"
"4","2017","30","Otros","12","27","29","38","4","4","33","42","3.4285714285714"
"4","2017","30","Otros","6","10","42","92","0","0","42","92","3.8518518518518"
"4","2017","30","Otros","6","10","43","83","0","0","43","83","3.8518518518518"
"4","2017","30","Otros","5","8","5","12","8","19","13","31","5"
"4","2017","30","Otros","5","8","33","33","27","27","60","60","5"
"4","2017","30","Hotel","9","26","31","67","8","22","39","89","1.5"
"4","2017","30","Hotel","13","14","16","16","1","3","17","19","1"
"4","2017","29","Otros","10","18","89","168","49","136","138","304","10.25"
"4","2017","30","Otros","8","2","37","40","45","45","82","85","6.4285714285714"
"4","2017","30","Otros","7","27","16","17","0","0","16","17","4.8333333333333"
"4","2017","30","Otros","2","29","3","4","0","0","3","4","3.28"
"4","2017","30","Otros","11","32","1","1","0","0","1","1","2.2857142857143"
"4","2017","30","Otros","9","30","5","14","0","0","5","14","2.3333333333333"
"4","2017","30","Otros","2","29","3","9","11","28","14","37","3.28"
"4","2017","30","Otros","5","5","7","65","2","2","9","67","3.65625"
"4","2017","30","Otros","11","15","19","21","0","0","19","21","2.3571428571429"
"4","2017","30","Otros","10","23","7","14","0","0","7","14","7"
"4","2017","30","Otros","11","36","92","184","20","43","112","227","5.1904761904762"
"4","2017","30","Hotel","3","7","39","56","39","61","78","117","1"
"4","2017","30","Otros","10","27","2","2","1","1","3","3","4.84"
"4","2017","30","Otros","2","27","10","22","0","0","10","22","3.2"
"4","2017","30","Otros","12","35","27","38","54","93","81","131","3.5"
"4","2017","30","Otros","10","27","13","22","8","8","21","30","4.84"
"4","2017","30","Otros","16","40","27","50","146","355","173","405","28.142857142857"
"4","2017","30","Hotel","8","3","265","510","96","157","361","667","4.1111111111111"
"4","2017","30","Otros","9","22","32","75","0","0","32","75","7.6428571428571"
"4","2017","30","Otros","13","14","19","44","0","0","19","44","7.3846153846154"
"4","2017","30","Otros","5","9","2","3","0","0","2","3","4.0454545454545"
"4","2017","30","Otros","10","18","23","36","39","72","62","108","10.25"
"4","2017","30","Otros","6","25","75","139","8","44","83","183","2.3846153846154"
"4","2017","30","Otros","9","22","50","120","0","0","50","120","7.6428571428571"
"4","2017","30","Otros","10","27","27","42","5","5","32","47","4.84"
"4","2017","30","Otros","16","20","34","49","4","12","38","61","3.0769230769231"
"4","2017","30","Hotel","7","17","89","211","0","0","89","211","10"
"4","2017","30","Otros","15","27","53","86","0","0","53","86","1.4222222222222"
"4","2017","30","Otros","12","35","7","10","9","10","16","20","3.5"
"4","2017","30","Otros","12","35","9","17","117","173","126","190","3.5"
"4","2017","30","Otros","3","7","5","5","0","0","5","5","2"
"4","2017","30","Otros","10","11","1","1","1","1","2","2","11.764705882353"
"4","2017","30","Otros","12","24","10","10","0","0","10","10","9.2"
"4","2017","30","Otros","10","23","9","9","0","0","9","9","7"
"4","2017","30","Otros","7","27","13","13","4","4","17","17","4.8333333333333"
"4","2017","30","","10","18","5","9","0","0","5","9","1"
"4","2017","30","Otros","16","27","2","3","6","6","8","9","13.818181818182"
"4","2017","30","Hotel","2","29","8","24","10","30","18","54","1"
"4","2017","30","Otros","14","27","7","8","4","5","11","13","11.833333333333"
"4","2017","30","Otros","11","32","54","75","0","0","54","75","2.2857142857143"
"4","2017","30","Otros","16","19","42","105","38","142","80","247","1"
"4","2017","30","Otros","16","27","39","57","0","0","39","57","13.818181818182"
"4","2017","30","Otros","8","3","20","53","16","73","36","126","10"
"4","2017","30","Otros","16","27","20","28","0","0","20","28","13.818181818182"
"4","2017","30","Otros","16","20","55","142","4","8","59","150","3.0769230769231"
"4","2017","30","Otros","16","40","86","155","21","31","107","186","28.142857142857"
"4","2017","30","Hotel","11","36","68","85","18","26","86","111","2.375"
"4","2017","30","Otros","6","10","70","100","0","0","70","100","3.8518518518518"
"4","2017","30","Otros","7","38","109","279","27","69","136","348","2.75"
"4","2017","30","Otros","13","14","19","43","0","0","19","43","7.3846153846154"
"4","2017","30","Otros","9","30","18","32","0","0","18","32","2.3333333333333"
"4","2017","30","Otros","13","27","78","350","0","0","78","350","12.2"
"4","2017","30","Otros","10","27","50","50","27","27","77","77","4.84"
"4","2017","30","Otros","6","25","11","15","15","23","26","38","2.3846153846154"
"4","2017","30","Otros","9","26","22","411","50","100","72","511","3.8888888888889"
"4","2017","30","Otros","10","18","10","22","15","60","25","82","10.25"
"4","2017","30","Otros","2","29","15","57","0","0","15","57","3.28"
"4","2017","30","Otros","6","25","4","4","0","0","4","4","2.3846153846154"
"4","2017","30","Otros","5","9","15","26","13","21","28","47","4.0454545454545"
"4","2017","30","Otros","5","9","4","80","0","0","4","80","4.0454545454545"
"4","2017","30","Hotel","9","37","41","99","10","55","51","154","3.4"
"4","2017","30","Hotel","7","38","112","192","6","8","118","200","1"
"4","2017","30","Otros","7","27","101","118","0","0","101","118","4.8333333333333"
"4","2017","30","Otros","5","9","3","3","0","0","3","3","4.0454545454545"
"4","2017","30","Otros","10","27","2","2","1","1","3","3","4.84"
"4","2017","30","Otros","7","27","20","41","0","0","20","41","4.8333333333333"
"4","2017","30","Otros","16","40","20","41","32","80","52","121","28.142857142857"
"4","2017","30","Otros","10","23","12","12","1","1","13","13","7"
"4","2017","30","Otros","15","16","60","138","10","29","70","167","9"
"4","2017","30","Otros","3","7","12","12","64","144","76","156","2"
"4","2017","30","Otros","7","17","69","119","2","4","71","123","17.166666666667"
"4","2017","30","Otros","8","27","35","51","5","5","40","56","9.4"
"4","2017","30","Otros","9","22","24","104","0","0","24","104","7.6428571428571"
"4","2017","30","Otros","16","19","25","60","0","0","25","60","10.263157894737"
"4","2017","30","","15","27","56","96","0","0","56","96","1"
"4","2017","30","Hotel","10","11","19","29","9","9","28","38","5.6666666666667"
"4","2017","30","Otros","2","27","5","10","0","0","5","10","3.2"
"4","2017","30","Otros","8","2","26","50","34","41","60","91","6.4285714285714"
"4","2017","30","Otros","5","5","2","3","0","0","2","3","3.65625"
"4","2017","30","Otros","12","35","6","9","7","12","13","21","3.5"
"4","2017","30","Otros","8","3","14","59","8","22","22","81","10"
"4","2017","30","Otros","12","24","9","18","23","72","32","90","9.2"
"4","2017","30","Otros","11","32","34","104","0","0","34","104","2.2857142857143"
"4","2017","30","Otros","10","27","36","65","65","97","101","162","4.84"
"4","2017","30","Otros","11","15","13","27","0","0","13","27","2.3571428571429"
"4","2017","30","Otros","5","8","7","7","5","8","12","15","5"
"4","2017","30","Otros","14","27","16","16","2","2","18","18","11.833333333333"
"4","2017","30","Otros","13","27","147","214","0","0","147","214","12.2"
"4","2017","30","Hotel","10","18","32","32","97","97","129","129","3.2"
"4","2017","30","Otros","10","27","23","37","19","19","42","56","4.84"
"4","2017","30","Otros","11","32","10","12","0","0","10","12","1"
"4","2017","30","Otros","9","37","35","190","0","0","35","190","4.5"
"4","2017","30","Otros","12","35","18","24","146","230","164","254","3.5"
"4","2017","30","Otros","8","34","86","158","77","123","163","281","5.75"
"4","2017","30","Hotel","16","40","19","19","71","113","90","132","16.333333333333"
"4","2017","30","Hotel","10","11","10","126","28","69","38","195","5.6666666666667"
"4","2017","30","Otros","7","27","27","65","0","0","27","65","4.8333333333333"
"4","2017","30","Hotel","7","38","11","11","0","0","11","11","1"
"4","2017","30","Otros","6","27","2","3","0","0","2","3","3.960088691796"
"4","2017","30","Otros","6","10","39","90","0","0","39","90","3.8518518518518"
"4","2017","15","Otros","6","25","61","114","0","0","61","114","1"
"4","2017","30","Otros","6","25","17","24","0","0","17","24","2.3846153846154"
"4","2017","30","Otros","6","27","36","110","0","0","36","110","3.960088691796"
"4","2017","30","Otros","6","27","79","186","0","0","79","186","3.960088691796"
"4","2017","30","Otros","5","5","23","49","7","17","30","66","3.65625"
"4","2017","30","Otros","5","5","6","8","0","0","6","8","3.65625"
"4","2017","30","Otros","3","4","11","19","2","8","13","27","12.2"
"4","2017","30","Otros","10","23","8","28","0","0","8","28","7"
"4","2017","30","Otros","8","3","16","46","0","0","16","46","10"
"4","2017","30","Otros","5","5","16","67","3","6","19","73","3.65625"
"4","2017","30","Otros","5","8","8","14","5","10","13","24","5"
"4","2017","30","Otros","6","10","12","36","10","26","22","62","3.8518518518518"
"4","2017","30","Otros","16","19","9","19","0","0","9","19","10.263157894737"
"4","2017","30","Otros","11","15","50","59","15","45","65","104","2.3571428571429"
"4","2017","30","Otros","7","38","48","67","0","0","48","67","2.75"
"4","2017","30","Otros","11","32","147","241","41","50","188","291","2.2857142857143"
"4","2017","30","Otros","8","2","38","61","0","0","38","61","6.4285714285714"
"4","2017","30","Otros","10","27","18","27","14","17","32","44","4.84"
"4","2017","30","Otros","6","27","27","48","0","0","27","48","3.960088691796"
"4","2017","30","Otros","11","32","41","60","1","1","42","61","2.2857142857143"
"4","2017","30","Otros","8","34","28","43","36","57","64","100","5.75"
"4","2017","30","Otros","11","32","5","5","0","0","5","5","2.2857142857143"
"4","2017","30","Otros","10","11","12","21","0","0","12","21","11.764705882353"
"4","2017","30","Otros","11","32","6","6","9","9","15","15","2.2857142857143"
"4","2017","30","Otros","14","31","17","30","0","0","17","30","20.2"
"4","2017","30","Hotel","14","31","152","347","622","1585","774","1932","17.4"
"4","2017","30","Otros","11","36","142","198","25","42","167","240","5.1904761904762"
"4","2017","30","Hotel","15","16","1181","2153","241","442","1422","2595","2"
"4","2017","30","Otros","15","27","8","14","0","0","8","14","1.4222222222222"
"4","2017","30","Otros","5","5","6","11","2","3","8","14","3.65625"
"4","2017","30","Otros","8","34","3","4","11","12","14","16","5.75"
"4","2017","30","Otros","7","27","18","27","0","0","18","27","4.8333333333333"
"4","2017","30","Otros","12","35","6","7","10","12","16","19","3.5"
"4","2017","30","Otros","5","5","58","104","0","0","58","104","3.65625"
"4","2017","30","Otros","10","11","3","4","0","0","3","4","11.764705882353"
"4","2017","30","Otros","10","11","2","4","0","0","2","4","11.764705882353"
"4","2017","30","Otros","9","30","6","120","0","0","6","120","2.3333333333333"
"4","2017","30","Otros","8","2","19","30","1","1","20","31","6.4285714285714"
"4","2017","30","Otros","10","27","60","79","56","72","116","151","4.84"
"4","2017","30","Otros","5","9","17","23","1","1","18","24","4.0454545454545"
"4","2017","30","Otros","6","27","13","13","0","0","13","13","3.960088691796"
"4","2017","30","Otros","6","10","97","209","10","20","107","229","3.8518518518518"
"4","2017","30","Otros","6","10","63","107","0","0","63","107","3.8518518518518"
"4","2017","30","Otros","6","27","5","10","0","0","5","10","3.960088691796"
"4","2017","30","Otros","6","12","5","35","0","0","5","35","1.8256578947368"
"4","2017","30","Otros","6","10","66","128","0","0","66","128","3.8518518518518"
"4","2017","30","Otros","6","10","29","46","0","0","29","46","3.8518518518518"
"4","2017","30","Otros","6","27","21","23","0","0","21","23","3.960088691796"
"4","2017","30","Otros","6","12","42","58","0","0","42","58","1.8256578947368"
"4","2017","30","Otros","6","10","20","25","0","0","20","25","3.8518518518518"
"4","2017","30","Hotel","6","25","41","109","0","0","41","109","1"
"4","2017","8","Otros","6","27","4","4","0","0","4","4","3.960088691796"
"4","2017","30","Otros","5","9","17","34","20","28","37","62","4.0454545454545"
"4","2017","30","Otros","5","5","12","28","19","27","31","55","3.65625"
"4","2017","30","Otros","5","5","21","26","9","20","30","46","3.65625"
"4","2017","30","Otros","5","5","40","69","15","30","55","99","3.65625"
"4","2017","30","Otros","11","36","65","136","0","0","65","136","5.1904761904762"
"4","2017","30","Hotel","6","10","513","1884","22","45","535","1929","1"
"4","2017","30","Otros","5","9","12","18","1","1","13","19","4.0454545454545"
"4","2017","30","Otros","5","8","10","20","10","20","20","40","5"
"4","2017","0","Hotel","15","27","0","0","0","0","0","0","1"
"4","2017","30","Hotel","3","4","286","1605","18","78","304","1683","3"
"4","2017","30","Otros","3","7","25","25","29","197","54","222","1"
"4","2017","30","Otros","7","38","100","247","4","6","104","253","2.75"
"4","2017","30","Hotel","10","27","11","11","21","21","32","32","1"
"4","2017","30","Hotel","12","35","0","0","23","25","23","25","1.7272727272727"
"4","2017","30","Hotel","10","27","9","13","0","0","9","13","2.25"
"4","2017","30","Hotel","7","17","503","830","70","115","573","945","4"
"4","2017","30","Hotel","16","19","7","10","0","0","7","10","4"
"4","2017","30","Hotel","2","6","12","189","0","0","12","189","2.2"
"4","2017","30","Otros","5","5","53","155","7","37","60","192","3.65625"
"4","2017","30","Otros","12","24","30","57","48","105","78","162","9.2"
"4","2017","30","Otros","5","8","2","4","5","10","7","14","5"
"4","2017","30","Otros","4","13","152","181","15","15","167","196","1"
"4","2017","30","Otros","10","11","192","192","0","0","192","192","11.764705882353"
"4","2017","30","Otros","12","35","2","2","17","18","19","20","3.5"
"4","2017","30","Otros","10","23","60","63","6","6","66","69","7"
"4","2017","30","Otros","11","36","308","530","82","165","390","695","5.1904761904762"
"4","2017","30","Otros","12","35","24","31","29","42","53","73","3.5"
"4","2017","30","Otros","11","36","22","78","18","46","40","124","5.1904761904762"
"4","2017","30","Otros","8","2","87","219","13","29","100","248","6.4285714285714"
"4","2017","30","Otros","9","30","39","111","0","0","39","111","2.3333333333333"
"4","2017","30","Otros","11","36","53","97","25","144","78","241","5.1904761904762"
"4","2017","30","Otros","6","10","15","26","0","0","15","26","3.8518518518518"
"4","2017","30","Otros","10","18","36","78","0","0","36","78","10.25"
"4","2017","30","Otros","7","27","18","92","2","2","20","94","4.8333333333333"
"4","2017","30","Otros","16","20","9","18","0","0","9","18","1"
"4","2017","30","Otros","9","22","43","71","0","0","43","71","7.6428571428571"
"4","2017","30","Otros","5","5","189","266","5","20","194","286","3.65625"
"4","2017","30","Otros","12","35","15","18","33","36","48","54","3.5"
"4","2017","30","Otros","10","11","0","0","5","9","5","9","11.764705882353"
"4","2017","30","Otros","10","11","3","18","0","0","3","18","11.764705882353"
"4","2017","23","Otros","5","9","35","71","7","7","42","78","4.0454545454545"
"4","2017","30","Otros","5","5","4","120","0","0","4","120","3.65625"
"4","2017","30","Otros","12","35","1","1","4","6","5","7","3.5"
"4","2017","30","Otros","7","38","102","228","46","105","148","333","2.75"
"4","2017","30","Hotel","12","35","6","21","25","61","31","82","1.7272727272727"
"4","2017","30","Otros","13","14","62","92","0","0","62","92","1"
"4","2017","30","Otros","5","5","12","19","8","8","20","27","3.65625"
"4","2017","30","Hotel","9","26","10","17","0","0","10","17","1.5"
"4","2017","30","Hotel","16","19","37","55","0","0","37","55","1"
"4","2017","30","Otros","16","19","77","83","0","0","77","83","10.263157894737"
"4","2017","30","Otros","9","30","44","74","0","0","44","74","2.3333333333333"
"4","2017","30","Otros","16","19","7","7","0","0","7","7","10.263157894737"
"4","2017","30","Otros","16","19","86","203","0","0","86","203","10.263157894737"
"4","2017","30","Otros","9","26","16","115","0","0","16","115","3.8888888888889"
"4","2017","30","Otros","16","40","2","3","0","0","2","3","28.142857142857"
"4","2017","30","Hotel","16","27","17","31","0","0","17","31","5.8571428571429"
"4","2017","30","Otros","16","19","12","26","0","0","12","26","10.263157894737"
"4","2017","30","Otros","16","19","20","40","0","0","20","40","10.263157894737"
"4","2017","30","","9","30","181","286","11","35","192","321","1"
"4","2017","30","Otros","16","19","10","14","0","0","10","14","10.263157894737"
"4","2017","30","Otros","10","11","7","18","5","5","12","23","11.764705882353"
"4","2017","30","Otros","11","36","18","18","0","0","18","18","5.1904761904762"
"4","2017","30","Otros","16","19","5","8","0","0","5","8","10.263157894737"
"4","2017","30","Otros","16","19","130","224","0","0","130","224","1.3333333333333"
"4","2017","30","Otros","16","19","20","30","0","0","20","30","10.263157894737"
"4","2017","30","Otros","10","18","4","6","28","51","32","57","10.25"
"4","2017","30","Otros","16","19","12","24","0","0","12","24","10.263157894737"
"4","2017","30","Otros","16","19","10","21","0","0","10","21","1.3333333333333"
"4","2017","30","","9","26","188","1229","0","0","188","1229","1"
"4","2017","30","Otros","16","19","13","17","0","0","13","17","10.263157894737"
"4","2017","30","Otros","16","19","48","70","4","6","52","76","10.263157894737"
"4","2017","30","Hotel","8","2","495","942","58","129","553","1071","1"
"4","2017","30","Otros","6","10","25","25","0","0","25","25","3.8518518518518"
"4","2017","30","Otros","6","12","5","5","0","0","5","5","1.8256578947368"
"4","2017","30","Hotel","16","19","308","586","47","154","355","740","1"
"4","2017","30","Otros","3","7","22","22","50","50","72","72","2"
"4","2017","30","Hotel","2","6","884","2206","482","1001","1366","3207","1"
"4","2017","30","Hotel","3","4","283","616","51","122","334","738","2.6"
"4","2017","30","Hotel","16","40","2041","3241","781","1374","2822","4615","1"
"4","2017","30","Otros","16","27","59","81","0","0","59","81","13.818181818182"
"4","2017","27","Hotel","6","28","173","198","59","76","232","274","2.4"
"4","2017","30","Hotel","8","34","488","1016","283","501","771","1517","1"
"4","2017","30","Otros","9","30","2","40","0","0","2","40","2.3333333333333"
"4","2017","30","Hotel","10","18","98","98","139","139","237","237","1"
"4","2017","30","Hotel","9","30","148","298","1","2","149","300","1"
"4","2017","30","Hotel","15","27","7","7","2","2","9","9","1"
"4","2017","30","Hotel","9","22","67","155","0","0","67","155","2.5555555555556"
"4","2017","30","","11","15","1","1","0","0","1","1","1"
"4","2017","30","Otros","6","12","20","25","4","5","24","30","1.8256578947368"
"4","2017","30","Hotel","15","27","30","900","0","0","30","900","1"
"4","2017","30","Otros","15","27","29","32","0","0","29","32","1.4222222222222"
"4","2017","30","Otros","15","27","1","1","0","0","1","1","1.4222222222222"
"4","2017","30","Otros","2","1","14","14","10","10","24","24","1"
"4","2017","30","Otros","12","24","4","6","3","3","7","9","9.2"
"4","2017","30","Otros","5","5","10","19","7","12","17","31","3.65625"
"4","2017","30","Hotel","7","27","150","164","0","0","150","164","1"
"4","2017","30","Otros","16","20","92","152","2","10","94","162","3.0769230769231"
"4","2017","0","","10","11","0","0","0","0","0","0","1"
"4","2017","30","Hotel","16","40","20","20","21","42","41","62","16.333333333333"
"4","2017","30","Otros","12","35","3","4","2","2","5","6","3.5"
"4","2017","30","Hotel","6","27","28","28","0","0","28","28","3"
"4","2017","30","Otros","5","5","29","44","0","0","29","44","3.65625"
"4","2017","30","Hotel","6","27","26","26","0","0","26","26","3"
"4","2017","30","Otros","6","25","32","34","0","0","32","34","2.3846153846154"
"4","2017","30","Hotel","15","27","104","201","0","0","104","201","1"
"4","2017","30","Otros","5","9","17","29","11","15","28","44","4.0454545454545"
"4","2017","30","Hotel","15","27","30","60","0","0","30","60","1"
"4","2017","30","Hotel","5","9","0","0","0","0","0","0","1"
"4","2017","30","Hotel","8","34","53","94","99","144","152","238","2.5714285714286"
"4","2017","0","Hotel","15","27","0","0","0","0","0","0","1"
"4","2017","30","Hotel","6","27","186","340","0","0","186","340","3"
"4","2017","30","Otros","6","27","42","84","0","0","42","84","1"
"4","2017","30","Otros","12","27","14","14","81","81","95","95","3.4285714285714"
"4","2017","30","Hotel","2","27","306","756","40","173","346","929","1"
"4","2017","30","Hotel","2","6","112","939","0","0","112","939","1"
"4","2017","30","Otros","2","6","33","33","0","0","33","33","1"
"4","2017","30","Hotel","4","39","232","232","0","0","232","232","1"
"4","2017","30","Hotel","6","10","419","597","49","75","468","672","1"
"4","2017","30","Otros","5","8","25","39","8","17","33","56","5"
"4","2017","30","Hotel","13","33","751","940","114","210","865","1150","1"
"4","2017","30","Hotel","13","33","112","134","42","42","154","176","1"
"4","2017","30","Otros","11","32","219","570","4","6","223","576","2.2857142857143"
"4","2017","30","Hotel","9","26","909","1257","256","283","1165","1540","1"
"4","2017","30","Hotel","16","20","61","88","6","8","67","96","1"
"4","2017","30","Otros","16","20","3","3","1","1","4","4","3.0769230769231"
"4","2017","30","","16","40","858","1567","0","0","858","1567","1"
"4","2017","30","Hotel","15","16","1180","2269","181","483","1361","2752","1"
"4","2017","30","Hotel","5","9","7","16","17","34","24","50","1"
"4","2017","30","Otros","7","38","51","81","8","11","59","92","2.75"
"4","2017","30","Otros","2","6","224","1020","0","0","224","1020","1"
"4","2017","30","Otros","2","6","38","111","0","0","38","111","1"
"4","2017","30","Hotel","15","27","155","515","7","7","162","522","1"
"4","2017","30","Otros","7","38","50","80","0","0","50","80","2.75"
"4","2017","30","Otros","2","1","17","70","12","19","29","89","1"
"4","2017","30","Otros","8","3","40","68","3","4","43","72","10"
"4","2017","30","Otros","11","36","30","193","4","8","34","201","5.1904761904762"
"4","2017","30","Otros","16","20","14","18","0","0","14","18","3.0769230769231"
"4","2017","30","Otros","8","3","277","475","9","15","286","490","1"
"4","2017","30","Otros","4","39","45","60","0","0","45","60","2.2222222222222"
"4","2017","30","Otros","5","5","210","429","20","54","230","483","3.65625"
"4","2017","30","Otros","12","27","5","9","1","2","6","11","3.4285714285714"
"4","2017","30","Otros","7","27","78","263","0","0","78","263","1"
"4","2017","30","Hotel","2","6","12","12","46","70","58","82","1"
"4","2017","30","Hotel","14","27","189","536","110","148","299","684","1"
"4","2017","30","Hotel","16","19","303","549","260","859","563","1408","1"
"4","2017","30","","2","1","55","770","0","0","55","770","1"
"4","2017","30","Hotel","2","27","45","101","2","32","47","133","1"
"4","2017","30","Otros","16","20","94","143","4","12","98","155","1"
"4","2017","10","Otros","13","14","24","44","0","0","24","44","1"
"4","2017","30","Hotel","11","36","73","81","7","10","80","91","2.375"
"4","2017","30","Otros","13","14","4","120","0","0","4","120","7.3846153846154"
"4","2017","30","Otros","12","27","8","8","0","0","8","8","3.4285714285714"
"4","2017","30","Hotel","2","6","198","397","19","19","217","416","2.2"
"4","2017","30","Otros","2","6","895","3390","0","0","895","3390","1"
"4","2017","30","Otros","10","27","3","90","0","0","3","90","4.84"
"4","2017","30","Otros","12","27","5","6","2","2","7","8","3.4285714285714"
"4","2017","30","Otros","13","14","40","40","0","0","40","40","7.3846153846154"
"4","2017","30","Otros","6","12","121","226","36","75","157","301","1.8256578947368"
"4","2017","30","Otros","2","6","15","15","1","1","16","16","1"
"4","2017","30","Hotel","12","35","67","151","58","114","125","265","1.7272727272727"
"4","2017","30","Otros","5","5","9","20","5","15","14","35","3.65625"
"4","2017","30","Otros","9","30","0","0","4","120","4","120","2.3333333333333"
"4","2017","30","Hotel","8","2","37","43","15","21","52","64","1"
"4","2017","30","Otros","9","30","6","6","0","0","6","6","2.3333333333333"
"4","2017","30","Hotel","15","27","62","68","4","8","66","76","1"
"4","2017","30","Hotel","3","7","19","19","2","2","21","21","1"
"4","2017","25","Otros","6","12","409","588","0","0","409","588","1.8256578947368"
"4","2017","30","Otros","12","27","40","40","5","5","45","45","3.4285714285714"
"4","2017","30","Otros","2","6","14","48","1","30","15","78","5"
"4","2017","30","Otros","6","27","26","53","0","0","26","53","3.960088691796"
"4","2017","30","Hotel","10","11","115","189","13","32","128","221","1"
"4","2017","30","Otros","2","1","20","140","0","0","20","140","1"
"4","2017","30","Otros","11","36","5","5","1","1","6","6","5.1904761904762"
"4","2017","30","Hotel","11","32","0","0","0","0","0","0","1"
"4","2017","30","Otros","2","27","18","52","0","0","18","52","1"
"4","2017","30","Otros","12","27","2","2","2","2","4","4","3.4285714285714"
"4","2017","30","Hotel","8","2","40","58","0","0","40","58","3"
"4","2017","30","Hotel","16","20","24","24","0","0","24","24","1"
"4","2017","30","Otros","12","35","0","0","64","118","64","118","3.5"
"4","2017","30","Otros","13","14","28","52","0","0","28","52","1"
"4","2017","30","Otros","2","27","28","58","0","0","28","58","3.2"
"4","2017","30","Hotel","6","27","18","18","0","0","18","18","3"
"4","2017","30","Hotel","8","3","82","153","40","60","122","213","4.1111111111111"
"4","2017","26","Hotel","15","27","73","251","0","0","73","251","1"
"4","2017","30","Otros","8","3","53","141","4","8","57","149","10"
"4","2017","30","Hotel","16","20","16","42","7","21","23","63","1"
"4","2017","30","Hotel","6","28","14","17","0","0","14","17","2.4"
"4","2017","30","Otros","2","1","40","84","10","20","50","104","5.5"
"4","2017","30","Hotel","11","36","72","140","51","65","123","205","2.375"
"4","2017","30","Otros","4","13","211","211","0","0","211","211","1"
"4","2017","30","Otros","2","6","166","1162","0","0","166","1162","1"
"4","2017","30","Otros","8","34","69","101","69","107","138","208","5.75"
"4","2017","30","Hotel","11","15","0","0","0","0","0","0","1"
"4","2017","30","Otros","15","27","9","13","0","0","9","13","1.4222222222222"
"4","2017","30","Hotel","13","14","72","123","8","14","80","137","1"
"4","2017","30","Hotel","13","14","253","345","16","26","269","371","1"
"4","2017","30","Hotel","9","30","48","90","9","22","57","112","1"
"4","2017","30","Hotel","4","13","186","312","44","120","230","432","5.4"
"4","2017","30","Otros","6","27","2","3","0","0","2","3","3.960088691796"
"4","2017","21","Hotel","15","27","10","14","0","0","10","14","1"
"4","2017","30","Hotel","2","29","10","33","84","304","94","337","2"
"4","2017","30","Hotel","13","33","62","124","50","150","112","274","2"
"4","2017","30","Hotel","12","35","67","151","58","114","125","265","1.7272727272727"
"4","2017","30","Hotel","13","14","134","204","6","17","140","221","1"
"4","2017","30","Otros","6","25","16","16","0","0","16","16","2.3846153846154"
"4","2017","30","Hotel","8","2","13","15","4","4","17","19","3"
"4","2017","30","Otros","4","39","28","36","0","0","28","36","2.2222222222222"
"4","2017","30","Otros","6","12","111","122","9","11","120","133","1.8256578947368"
"4","2017","30","Otros","13","33","12","44","25","146","37","190","5.125"
"4","2017","30","Hotel","4","13","27","103","0","0","27","103","5.4"
"4","2017","30","Hotel","7","27","159","212","0","0","159","212","4.1666666666667"
"4","2017","30","Hotel","4","13","597","1623","187","429","784","2052","1"
"4","2017","0","","5","8","0","0","0","0","0","0","1"
"4","2017","30","Otros","8","2","40","68","9","9","49","77","6.4285714285714"
"4","2017","30","Otros","2","6","2","2","20","20","22","22","1"
"4","2017","30","","6","10","0","0","0","0","0","0","1"
"4","2017","30","Hotel","2","29","32","108","34","98","66","206","2"
"4","2017","30","","14","31","102","225","416","1373","518","1598","1"
"4","2017","30","Hotel","16","27","3448","13794","0","0","3448","13794","1"
"4","2017","30","Hotel","12","35","39","55","52","69","91","124","1.7272727272727"
"4","2017","30","","12","35","631","749","2271","2460","2902","3209","1"
"4","2017","30","","9","26","13","63","0","0","13","63","1"
"4","2017","30","Otros","11","32","182","258","0","0","182","258","2.2857142857143"
"4","2017","30","Otros","12","24","28","60","55","87","83","147","9.2"
"4","2017","30","Hotel","6","25","10","20","0","0","10","20","1"
"4","2017","30","Otros","11","32","16","20","0","0","16","20","2.2857142857143"
"4","2017","30","Hotel","16","19","63","92","1","1","64","93","4"
"4","2017","30","Otros","13","33","15","15","9","13","24","28","5.125"
"4","2017","30","Otros","16","27","22","72","1","4","23","76","13.818181818182"
"4","2017","30","Otros","6","12","126","365","7","18","133","383","1.8256578947368"
"4","2017","30","Otros","2","29","5","25","0","0","5","25","3.28"
"4","2017","30","Hotel","14","27","174","207","32","45","206","252","1"
"4","2017","30","Otros","2","1","1","1","0","0","1","1","1"
"4","2017","30","Otros","11","32","23","23","0","0","23","23","2.2857142857143"
"4","2017","30","Otros","2","27","1","1","0","0","1","1","1"
"4","2017","30","Hotel","2","29","104","414","16","48","120","462","1"
"4","2017","30","Hotel","4","13","40","334","0","0","40","334","3.2"
"4","2017","30","Hotel","4","21","6","22","0","0","6","22","3"
"4","2017","30","Otros","7","27","72","97","0","0","72","97","4.8333333333333"
"4","2017","30","","3","4","63","122","30","65","93","187","1"
"4","2017","30","Hotel","6","27","33","42","2","2","35","44","3"
"4","2017","30","Otros","16","19","14","30","0","0","14","30","10.263157894737"
"4","2017","30","Otros","11","32","48","96","3","4","51","100","2.2857142857143"
"4","2017","30","Otros","3","7","13","13","36","68","49","81","2"
"4","2017","30","Otros","5","5","22","35","8","16","30","51","3.65625"
"4","2017","24","Otros","15","27","518","518","0","0","518","518","1.4222222222222"
"4","2017","30","Otros","6","25","31","41","0","0","31","41","2.3846153846154"
"4","2017","30","","10","27","14","58","0","0","14","58","1"
"4","2017","30","Otros","2","29","12","24","62","114","74","138","3.28"
"4","2017","30","Otros","12","35","1","2","8","9","9","11","3.5"
"4","2017","30","Otros","16","19","30","48","0","0","30","48","10.263157894737"
"4","2017","30","Otros","9","26","17","64","0","0","17","64","3.8888888888889"
"4","2017","30","Hotel","13","33","45","45","13","13","58","58","2"
"4","2017","30","Otros","11","32","7","11","0","0","7","11","2.2857142857143"
"4","2017","30","Otros","9","22","8","18","0","0","8","18","7.6428571428571"
"4","2017","30","Otros","6","27","10","300","0","0","10","300","3.960088691796"
"4","2017","30","Otros","15","27","32","36","0","0","32","36","1.4222222222222"
"4","2017","30","Otros","11","32","94","94","10","10","104","104","2.2857142857143"
"4","2017","30","Otros","11","15","30","45","1","2","31","47","2.3571428571429"
"4","2017","30","Otros","9","37","11","121","0","0","11","121","4.5"
"4","2017","30","Otros","5","9","32","44","4","8","36","52","4.0454545454545"
"4","2017","30","Hotel","10","27","15","27","0","0","15","27","2.25"
"4","2017","30","Otros","6","28","23","304","0","0","23","304","4.65"
"4","2017","30","Otros","4","13","26","48","37","55","63","103","3.4"
"4","2017","30","Otros","2","1","1","1","0","0","1","1","1"
"4","2017","30","Otros","2","29","27","57","33","66","60","123","3.28"
"4","2017","30","Hotel","8","3","10","28","0","0","10","28","4.1111111111111"
"4","2017","30","Otros","16","19","108","237","0","0","108","237","1.3333333333333"
"4","2017","30","Otros","12","35","0","0","14","14","14","14","3.5"
"4","2017","30","Hotel","12","35","20","62","72","103","92","165","1.7272727272727"
"4","2017","30","Otros","12","35","7","7","35","56","42","63","3.5"
"4","2017","30","Otros","2","29","47","71","66","133","113","204","3.28"
"4","2017","30","Hotel","7","27","106","193","24","44","130","237","1"
"4","2017","30","Hotel","9","22","32","48","2","4","34","52","2.5555555555556"
"4","2017","30","Hotel","12","35","16","18","36","72","52","90","1.7272727272727"
"4","2017","30","Otros","15","16","113","204","26","50","139","254","2"
"4","2017","30","Hotel","15","27","4","6","0","0","4","6","1"
"4","2017","30","Otros","4","13","72","72","0","0","72","72","3.4"
"4","2017","30","Hotel","8","34","96","161","46","82","142","243","2.5714285714286"
"4","2017","0","Hotel","16","20","0","0","0","0","0","0","1"
"4","2017","30","Hotel","6","28","139","153","36","53","175","206","2.4"
"4","2017","30","Hotel","15","27","78","369","3","3","81","372","1"
"4","2017","30","Otros","12","35","14","37","16","31","30","68","3.5"
"4","2017","30","Otros","11","15","32","75","0","0","32","75","2.3571428571429"
"4","2017","30","Otros","11","15","29","94","0","0","29","94","2.3571428571429"
"4","2017","30","Otros","11","36","73","120","44","66","117","186","5.1904761904762"
"4","2017","30","Hotel","11","36","46","72","16","28","62","100","2.375"
"4","2017","30","Hotel","6","12","73","143","0","0","73","143","5"
"4","2017","30","Otros","8","3","64","103","43","57","107","160","10"
"4","2017","30","Otros","10","27","12","26","16","34","28","60","4.84"
"4","2017","30","Otros","8","3","15","21","0","0","15","21","10"
"4","2017","30","Otros","6","25","16","28","0","0","16","28","2.3846153846154"
"4","2017","30","Hotel","2","27","77","115","0","0","77","115","1"
"4","2017","30","Hotel","10","18","0","0","316","896","316","896","3.2"
"4","2017","30","Otros","11","32","102","260","17","41","119","301","1"
"4","2017","30","Hotel","6","10","687","833","317","399","1004","1232","1"
"4","2017","30","Otros","11","32","43","69","3","3","46","72","2.2857142857143"
"4","2017","0","Otros","2","27","0","0","0","0","0","0","1"
"4","2017","30","","12","24","141","501","439","1561","580","2062","1"
"4","2017","30","Hotel","16","27","383","428","0","0","383","428","5.8571428571429"
"4","2017","30","Hotel","7","38","64","498","0","0","64","498","1"
"4","2017","30","Hotel","6","12","1291","1291","12","12","1303","1303","1"
"5","2017","31","Hotel","14","31","982","1495","7779","9314","8761","10809","1"
"5","2017","31","Hotel","14","31","490","985","2672","6629","3162","7614","1"
"5","2017","31","Hotel","14","31","1015","1315","1470","5706","2485","7021","1"
"5","2017","31","Hotel","11","32","48","182","83","420","131","602","1"
"5","2017","31","Hotel","14","27","2286","4103","632","984","2918","5087","1"
"5","2017","31","Otros","11","32","35","47","0","0","35","47","2.2857142857143"
"5","2017","31","Hotel","14","31","199","292","3355","4921","3554","5213","5.4"
"5","2017","31","Hotel","15","16","1311","3243","74","209","1385","3452","1"
"5","2017","31","Hotel","14","31","1168","2740","998","4090","2166","6830","5.4"
"5","2017","31","Hotel","12","24","1177","1835","1982","2588","3159","4423","1"
"5","2017","31","Hotel","16","40","1104","1731","427","931","1531","2662","1"
"5","2017","31","Hotel","6","12","1771","2490","40","114","1811","2604","1"
"5","2017","31","Hotel","10","23","2005","2689","365","438","2370","3127","1"
"5","2017","31","Hotel","14","31","1468","2628","301","579","1769","3207","5.4"
"5","2017","31","Hotel","3","4","692","1293","123","1701","815","2994","1"
"5","2017","31","","11","32","661","901","70","125","731","1026","1"
"5","2017","31","Hotel","6","12","807","1323","109","241","916","1564","1"
"5","2017","31","Hotel","6","12","2444","3154","250","321","2694","3475","1"
"5","2017","31","Hotel","9","26","2714","5437","36","65","2750","5502","1"
"5","2017","31","Hotel","2","1","817","2524","63","565","880","3089","1"
"5","2017","31","Hotel","9","26","835","1302","191","441","1026","1743","1"
"5","2017","31","Hotel","6","12","881","1726","43","139","924","1865","1"
"5","2017","31","Hotel","14","31","82","100","4908","7370","4990","7470","5.4"
"5","2017","31","Hotel","11","32","339","552","171","222","510","774","1"
"5","2017","31","Hotel","2","6","1331","1772","145","180","1476","1952","1"
"5","2017","31","Hotel","16","40","1581","2476","1482","1748","3063","4224","1"
"5","2017","31","Hotel","14","27","1064","2037","483","1215","1547","3252","1"
"5","2017","31","Otros","11","36","83","161","0","0","83","161","1"
"5","2017","31","Hotel","10","23","634","1159","474","817","1108","1976","1"
"5","2017","31","Hotel","14","31","238","560","501","2354","739","2914","7.8"
"5","2017","31","Hotel","7","17","341","714","56","167","397","881","1"
"5","2017","31","Hotel","2","1","2575","2926","364","400","2939","3326","2"
"5","2017","31","Hotel","2","1","1767","2924","347","881","2114","3805","2"
"5","2017","31","Hotel","4","13","1090","1952","241","496","1331","2448","1"
"5","2017","31","Hotel","2","1","2486","2754","344","407","2830","3161","2"
"5","2017","31","Hotel","10","27","1549","2398","529","1458","2078","3856","1"
"5","2017","31","Hotel","14","27","742","1087","1399","2052","2141","3139","1"
"5","2017","31","Hotel","14","27","1547","2866","838","1762","2385","4628","1"
"5","2017","31","Hotel","6","12","1440","3003","54","154","1494","3157","1"
"5","2017","31","Hotel","6","12","1779","2323","533","657","2312","2980","1"
"5","2017","31","Hotel","13","27","1585","3194","2","2","1587","3196","1"
"5","2017","31","Hotel","14","31","345","550","1493","3715","1838","4265","7.8"
"5","2017","31","Hotel","6","12","1416","2264","291","465","1707","2729","1"
"5","2017","31","Hotel","16","27","1995","3760","143","258","2138","4018","1"
"5","2017","31","","10","27","15","44","14","20","29","64","1"
"5","2017","31","Hotel","10","18","698","1285","273","611","971","1896","1"
"5","2017","31","Hotel","9","37","1403","2174","138","270","1541","2444","1"
"5","2017","31","Hotel","16","27","1103","3309","0","0","1103","3309","1"
"5","2017","31","Hotel","15","16","928","1736","77","170","1005","1906","2"
"5","2017","31","Hotel","2","1","1416","2264","291","465","1707","2729","2"
"5","2017","31","Hotel","3","4","544","1298","183","291","727","1589","1"
"5","2017","31","Hotel","16","40","1675","2062","687","973","2362","3035","1"
"5","2017","31","Hotel","7","17","2705","3247","172","196","2877","3443","1"
"5","2017","31","Hotel","12","24","872","1560","432","941","1304","2501","1"
"5","2017","31","Hotel","12","35","559","1065","242","458","801","1523","1"
"5","2017","31","Hotel","2","6","352","799","41","43","393","842","1"
"5","2017","31","Hotel","13","33","1523","1525","203","203","1726","1728","1"
"5","2017","31","Hotel","10","27","1134","1850","764","1021","1898","2871","1"
"5","2017","31","Hotel","10","23","1007","1482","226","346","1233","1828","1"
"5","2017","31","Hotel","11","36","982","1422","175","538","1157","1960","1"
"5","2017","31","Hotel","8","34","1340","1987","199","199","1539","2186","1"
"5","2017","31","Hotel","2","6","919","1810","186","311","1105","2121","1"
"5","2017","31","Hotel","14","31","692","947","1140","1500","1832","2447","7.8"
"5","2017","31","Hotel","11","36","1810","3125","262","672","2072","3797","1"
"5","2017","31","","10","27","122","233","446","715","568","948","1"
"5","2017","31","Hotel","14","31","1135","1635","1858","5511","2993","7146","5.4"
"5","2017","31","Hotel","4","13","3015","3027","1","2","3016","3029","1"
"5","2017","31","Hotel","6","28","1145","2124","51","74","1196","2198","1"
"5","2017","31","Otros","14","31","64","101","201","305","265","406","2.8"
"5","2017","31","Otros","16","27","50","50","0","0","50","50","2"
"5","2017","31","Hotel","2","1","1239","2665","358","383","1597","3048","2"
"5","2017","31","Hotel","10","18","412","709","429","563","841","1272","1"
"5","2017","31","Hotel","7","17","805","986","65","77","870","1063","1"
"5","2017","31","Hotel","12","24","527","1378","293","891","820","2269","1"
"5","2017","31","Hotel","10","18","693","1237","283","504","976","1741","1"
"5","2017","31","Hotel","2","1","3730","4334","76","119","3806","4453","1"
"5","2017","31","Hotel","10","18","572","1138","310","626","882","1764","1"
"5","2017","31","Hotel","6","28","1580","1981","396","477","1976","2458","1"
"5","2017","31","Hotel","5","5","1764","1764","146","146","1910","1910","1"
"5","2017","31","Hotel","4","13","478","1240","35","168","513","1408","1"
"5","2017","31","Hotel","10","18","1000","1780","449","800","1449","2580","1"
"5","2017","31","Hotel","16","40","751","1054","168","196","919","1250","1"
"5","2017","31","Hotel","8","3","1652","3470","452","933","2104","4403","1"
"5","2017","31","Hotel","15","16","765","1991","232","371","997","2362","2"
"5","2017","31","Hotel","14","31","141","238","593","1128","734","1366","7.8"
"5","2017","31","Hotel","13","33","142","204","128","217","270","421","1"
"5","2017","31","Hotel","15","16","713","956","86","108","799","1064","2"
"5","2017","31","Otros","4","21","249","409","2","4","251","413","1"
"5","2017","31","Hotel","6","10","778","1081","0","0","778","1081","1"
"5","2017","31","Hotel","16","19","80","98","7","8","87","106","1"
"5","2017","31","Hotel","16","27","691","1931","4","12","695","1943","1"
"5","2017","31","Hotel","10","11","1296","2181","42","60","1338","2241","1"
"5","2017","31","Otros","10","23","304","584","5","13","309","597","1"
"5","2017","31","Hotel","12","35","56","152","33","83","89","235","1"
"5","2017","31","Hotel","11","36","615","1029","93","113","708","1142","1"
"5","2017","31","Hotel","14","31","46","176","212","1894","258","2070","17.4"
"5","2017","31","Hotel","10","18","360","769","432","1005","792","1774","3.2"
"5","2017","31","Hotel","4","13","423","750","17","23","440","773","1"
"5","2017","31","Hotel","6","12","364","569","36","82","400","651","5"
"5","2017","31","Hotel","6","10","584","1272","26","36","610","1308","1"
"5","2017","31","Otros","5","5","229","519","79","118","308","637","3.65625"
"5","2017","31","Hotel","12","24","537","707","220","459","757","1166","1"
"5","2017","31","Hotel","8","3","640","1276","160","337","800","1613","1"
"5","2017","31","Hotel","13","27","645","1021","0","0","645","1021","2.75"
"5","2017","31","Hotel","15","16","885","2031","74","222","959","2253","4"
"5","2017","31","Otros","15","16","157","709","28","126","185","835","2"
"5","2017","31","Otros","16","20","91","104","0","0","91","104","1"
"5","2017","31","Hotel","3","4","595","1163","10","82","605","1245","1"
"5","2017","31","Hotel","11","36","154","176","0","0","154","176","1"
"5","2017","31","Hotel","2","6","464","915","135","194","599","1109","1"
"5","2017","31","Hotel","8","34","665","1130","137","232","802","1362","1"
"5","2017","31","Hotel","4","13","10","22","0","0","10","22","3.2"
"5","2017","31","Hotel","13","27","729","1511","0","0","729","1511","2.75"
"5","2017","31","Hotel","2","29","325","841","321","1195","646","2036","1"
"5","2017","31","Otros","11","36","64","107","0","0","64","107","1"
"5","2017","31","","10","11","1","1","0","0","1","1","1"
"5","2017","31","Hotel","4","13","875","1336","46","121","921","1457","1"
"5","2017","31","Hotel","16","40","1978","2970","782","1177","2760","4147","5.6666666666667"
"5","2017","31","Hotel","10","23","1008","1421","259","390","1267","1811","2.8"
"5","2017","31","Hotel","8","34","209","391","144","331","353","722","1"
"5","2017","31","Hotel","5","5","220","600","40","93","260","693","1"
"5","2017","31","Hotel","3","4","77","151","83","152","160","303","3"
"5","2017","31","Hotel","9","26","44","101","3","4","47","105","1"
"5","2017","31","Hotel","8","34","309","437","112","208","421","645","1"
"5","2017","31","Hotel","7","17","114","191","12","56","126","247","4"
"5","2017","31","Hotel","4","13","254","1229","43","124","297","1353","3.2"
"5","2017","31","Hotel","12","35","9","32","107","387","116","419","1"
"5","2017","31","Hotel","16","40","854","1773","348","806","1202","2579","1"
"5","2017","31","Hotel","9","26","261","481","48","116","309","597","1"
"5","2017","31","","6","27","155","251","14","35","169","286","1"
"5","2017","31","Hotel","9","26","147","220","4","4","151","224","1"
"5","2017","31","Hotel","4","13","187","307","39","69","226","376","3.2"
"5","2017","31","Hotel","6","28","272","321","11","14","283","335","1"
"5","2017","31","","2","29","69","191","564","1739","633","1930","1"
"5","2017","31","Hotel","13","33","1333","1576","101","145","1434","1721","1"
"5","2017","31","Hotel","8","3","234","502","57","121","291","623","1"
"5","2017","31","Hotel","14","27","477","616","1226","1347","1703","1963","1"
"5","2017","31","Hotel","16","40","244","428","0","0","244","428","5.6666666666667"
"5","2017","31","Hotel","12","24","396","533","129","240","525","773","1"
"5","2017","31","Hotel","10","18","1010","1339","129","269","1139","1608","3.2"
"5","2017","31","Otros","15","16","79","81","6","9","85","90","9"
"5","2017","31","Hotel","6","10","510","580","0","0","510","580","1"
"5","2017","31","Hotel","10","11","655","1029","38","106","693","1135","1"
"5","2017","31","Otros","6","10","47","243","0","0","47","243","3.8518518518518"
"5","2017","31","Otros","10","23","68","149","10","30","78","179","1"
"5","2017","31","Hotel","10","23","420","583","243","431","663","1014","2.8"
"5","2017","31","Hotel","6","12","124","204","4","4","128","208","5"
"5","2017","31","Hotel","6","27","46","94","1","1","47","95","3"
"5","2017","31","Hotel","10","23","414","689","359","685","773","1374","2.8"
"5","2017","31","","4","39","67","101","0","0","67","101","1"
"5","2017","31","Hotel","8","34","456","611","498","792","954","1403","1"
"5","2017","31","Hotel","8","34","474","690","265","392","739","1082","1"
"5","2017","31","Otros","4","39","3","3","0","0","3","3","2.2222222222222"
"5","2017","31","Otros","13","14","138","276","0","0","138","276","1"
"5","2017","31","Hotel","10","23","164","198","10","22","174","220","2.8"
"5","2017","31","Otros","13","14","273","897","0","0","273","897","1"
"5","2017","31","Hotel","12","24","289","450","392","635","681","1085","1"
"5","2017","31","","6","25","56","56","0","0","56","56","1"
"5","2017","31","Hotel","15","27","335","557","16","27","351","584","1"
"5","2017","0","Hotel","12","35","0","0","0","0","0","0","1"
"5","2017","31","Hotel","16","40","776","1309","75","217","851","1526","1"
"5","2017","31","Hotel","16","27","104","167","0","0","104","167","1"
"5","2017","31","Hotel","9","30","45","90","0","0","45","90","1"
"5","2017","31","Hotel","4","13","339","823","19","58","358","881","3.2"
"5","2017","31","Hotel","2","29","136","408","194","717","330","1125","1"
"5","2017","31","Hotel","16","20","252","358","160","257","412","615","1"
"5","2017","31","Hotel","5","5","536","996","158","238","694","1234","1"
"5","2017","31","Hotel","13","33","728","1151","83","158","811","1309","1"
"5","2017","31","Otros","16","19","26","41","0","0","26","41","1.3333333333333"
"5","2017","31","Hotel","12","24","150","384","224","452","374","836","1"
"5","2017","31","","8","2","344","590","21","33","365","623","1"
"5","2017","0","Hotel","12","35","0","0","0","0","0","0","1"
"5","2017","31","Hotel","16","27","25","31","322","366","347","397","2.5"
"5","2017","31","Otros","16","27","226","337","6","19","232","356","2"
"5","2017","31","Hotel","8","34","401","625","255","454","656","1079","1"
"5","2017","31","Otros","8","3","77","243","0","0","77","243","1"
"5","2017","31","Hotel","7","27","236","347","105","176","341","523","1"
"5","2017","31","Hotel","4","39","197","388","0","0","197","388","1"
"5","2017","31","Hotel","15","16","167","337","110","250","277","587","4"
"5","2017","31","Hotel","4","39","3","32","1","12","4","44","1"
"5","2017","31","Hotel","4","39","205","342","38","45","243","387","1"
"5","2017","31","Hotel","15","16","167","505","3","6","170","511","4"
"5","2017","31","Hotel","14","31","32","56","171","623","203","679","17.4"
"5","2017","31","Hotel","8","34","231","297","208","323","439","620","1"
"5","2017","31","Hotel","6","28","216","295","23","25","239","320","1"
"5","2017","31","Hotel","7","17","472","723","32","65","504","788","4"
"5","2017","31","Otros","7","27","7","9","0","0","7","9","1"
"5","2017","31","Hotel","11","36","1535","1750","42","82","1577","1832","1"
"5","2017","31","Otros","4","21","231","393","61","94","292","487","1"
"5","2017","31","Otros","15","16","89","139","31","50","120","189","2"
"5","2017","31","Otros","7","17","159","354","0","0","159","354","3"
"5","2017","12","Hotel","7","38","29","29","2","2","31","31","1"
"5","2017","31","Hotel","16","27","462","490","8","24","470","514","2.5"
"5","2017","31","Hotel","2","6","110","142","2","2","112","144","2.2"
"5","2017","31","Hotel","11","36","297","512","80","128","377","640","1"
"5","2017","31","Hotel","6","28","42","52","2","2","44","54","1"
"5","2017","31","Hotel","6","12","68","115","0","0","68","115","5"
"5","2017","31","Otros","9","22","23","32","0","0","23","32","1"
"5","2017","31","","13","14","154","184","1","4","155","188","2"
"5","2017","31","Hotel","2","29","92","495","495","620","587","1115","1"
"5","2017","31","Hotel","2","29","5","10","53","106","58","116","1"
"5","2017","31","Otros","4","13","361","389","22","22","383","411","1"
"5","2017","31","Hotel","15","16","61","146","31","77","92","223","4"
"5","2017","31","Hotel","2","1","164","407","3","6","167","413","6.4"
"5","2017","31","Otros","7","27","26","28","0","0","26","28","1"
"5","2017","31","Otros","13","33","24","24","0","0","24","24","5.125"
"5","2017","31","","4","21","188","233","6","10","194","243","1"
"5","2017","31","Hotel","6","10","332","332","2","2","334","334","1"
"5","2017","31","Hotel","11","36","72","148","0","0","72","148","1"
"5","2017","31","Otros","14","31","150","250","50","100","200","350","2.8"
"5","2017","31","Hotel","7","27","158","231","8","25","166","256","1"
"5","2017","31","Otros","6","10","24","270","0","0","24","270","3.8518518518518"
"5","2017","31","Hotel","4","39","8","14","3","3","11","17","2.6"
"5","2017","31","Otros","8","2","2","4","2","4","4","8","6.4285714285714"
"5","2017","31","Otros","11","36","27","43","2","4","29","47","5.1904761904762"
"5","2017","31","Hotel","13","33","108","108","2","2","110","110","1"
"5","2017","31","","3","4","150","193","52","65","202","258","1"
"5","2017","31","Hotel","7","17","193","559","27","66","220","625","4"
"5","2017","31","Hotel","8","2","99","152","2","2","101","154","1"
"5","2017","31","Otros","15","16","190","273","20","43","210","316","2"
"5","2017","29","Hotel","10","11","213","320","6","6","219","326","1"
"5","2017","31","Hotel","16","19","362","573","0","0","362","573","1"
"5","2017","31","Hotel","10","23","87","114","16","23","103","137","4"
"5","2017","31","","7","38","146","237","53","56","199","293","1"
"5","2017","31","Hotel","7","27","15","21","0","0","15","21","1"
"5","2017","31","Hotel","11","36","327","670","43","192","370","862","1"
"5","2017","31","Hotel","16","40","179","290","13","27","192","317","16.333333333333"
"5","2017","31","Hotel","16","19","0","0","0","0","0","0","1"
"5","2017","31","Hotel","16","19","0","0","0","0","0","0","1"
"5","2017","31","Hotel","16","20","33","50","0","0","33","50","1"
"5","2017","31","Hotel","10","11","219","374","12","14","231","388","1"
"5","2017","31","Otros","7","27","60","113","0","0","60","113","4.8333333333333"
"5","2017","31","Otros","7","27","12","16","0","0","12","16","1"
"5","2017","31","Hotel","7","27","34","47","0","0","34","47","4.1666666666667"
"5","2017","31","Otros","13","14","35","47","0","0","35","47","1"
"5","2017","31","Otros","11","15","61","83","0","0","61","83","2.3571428571429"
"5","2017","31","Otros","10","27","12","58","7","19","19","77","4.84"
"5","2017","31","Otros","14","31","155","155","1913","1913","2068","2068","2.8"
"5","2017","31","Otros","11","36","16","31","3","4","19","35","5.1904761904762"
"5","2017","31","Hotel","16","19","21","25","0","0","21","25","1"
"5","2017","31","","14","27","86","126","20","32","106","158","2.6666666666667"
"5","2017","31","Hotel","16","40","64","68","0","0","64","68","5.6666666666667"
"5","2017","31","Hotel","10","27","9","20","0","0","9","20","2.25"
"5","2017","31","Otros","2","29","66","142","151","335","217","477","3.28"
"5","2017","31","Hotel","13","27","8","8","17","21","25","29","1"
"5","2017","31","Otros","9","22","18","22","0","0","18","22","1"
"5","2017","31","Hotel","2","27","88","178","12","17","100","195","1"
"5","2017","31","Hotel","8","34","251","353","460","608","711","961","1"
"5","2017","31","Hotel","7","27","276","464","5","5","281","469","1"
"5","2017","31","Hotel","15","16","157","335","20","39","177","374","4"
"5","2017","31","Hotel","16","20","57","77","8","21","65","98","1"
"5","2017","0","Otros","4","13","0","0","0","0","0","0","1"
"5","2017","31","Hotel","2","1","166","394","10","41","176","435","6.4"
"5","2017","31","Otros","11","32","27","77","0","0","27","77","2.2857142857143"
"5","2017","31","Hotel","2","29","23","147","89","599","112","746","1"
"5","2017","31","Hotel","16","27","244","253","123","130","367","383","2.5"
"5","2017","31","Hotel","10","18","258","1094","0","0","258","1094","3.2"
"5","2017","31","Otros","11","36","256","287","18","26","274","313","1"
"5","2017","31","Otros","13","14","15","26","0","0","15","26","1"
"5","2017","31","Hotel","7","27","149","194","0","0","149","194","1"
"5","2017","31","Otros","7","17","30","30","0","0","30","30","3"
"5","2017","31","Otros","14","31","195","295","84","354","279","649","2.8"
"5","2017","31","Hotel","2","29","129","311","317","1107","446","1418","1"
"5","2017","31","Hotel","8","3","92","376","66","136","158","512","1"
"5","2017","31","Hotel","8","34","281","396","196","350","477","746","2.5714285714286"
"5","2017","31","Hotel","8","34","242","311","188","383","430","694","2.5714285714286"
"5","2017","31","Hotel","12","35","150","179","116","170","266","349","1"
"5","2017","31","Hotel","11","32","183","357","6","14","189","371","1"
"5","2017","31","Hotel","13","33","160","226","7","7","167","233","2"
"5","2017","31","Hotel","10","23","166","280","43","73","209","353","2.8"
"5","2017","31","Hotel","12","35","76","271","7","11","83","282","1"
"5","2017","31","","16","40","206","271","16","18","222","289","3.0555555555556"
"5","2017","31","Otros","16","19","6","10","0","0","6","10","1.3333333333333"
"5","2017","31","Otros","16","20","12","48","0","0","12","48","1"
"5","2017","31","Hotel","6","12","179","441","9","24","188","465","5"
"5","2017","31","Hotel","16","19","97","110","0","0","97","110","4"
"5","2017","31","Hotel","12","24","118","326","93","226","211","552","1"
"5","2017","31","Hotel","12","24","229","569","32","74","261","643","3"
"5","2017","0","Hotel","8","3","0","0","0","0","0","0","1"
"5","2017","31","Hotel","5","9","0","0","0","0","0","0","1"
"5","2017","31","Hotel","16","27","218","408","14","35","232","443","2.5"
"5","2017","31","Otros","10","23","32","32","0","0","32","32","7"
"5","2017","31","Otros","13","14","25","42","0","0","25","42","7.3846153846154"
"5","2017","31","Otros","2","6","41","119","15","32","56","151","1"
"5","2017","20","Hotel","15","16","8","11","54","72","62","83","7.8"
"5","2017","31","Hotel","8","3","230","1012","0","0","230","1012","1"
"5","2017","31","Hotel","8","34","272","494","283","525","555","1019","1"
"5","2017","31","Hotel","8","3","11","14","6","10","17","24","1"
"5","2017","31","","2","29","34","72","18","36","52","108","1"
"5","2017","31","Hotel","2","1","221","389","25","111","246","500","6.4"
"5","2017","31","Hotel","7","17","123","219","0","0","123","219","4"
"5","2017","31","Otros","7","17","141","260","0","0","141","260","3"
"5","2017","31","Hotel","16","40","108","191","65","74","173","265","5.6666666666667"
"5","2017","31","Hotel","12","24","192","426","92","168","284","594","1"
"5","2017","31","Hotel","14","31","215","544","210","876","425","1420","17.4"
"5","2017","0","Hotel","9","26","0","0","0","0","0","0","1"
"5","2017","31","Hotel","6","12","61","85","0","0","61","85","5"
"5","2017","31","Otros","5","9","12","18","8","10","20","28","4.0454545454545"
"5","2017","31","Otros","5","9","3","4","1","1","4","5","4.0454545454545"
"5","2017","31","Otros","15","27","87","106","0","0","87","106","1.4222222222222"
"5","2017","31","Hotel","8","34","0","0","1","1","1","1","2.5714285714286"
"5","2017","31","Hotel","10","18","227","445","94","147","321","592","7.75"
"5","2017","31","Hotel","15","16","248","579","43","102","291","681","7.8"
"5","2017","24","Hotel","2","29","43","123","148","457","191","580","1"
"5","2017","31","Hotel","4","39","133","309","11","15","144","324","2.6"
"5","2017","31","Otros","4","39","95","113","2","2","97","115","2.2222222222222"
"5","2017","31","Hotel","4","13","123","276","13","78","136","354","5.4"
"5","2017","31","Otros","10","23","56","92","0","0","56","92","7"
"5","2017","31","Otros","14","31","96","148","222","533","318","681","20.2"
"5","2017","31","Hotel","3","4","62","94","0","0","62","94","2.6"
"5","2017","31","Hotel","10","23","165","280","20","40","185","320","4"
"5","2017","31","Otros","9","22","126","574","3","6","129","580","1"
"5","2017","31","Hotel","12","24","201","423","82","166","283","589","3"
"5","2017","31","Hotel","13","14","4","4","0","0","4","4","1"
"5","2017","31","Hotel","12","35","145","361","35","61","180","422","1.7272727272727"
"5","2017","31","Hotel","6","28","456","662","0","0","456","662","1"
"5","2017","31","","6","28","94","121","0","0","94","121","1"
"5","2017","31","Hotel","12","24","159","381","85","157","244","538","3"
"5","2017","31","Otros","5","9","7","9","0","0","7","9","4.0454545454545"
"5","2017","31","Hotel","16","20","25","27","0","0","25","27","1"
"5","2017","31","Hotel","4","21","125","179","48","52","173","231","3"
"5","2017","31","Otros","10","11","23","31","3","5","26","36","11.764705882353"
"5","2017","31","Otros","13","14","15","23","0","0","15","23","7.3846153846154"
"5","2017","31","Otros","16","27","17","26","0","0","17","26","13.818181818182"
"5","2017","14","Hotel","9","26","240","240","0","0","240","240","1"
"5","2017","31","Hotel","16","27","195","397","106","171","301","568","2.5"
"5","2017","31","Hotel","3","4","1295","2986","302","304","1597","3290","3"
"5","2017","31","Otros","16","27","148","148","0","0","148","148","2"
"5","2017","31","Otros","16","19","218","285","0","0","218","285","1.3333333333333"
"5","2017","31","Hotel","6","12","452","683","11","14","463","697","5"
"5","2017","31","Hotel","2","1","238","464","9","16","247","480","6.4"
"5","2017","31","Hotel","10","11","328","557","7","15","335","572","1"
"5","2017","25","Otros","10","23","91","91","0","0","91","91","1"
"5","2017","31","Otros","10","27","454","500","69","75","523","575","4.84"
"5","2017","31","Hotel","16","27","222","404","9","25","231","429","2.5"
"5","2017","31","Hotel","6","28","170","251","7","9","177","260","1"
"5","2017","31","Hotel","4","13","79","228","1","23","80","251","5.4"
"5","2017","31","Hotel","14","27","554","638","12","15","566","653","8.5"
"5","2017","31","Hotel","10","27","119","222","310","361","429","583","1"
"5","2017","31","Hotel","13","27","77","134","65","102","142","236","4.2"
"5","2017","31","Hotel","3","4","444","701","12","25","456","726","3"
"5","2017","31","Otros","4","13","126","148","0","0","126","148","3.4"
"5","2017","31","Otros","11","15","14","27","0","0","14","27","2.3571428571429"
"5","2017","31","Otros","6","10","61","296","0","0","61","296","3.8518518518518"
"5","2017","31","Otros","2","1","52","78","5","9","57","87","1"
"5","2017","31","","6","12","62","200","1","1","63","201","1"
"5","2017","31","Otros","10","23","238","859","2","2","240","861","1"
"5","2017","31","Hotel","16","19","37","49","0","0","37","49","4"
"5","2017","31","Hotel","10","11","37","150","0","0","37","150","5.6666666666667"
"5","2017","31","Hotel","10","23","47","53","4","7","51","60","4"
"5","2017","31","Otros","14","31","93","177","194","513","287","690","2.8"
"5","2017","31","Otros","13","27","5","5","0","0","5","5","12.2"
"5","2017","31","Hotel","2","1","452","1711","0","0","452","1711","6.4"
"5","2017","31","Hotel","16","19","39","45","0","0","39","45","4"
"5","2017","31","Otros","12","35","33","44","5","7","38","51","3.5"
"5","2017","31","Otros","15","16","92","279","67","296","159","575","2"
"5","2017","31","Otros","9","22","144","288","15","30","159","318","1"
"5","2017","31","Hotel","10","27","195","271","559","732","754","1003","1"
"5","2017","31","Hotel","2","27","105","137","12","14","117","151","3.6"
"5","2017","31","Hotel","16","20","97","247","13","31","110","278","1"
"5","2017","31","Hotel","10","18","0","0","7","15","7","15","7.75"
"5","2017","31","Hotel","6","12","190","196","0","0","190","196","5"
"5","2017","31","Hotel","2","27","66","161","0","0","66","161","3.6"
"5","2017","31","Hotel","15","16","99","175","4","6","103","181","7.8"
"5","2017","31","Hotel","10","23","48","48","17","17","65","65","4"
"5","2017","31","Hotel","11","32","28","32","14","17","42","49","1"
"5","2017","31","Hotel","14","27","118","271","27","166","145","437","8.5"
"5","2017","31","Otros","10","11","17","19","1","6","18","25","11.764705882353"
"5","2017","31","Hotel","2","27","55","124","9","14","64","138","3.6"
"5","2017","31","Otros","13","14","139","278","2","4","141","282","7.3846153846154"
"5","2017","31","Hotel","2","1","145","274","11","16","156","290","6.4"
"5","2017","31","Otros","7","17","194","444","0","0","194","444","17.166666666667"
"5","2017","31","Otros","10","23","18","78","0","0","18","78","7"
"5","2017","31","Hotel","13","27","159","159","15","15","174","174","2.75"
"5","2017","31","Otros","10","18","12","24","6","14","18","38","10.25"
"5","2017","31","Otros","5","9","8","248","0","0","8","248","4.0454545454545"
"5","2017","31","Hotel","4","39","32","48","10","22","42","70","2.6"
"5","2017","31","Otros","16","27","38","141","0","0","38","141","13.818181818182"
"5","2017","31","Hotel","14","27","24","29","27","71","51","100","8.5"
"5","2017","31","Hotel","10","11","26","47","11","22","37","69","5.6666666666667"
"5","2017","31","Hotel","10","18","108","233","40","77","148","310","7.75"
"5","2017","31","Otros","14","31","164","279","101","192","265","471","20.2"
"5","2017","31","Otros","11","32","0","0","3","3","3","3","2.2857142857143"
"5","2017","31","Otros","5","5","6","6","7","11","13","17","3.65625"
"5","2017","31","Otros","6","25","40","47","0","0","40","47","2.3846153846154"
"5","2017","31","Hotel","3","4","56","117","5","11","61","128","2.6"
"5","2017","31","Otros","7","27","55","89","1","1","56","90","4.8333333333333"
"5","2017","31","Otros","2","29","47","105","132","279","179","384","3.28"
"5","2017","31","Hotel","2","29","66","95","148","242","214","337","1"
"5","2017","31","Otros","4","21","37","62","0","0","37","62","1"
"5","2017","12","Hotel","7","27","4","4","0","0","4","4","4.1666666666667"
"5","2017","31","Otros","5","5","17","36","0","0","17","36","3.65625"
"5","2017","31","Otros","11","36","35","50","5","11","40","61","5.1904761904762"
"5","2017","31","Hotel","7","27","331","331","0","0","331","331","4.1666666666667"
"5","2017","0","Hotel","16","20","0","0","0","0","0","0","1"
"5","2017","31","Hotel","12","24","94","152","23","40","117","192","3"
"5","2017","31","Hotel","9","26","99","150","9","10","108","160","1.5"
"5","2017","31","Hotel","7","17","150","555","3","3","153","558","10"
"5","2017","31","Hotel","9","37","218","316","58","111","276","427","3.4"
"5","2017","31","Hotel","5","5","245","436","58","95","303","531","2.1428571428571"
"5","2017","31","Otros","6","27","29","56","0","0","29","56","3.960088691796"
"5","2017","31","Hotel","9","37","37","46","7","8","44","54","3.4"
"5","2017","31","Otros","10","27","44","53","0","0","44","53","4.84"
"5","2017","31","Otros","8","3","228","467","20","26","248","493","10"
"5","2017","31","Otros","16","20","7","9","0","0","7","9","3.0769230769231"
"5","2017","31","Otros","9","22","8","10","0","0","8","10","7.6428571428571"
"5","2017","31","Otros","10","27","204","267","17","17","221","284","4.84"
"5","2017","31","Otros","10","23","55","96","4","5","59","101","7"
"5","2017","31","Otros","2","6","314","335","72","85","386","420","1"
"5","2017","31","Otros","4","39","14","27","0","0","14","27","2.2222222222222"
"5","2017","31","Hotel","2","27","40","40","18","18","58","58","1"
"5","2017","31","Hotel","14","31","59","103","106","396","165","499","24"
"5","2017","31","Otros","2","29","105","220","132","284","237","504","3.28"
"5","2017","31","Otros","8","3","440","2200","0","0","440","2200","10"
"5","2017","31","","13","14","20","28","8","8","28","36","1"
"5","2017","31","Hotel","6","10","136","175","8","10","144","185","6.6"
"5","2017","31","Hotel","8","34","166","299","83","144","249","443","2.5714285714286"
"5","2017","31","Hotel","9","22","132","636","0","0","132","636","2.5555555555556"
"5","2017","31","Hotel","2","6","132","273","7","13","139","286","2.2"
"5","2017","31","Hotel","10","27","109","171","217","287","326","458","2.25"
"5","2017","31","Otros","14","27","100","100","0","0","100","100","11.833333333333"
"5","2017","31","Otros","6","12","257","543","9","17","266","560","1.8256578947368"
"5","2017","31","Hotel","6","27","217","217","0","0","217","217","3"
"5","2017","31","Hotel","5","5","15","30","36","103","51","133","2.1428571428571"
"5","2017","31","Hotel","5","5","67","107","9","9","76","116","2.1428571428571"
"5","2017","31","Hotel","13","27","288","288","0","0","288","288","4.2"
"5","2017","31","Hotel","2","27","121","325","0","0","121","325","3.6"
"5","2017","31","Hotel","8","3","46","46","36","36","82","82","4.1111111111111"
"5","2017","31","Otros","11","36","20","86","1","3","21","89","5.1904761904762"
"5","2017","31","Otros","9","30","19","48","0","0","19","48","2.3333333333333"
"5","2017","31","Otros","16","19","7","8","0","0","7","8","10.263157894737"
"5","2017","31","Hotel","14","31","82","115","356","953","438","1068","17.4"
"5","2017","31","Hotel","2","1","371","428","11","17","382","445","6.4"
"5","2017","31","Hotel","16","40","671","1158","400","529","1071","1687","5.6666666666667"
"5","2017","31","Otros","7","17","219","487","8","17","227","504","17.166666666667"
"5","2017","31","Hotel","13","27","398","515","66","107","464","622","2.75"
"5","2017","31","Hotel","14","31","220","244","435","678","655","922","24"
"5","2017","31","Otros","3","4","41","95","6","11","47","106","12.2"
"5","2017","31","Otros","8","34","145","214","261","376","406","590","5.75"
"5","2017","31","Hotel","9","22","27","30","0","0","27","30","2.5555555555556"
"5","2017","31","Hotel","4","21","47","88","8","15","55","103","3"
"5","2017","31","Hotel","6","27","46","135","0","0","46","135","3"
"5","2017","31","Hotel","12","35","89","122","10","10","99","132","1.7272727272727"
"5","2017","31","Hotel","2","29","10","26","4","6","14","32","2"
"5","2017","31","Otros","10","11","52","75","5","7","57","82","11.764705882353"
"5","2017","31","Hotel","6","10","61","111","0","0","61","111","6.6"
"5","2017","31","Hotel","13","14","41","68","0","0","41","68","2"
"5","2017","8","Otros","16","27","6","6","0","0","6","6","13.818181818182"
"5","2017","31","Otros","6","27","17","17","0","0","17","17","3.960088691796"
"5","2017","31","Hotel","16","40","87","164","211","411","298","575","5.6666666666667"
"5","2017","31","Otros","6","10","44","72","0","0","44","72","3.8518518518518"
"5","2017","31","Otros","10","23","48","55","31","40","79","95","7"
"5","2017","31","Hotel","6","28","227","277","14","14","241","291","1"
"5","2017","31","Otros","7","38","46","72","32","58","78","130","2.75"
"5","2017","31","Hotel","6","12","204","370","2","7","206","377","5"
"5","2017","31","Hotel","13","27","156","221","2","4","158","225","4.2"
"5","2017","31","Otros","4","21","10","23","0","0","10","23","4.8333333333333"
"5","2017","31","Hotel","16","27","68","212","14","14","82","226","5.8571428571429"
"5","2017","31","Hotel","5","5","63","135","15","18","78","153","2.1428571428571"
"5","2017","31","Otros","12","24","42","178","29","37","71","215","9.2"
"5","2017","31","Otros","15","16","51","74","10","17","61","91","9"
"5","2017","31","Hotel","8","27","105","105","11","11","116","116","4.5"
"5","2017","31","Hotel","9","22","5","11","0","0","5","11","2.5555555555556"
"5","2017","31","Hotel","10","11","61","123","10","21","71","144","5.6666666666667"
"5","2017","31","Hotel","8","3","22","38","29","86","51","124","4.1111111111111"
"5","2017","31","Hotel","6","10","394","394","0","0","394","394","6.6"
"5","2017","31","Otros","9","26","13","22","0","0","13","22","3.8888888888889"
"5","2017","31","Hotel","4","39","68","201","8","22","76","223","2.6"
"5","2017","31","Otros","6","27","58","82","0","0","58","82","3.960088691796"
"5","2017","31","Otros","6","12","148","202","0","0","148","202","1.8256578947368"
"5","2017","31","Hotel","6","27","57","122","1","3","58","125","3"
"5","2017","31","Otros","5","9","81","125","9","29","90","154","4.0454545454545"
"5","2017","31","Hotel","2","27","139","164","17","19","156","183","3.6"
"5","2017","31","Hotel","2","29","20","60","165","495","185","555","1"
"5","2017","31","Hotel","4","13","7","47","0","0","7","47","5.4"
"5","2017","31","","11","15","14","280","0","0","14","280","1"
"5","2017","31","Hotel","6","10","299","334","21","25","320","359","6.6"
"5","2017","31","Otros","6","12","32","42","0","0","32","42","1.8256578947368"
"5","2017","31","Otros","10","18","45","45","4","4","49","49","10.25"
"5","2017","31","Otros","9","22","54","70","2","2","56","72","7.6428571428571"
"5","2017","31","","14","27","166","230","0","0","166","230","1"
"5","2017","31","Hotel","16","27","89","123","1","1","90","124","5.8571428571429"
"5","2017","31","Otros","2","29","8","16","20","42","28","58","3.28"
"5","2017","31","Otros","13","33","60","68","0","0","60","68","5.125"
"5","2017","31","Otros","13","33","0","0","11","11","11","11","5.125"
"5","2017","31","Otros","6","10","71","348","0","0","71","348","3.8518518518518"
"5","2017","31","Hotel","10","18","42","81","51","98","93","179","7.75"
"5","2017","31","Hotel","14","31","86","127","41","141","127","268","24"
"5","2017","31","Hotel","4","21","85","85","4","4","89","89","3"
"5","2017","31","Hotel","3","4","65","377","0","0","65","377","2.6"
"5","2017","31","Otros","8","27","0","0","0","0","0","0","1"
"5","2017","31","Otros","6","27","11","31","0","0","11","31","3.960088691796"
"5","2017","31","Hotel","6","25","410","486","0","0","410","486","1"
"5","2017","31","Otros","6","12","220","497","8","15","228","512","1.8256578947368"
"5","2017","31","Hotel","6","27","19","37","0","0","19","37","3"
"5","2017","31","Otros","6","27","80","672","0","0","80","672","3.960088691796"
"5","2017","31","Otros","6","10","15","60","0","0","15","60","3.8518518518518"
"5","2017","31","Otros","6","12","86","171","0","0","86","171","1.8256578947368"
"5","2017","31","Otros","5","5","14","23","3","3","17","26","3.65625"
"5","2017","31","Hotel","12","24","36","207","5","6","41","213","3"
"5","2017","31","Hotel","15","16","78","79","5","8","83","87","7.8"
"5","2017","31","Otros","4","13","60","71","0","0","60","71","3.4"
"5","2017","31","Hotel","2","29","118","638","46","194","164","832","1"
"5","2017","31","Hotel","4","21","8","20","4","10","12","30","3"
"5","2017","31","Hotel","10","27","92","165","104","174","196","339","2.25"
"5","2017","31","Hotel","8","3","142","244","34","57","176","301","4.1111111111111"
"5","2017","31","Hotel","12","27","55","86","0","0","55","86","1"
"5","2017","31","Otros","5","5","60","102","30","65","90","167","3.65625"
"5","2017","31","Otros","13","14","8","8","0","0","8","8","7.3846153846154"
"5","2017","31","Otros","10","11","238","495","0","0","238","495","11.764705882353"
"5","2017","31","Otros","16","40","61","82","4","27","65","109","28.142857142857"
"5","2017","31","Hotel","11","36","198","448","29","57","227","505","1"
"5","2017","31","Otros","8","34","103","187","43","56","146","243","5.75"
"5","2017","31","Hotel","7","17","79","120","10","16","89","136","10"
"5","2017","31","Otros","12","35","149","290","5","9","154","299","3.5"
"5","2017","31","Otros","5","9","15","52","0","0","15","52","4.0454545454545"
"5","2017","31","Hotel","9","22","17","27","0","0","17","27","2.5555555555556"
"5","2017","31","Otros","2","29","24","41","52","58","76","99","3.28"
"5","2017","31","Otros","2","29","47","103","46","104","93","207","3.28"
"5","2017","31","Hotel","10","27","85","179","77","87","162","266","2.25"
"5","2017","31","Hotel","16","19","88","131","15","62","103","193","4"
"5","2017","31","Hotel","16","40","124","298","0","0","124","298","16.333333333333"
"5","2017","31","Hotel","8","27","169","206","13","13","182","219","4.5"
"5","2017","31","Otros","13","14","15","39","0","0","15","39","7.3846153846154"
"5","2017","31","Hotel","7","27","20","20","0","0","20","20","4.1666666666667"
"5","2017","31","Otros","2","6","1","1","0","0","1","1","5"
"5","2017","31","Hotel","7","17","239","486","7","12","246","498","10"
"5","2017","31","Hotel","3","4","101","174","38","62","139","236","2.6"
"5","2017","31","Otros","6","12","14","22","0","0","14","22","1.8256578947368"
"5","2017","31","Otros","6","10","4","4","0","0","4","4","3.8518518518518"
"5","2017","31","Hotel","16","40","27","56","4","8","31","64","16.333333333333"
"5","2017","31","Otros","4","39","25","31","0","0","25","31","2.2222222222222"
"5","2017","31","Otros","13","14","41","82","0","0","41","82","7.3846153846154"
"5","2017","31","Otros","7","38","37","48","7","7","44","55","2.75"
"5","2017","31","Hotel","11","32","93","171","0","0","93","171","1"
"5","2017","31","Otros","11","36","123","265","8","15","131","280","5.1904761904762"
"5","2017","31","Hotel","4","21","59","74","4","6","63","80","3"
"5","2017","31","Otros","3","4","0","0","3","3","3","3","12.2"
"5","2017","31","Otros","5","9","31","47","0","0","31","47","4.0454545454545"
"5","2017","31","Hotel","8","27","67","141","1","1","68","142","4.5"
"5","2017","31","","7","17","56","90","3","3","59","93","1"
"5","2017","31","Otros","16","20","17","36","1","1","18","37","3.0769230769231"
"5","2017","31","Otros","4","21","39","80","6","12","45","92","4.8333333333333"
"5","2017","31","Otros","13","33","56","64","11","13","67","77","5.125"
"5","2017","31","","12","35","31","100","5","17","36","117","1"
"5","2017","31","Hotel","13","33","0","0","2","2","2","2","2"
"5","2017","31","Otros","4","39","18","19","0","0","18","19","2.2222222222222"
"5","2017","31","Otros","10","18","7","29","3","6","10","35","10.25"
"5","2017","31","Otros","6","27","83","127","1","1","84","128","3.960088691796"
"5","2017","31","Hotel","4","39","69","167","0","0","69","167","2.6"
"5","2017","31","Otros","14","31","37","69","89","225","126","294","20.2"
"5","2017","31","Hotel","2","29","46","125","201","320","247","445","2"
"5","2017","31","Hotel","9","26","160","349","2","2","162","351","1.5"
"5","2017","31","Otros","12","35","5","8","1","1","6","9","3.5"
"5","2017","31","Hotel","14","27","82","115","38","49","120","164","8.5"
"5","2017","31","Otros","11","36","25","158","0","0","25","158","5.1904761904762"
"5","2017","31","Otros","16","20","89","195","14","32","103","227","3.0769230769231"
"5","2017","31","Otros","4","39","3","8","0","0","3","8","2.2222222222222"
"5","2017","31","Otros","7","27","136","165","0","0","136","165","4.8333333333333"
"5","2017","31","Otros","6","27","24","50","0","0","24","50","3.960088691796"
"5","2017","31","Otros","5","8","15","465","0","0","15","465","5"
"5","2017","31","Otros","9","37","133","161","12","17","145","178","4.5"
"5","2017","31","Hotel","2","6","55","243","0","0","55","243","5.5"
"5","2017","31","Hotel","10","27","48","55","57","61","105","116","2.25"
"5","2017","31","Hotel","9","30","100","104","1","5","101","109","1"
"5","2017","31","Otros","4","13","36","100","10","10","46","110","3.4"
"5","2017","31","Hotel","5","5","300","300","31","31","331","331","1"
"5","2017","31","Otros","7","38","38","110","0","0","38","110","2.75"
"5","2017","31","Hotel","13","14","15","16","0","0","15","16","1"
"5","2017","31","Otros","5","9","13","21","9","19","22","40","4.0454545454545"
"5","2017","31","Otros","5","8","6","12","0","0","6","12","5"
"5","2017","31","Otros","10","27","51","76","26","31","77","107","4.84"
"5","2017","31","Hotel","13","14","18","39","0","0","18","39","1"
"5","2017","31","Otros","11","15","1","2","0","0","1","2","2.3571428571429"
"5","2017","31","Hotel","9","22","132","216","0","0","132","216","2.5555555555556"
"5","2017","31","Otros","11","36","40","46","1","1","41","47","5.1904761904762"
"5","2017","31","Hotel","10","18","2211","4289","918","2010","3129","6299","1"
"5","2017","31","Hotel","6","12","205","376","0","0","205","376","5"
"5","2017","31","","2","29","324","982","238","660","562","1642","1"
"5","2017","31","Hotel","16","27","909","1820","13","28","922","1848","1"
"5","2017","31","","14","31","447","831","406","1437","853","2268","1"
"5","2017","31","Hotel","8","3","4","6","0","0","4","6","4.1111111111111"
"5","2017","31","Otros","13","33","85","165","13","22","98","187","5.125"
"5","2017","31","","14","27","29","40","0","0","29","40","2.6666666666667"
"5","2017","31","Otros","9","22","5","6","0","0","5","6","7.6428571428571"
"5","2017","31","Hotel","10","11","20","24","0","0","20","24","5.6666666666667"
"5","2017","31","Otros","6","12","19","25","0","0","19","25","1.8256578947368"
"5","2017","31","Hotel","8","3","32","41","14","17","46","58","4.1111111111111"
"5","2017","31","Otros","6","12","111","141","0","0","111","141","1.8256578947368"
"5","2017","31","Hotel","8","27","150","150","0","0","150","150","4.5"
"5","2017","31","Hotel","6","28","201","239","6","12","207","251","2.4"
"5","2017","31","Otros","6","25","17","90","0","0","17","90","2.3846153846154"
"5","2017","31","Otros","6","25","19","37","0","0","19","37","2.3846153846154"
"5","2017","31","Hotel","11","36","504","1368","0","0","504","1368","1"
"5","2017","31","Otros","2","6","28","76","143","499","171","575","5"
"5","2017","31","Hotel","14","31","47","69","120","341","167","410","24"
"5","2017","31","Otros","4","21","11","23","1","1","12","24","4.8333333333333"
"5","2017","31","Otros","7","38","2","2","0","0","2","2","2.75"
"5","2017","31","Otros","13","14","20","20","0","0","20","20","7.3846153846154"
"5","2017","31","Otros","2","29","9","10","7","10","16","20","3.28"
"5","2017","31","Otros","3","4","97","107","26","34","123","141","12.2"
"5","2017","31","Hotel","3","4","381","720","15","27","396","747","3"
"5","2017","31","Otros","7","27","149","176","2","2","151","178","1"
"5","2017","31","Otros","7","17","110","116","0","0","110","116","3"
"5","2017","31","Hotel","12","27","231","400","24","24","255","424","1"
"5","2017","31","Otros","5","5","37","37","11","11","48","48","3.65625"
"5","2017","31","Hotel","6","10","220","260","4","8","224","268","6.6"
"5","2017","31","Otros","10","18","3","7","0","0","3","7","10.25"
"5","2017","31","Otros","8","27","45","81","0","0","45","81","9.4"
"5","2017","31","Otros","8","3","19","30","8","12","27","42","10"
"5","2017","31","Hotel","16","27","54","65","0","0","54","65","5.8571428571429"
"5","2017","31","Otros","6","10","42","95","0","0","42","95","3.8518518518518"
"5","2017","31","Hotel","2","6","43","79","2","2","45","81","5.5"
"5","2017","31","Hotel","8","3","24","53","18","28","42","81","4.1111111111111"
"5","2017","31","Otros","10","11","14","14","2","5","16","19","11.764705882353"
"5","2017","31","Otros","6","27","31","117","0","0","31","117","3.960088691796"
"5","2017","31","Otros","15","16","6","6","0","0","6","6","9"
"5","2017","31","Otros","5","5","0","0","3","3","3","3","3.65625"
"5","2017","31","Otros","10","27","26","38","31","37","57","75","4.84"
"5","2017","31","Hotel","7","38","30","48","6","10","36","58","1"
"5","2017","31","Hotel","13","27","3","3","0","0","3","3","4.2"
"5","2017","31","Hotel","16","20","46","46","0","0","46","46","1"
"5","2017","31","Otros","10","27","14","16","0","0","14","16","4.84"
"5","2017","31","Hotel","3","7","87","123","26","48","113","171","1"
"5","2017","31","Otros","2","29","41","73","3","3","44","76","3.28"
"5","2017","31","Otros","10","18","4","8","0","0","4","8","10.25"
"5","2017","31","Otros","9","22","199","414","0","0","199","414","7.6428571428571"
"5","2017","31","Otros","15","27","34","303","0","0","34","303","1.4222222222222"
"5","2017","31","Otros","11","36","2","6","0","0","2","6","5.1904761904762"
"5","2017","31","Otros","5","5","5","6","0","0","5","6","3.65625"
"5","2017","31","Otros","2","29","29","87","45","123","74","210","3.28"
"5","2017","31","Hotel","9","22","167","167","0","0","167","167","2.5555555555556"
"5","2017","31","Otros","11","32","1","5","0","0","1","5","2.2857142857143"
"5","2017","31","Hotel","10","27","173","272","159","322","332","594","1"
"5","2017","31","Otros","16","27","37","51","0","0","37","51","2"
"5","2017","31","Hotel","16","20","36","52","0","0","36","52","1"
"5","2017","31","Otros","11","15","31","43","0","0","31","43","2.3571428571429"
"5","2017","31","Otros","7","17","108","482","0","0","108","482","3"
"5","2017","31","Otros","5","8","10","12","2","5","12","17","5"
"5","2017","30","Hotel","13","33","99","139","4","4","103","143","2"
"5","2017","31","Otros","5","9","47","74","49","61","96","135","4.0454545454545"
"5","2017","31","Otros","10","27","68","107","45","78","113","185","4.84"
"5","2017","31","Otros","9","22","13","15","0","0","13","15","7.6428571428571"
"5","2017","31","Otros","16","40","63","122","0","0","63","122","28.142857142857"
"5","2017","31","Hotel","16","40","67","67","9","9","76","76","1"
"5","2017","31","Otros","15","16","13","35","1","2","14","37","9"
"5","2017","31","Hotel","8","2","19","27","14","15","33","42","3"
"5","2017","31","Otros","8","3","4","64","0","0","4","64","10"
"5","2017","31","Otros","7","17","32","69","0","0","32","69","17.166666666667"
"5","2017","31","Otros","16","20","54","76","0","0","54","76","3.0769230769231"
"5","2017","31","Otros","6","27","6","10","0","0","6","10","3.960088691796"
"5","2017","31","Otros","12","35","48","88","42","101","90","189","3.5"
"5","2017","31","Otros","6","28","83","350","7","14","90","364","4.65"
"5","2017","31","Otros","6","28","308","1083","6","10","314","1093","4.65"
"5","2017","31","Hotel","8","34","66","124","112","144","178","268","2.5714285714286"
"5","2017","31","Hotel","16","20","550","1103","9","24","559","1127","1"
"5","2017","31","Hotel","2","6","501","1008","0","0","501","1008","2.2"
"5","2017","31","Hotel","7","27","54","56","0","0","54","56","4.1666666666667"
"5","2017","31","Hotel","10","23","17","17","4","4","21","21","4"
"5","2017","31","Hotel","9","26","9","10","6","6","15","16","1.5"
"5","2017","31","Otros","8","27","48","54","0","0","48","54","9.4"
"5","2017","31","Otros","10","27","3","7","5","6","8","13","4.84"
"5","2017","31","Otros","11","15","3","4","1","1","4","5","2.3571428571429"
"5","2017","31","Otros","16","20","2","2","0","0","2","2","3.0769230769231"
"5","2017","31","Otros","11","32","75","116","0","0","75","116","1"
"5","2017","31","Otros","16","27","47","47","3","3","50","50","13.818181818182"
"5","2017","31","Otros","9","37","37","37","0","0","37","37","4.5"
"5","2017","31","Hotel","2","29","3","9","16","79","19","88","2"
"5","2017","31","Hotel","2","1","105","368","6","8","111","376","6.4"
"5","2017","31","Otros","5","8","5","7","0","0","5","7","5"
"5","2017","31","Otros","9","37","44","69","20","36","64","105","4.5"
"5","2017","31","Otros","7","38","51","68","0","0","51","68","2.75"
"5","2017","31","Otros","11","32","35","61","3","6","38","67","1"
"5","2017","31","Otros","4","39","43","54","12","12","55","66","2.2222222222222"
"5","2017","31","Hotel","11","36","49","122","20","132","69","254","2.375"
"5","2017","31","Otros","10","23","26","51","8","22","34","73","7"
"5","2017","31","Hotel","15","16","595","1292","72","235","667","1527","2"
"5","2017","31","Otros","2","29","15","46","118","222","133","268","3.28"
"5","2017","31","Hotel","6","12","1188","1542","36","43","1224","1585","1"
"5","2017","31","Hotel","11","15","0","0","0","0","0","0","1"
"5","2017","31","Otros","4","21","53","66","0","0","53","66","1"
"5","2017","31","Otros","16","19","36","81","0","0","36","81","10.263157894737"
"5","2017","31","","9","37","300","417","2","6","302","423","1"
"5","2017","31","Otros","10","27","48","68","46","61","94","129","4.84"
"5","2017","31","Otros","11","15","19","186","0","0","19","186","2.3571428571429"
"5","2017","31","Hotel","2","29","42","102","82","248","124","350","2"
"5","2017","31","Hotel","10","27","142","177","71","107","213","284","1"
"5","2017","31","Hotel","11","36","89","535","14","52","103","587","2.375"
"5","2017","31","Hotel","9","37","94","114","28","30","122","144","3.4"
"5","2017","31","Otros","14","27","6","12","4","8","10","20","11.833333333333"
"5","2017","31","Otros","7","38","50","68","0","0","50","68","1"
"5","2017","31","Hotel","2","1","34","113","0","0","34","113","6.4"
"5","2017","31","Otros","2","29","0","0","77","250","77","250","3.28"
"5","2017","31","Hotel","6","27","20","40","0","0","20","40","3"
"5","2017","31","Otros","5","9","17","24","0","0","17","24","4.0454545454545"
"5","2017","31","Hotel","2","1","161","234","0","0","161","234","6.4"
"5","2017","31","Hotel","3","7","12","34","18","26","30","60","1"
"5","2017","31","Otros","7","38","50","50","152","152","202","202","2.75"
"5","2017","31","Otros","7","17","12","24","0","0","12","24","17.166666666667"
"5","2017","31","Otros","7","38","6","8","0","0","6","8","2.75"
"5","2017","31","Otros","4","21","11","11","0","0","11","11","4.8333333333333"
"5","2017","31","Otros","2","1","31","31","4","4","35","35","5.5"
"5","2017","31","Otros","12","35","5","9","3","3","8","12","3.5"
"5","2017","31","Otros","12","35","1","2","2","2","3","4","3.5"
"5","2017","31","Otros","4","21","24","29","4","4","28","33","4.8333333333333"
"5","2017","31","Otros","12","24","15","30","15","30","30","60","9.2"
"5","2017","31","Otros","16","19","1","1","0","0","1","1","10.263157894737"
"5","2017","31","Otros","10","11","51","62","0","0","51","62","11.764705882353"
"5","2017","31","Otros","16","19","13","26","0","0","13","26","10.263157894737"
"5","2017","31","Hotel","2","27","33","35","5","6","38","41","1"
"5","2017","31","Otros","6","28","10","18","0","0","10","18","4.65"
"5","2017","31","Otros","10","18","147","268","41","95","188","363","10.25"
"5","2017","31","Otros","14","27","44","118","0","0","44","118","11.833333333333"
"5","2017","31","Hotel","11","32","9","29","0","0","9","29","1"
"5","2017","31","Otros","8","27","20","55","0","0","20","55","9.4"
"5","2017","31","Hotel","12","35","54","121","16","22","70","143","1.7272727272727"
"5","2017","31","Otros","13","14","18","26","0","0","18","26","7.3846153846154"
"5","2017","31","Otros","11","36","17","30","0","0","17","30","5.1904761904762"
"5","2017","31","Otros","16","20","3","3","0","0","3","3","3.0769230769231"
"5","2017","31","Hotel","14","31","175","499","775","1263","950","1762","7.8"
"5","2017","31","Otros","2","27","90","226","24","151","114","377","3.2"
"5","2017","31","","16","40","76","169","0","0","76","169","3.0555555555556"
"5","2017","31","Hotel","11","36","43","58","17","30","60","88","2.375"
"5","2017","31","Hotel","9","22","18","20","4","6","22","26","2.5555555555556"
"5","2017","31","Otros","2","29","6","8","13","41","19","49","3.28"
"5","2017","31","Hotel","10","27","8","9","72","86","80","95","2.25"
"5","2017","31","Otros","10","27","16","105","0","0","16","105","4.84"
"5","2017","31","Hotel","16","19","8","12","0","0","8","12","4"
"5","2017","21","Otros","2","6","7","49","0","0","7","49","5"
"5","2017","31","Otros","7","27","70","87","0","0","70","87","4.8333333333333"
"5","2017","31","Hotel","2","6","114","871","0","0","114","871","5.5"
"5","2017","31","Hotel","6","28","2","2","3","3","5","5","2.4"
"5","2017","31","Otros","6","10","68","372","0","0","68","372","3.8518518518518"
"5","2017","31","Hotel","6","27","67","67","4","4","71","71","3"
"5","2017","31","Otros","5","5","19","27","1","1","20","28","3.65625"
"5","2017","31","Otros","12","24","56","110","31","46","87","156","9.2"
"5","2017","31","Hotel","8","2","78","190","2","2","80","192","3"
"5","2017","31","Hotel","11","32","8","62","0","0","8","62","1"
"5","2017","4","Otros","10","18","6","14","2","4","8","18","10.25"
"5","2017","31","Hotel","9","37","13","16","9","14","22","30","3.4"
"5","2017","31","Otros","5","9","41","53","16","26","57","79","4.0454545454545"
"5","2017","31","Otros","12","24","4","22","6","12","10","34","9.2"
"5","2017","31","Otros","9","22","2","2","0","0","2","2","7.6428571428571"
"5","2017","31","Otros","2","29","12","29","16","68","28","97","3.28"
"5","2017","31","Otros","10","23","7","43","0","0","7","43","7"
"5","2017","31","Otros","10","27","60","290","16","40","76","330","4.84"
"5","2017","31","Otros","10","11","30","30","0","0","30","30","11.764705882353"
"5","2017","31","Otros","8","3","5","5","0","0","5","5","10"
"5","2017","31","Otros","14","31","102","186","338","555","440","741","20.2"
"5","2017","31","Otros","2","29","156","366","186","468","342","834","3.28"
"5","2017","0","Otros","6","25","0","0","0","0","0","0","1"
"5","2017","31","Hotel","15","16","17","37","0","0","17","37","7.8"
"5","2017","31","Hotel","15","27","45","45","0","0","45","45","1"
"5","2017","31","Otros","10","27","8","24","0","0","8","24","4.84"
"5","2017","31","Otros","10","23","57","57","0","0","57","57","7"
"5","2017","31","Otros","6","27","15","143","0","0","15","143","3.960088691796"
"5","2017","31","Otros","16","40","56","89","0","0","56","89","28.142857142857"
"5","2017","31","Otros","11","36","85","85","3","3","88","88","5.1904761904762"
"5","2017","31","Otros","8","34","38","204","28","35","66","239","5.75"
"5","2017","31","Otros","6","12","30","159","0","0","30","159","1.8256578947368"
"5","2017","31","Otros","6","10","135","213","0","0","135","213","3.8518518518518"
"5","2017","31","Hotel","4","21","74","123","8","10","82","133","3"
"5","2017","31","Hotel","11","36","53","193","16","22","69","215","2.375"
"5","2017","31","Otros","5","8","77","108","9","11","86","119","5"
"5","2017","31","Hotel","7","17","78","129","0","0","78","129","10"
"5","2017","26","Hotel","11","36","191","223","26","43","217","266","1"
"5","2017","31","Otros","9","30","10","14","0","0","10","14","2.3333333333333"
"5","2017","31","Hotel","12","35","35","57","17","27","52","84","1.7272727272727"
"5","2017","31","Otros","2","1","99","174","20","30","119","204","5.5"
"5","2017","31","Hotel","6","25","42","80","5","10","47","90","1"
"5","2017","31","Otros","5","5","5","155","0","0","5","155","3.65625"
"5","2017","31","Otros","2","29","34","61","45","127","79","188","3.28"
"5","2017","31","Hotel","2","6","14","38","6","6","20","44","5.5"
"5","2017","31","Otros","7","17","7","12","1","1","8","13","17.166666666667"
"5","2017","31","Hotel","8","2","6","6","4","4","10","10","3"
"5","2017","31","Hotel","13","14","6","49","0","0","6","49","1"
"5","2017","31","Otros","7","38","26","76","2","4","28","80","2.75"
"5","2017","31","Hotel","14","31","16","35","116","292","132","327","24"
"5","2017","31","Hotel","5","5","24","41","0","0","24","41","2.1428571428571"
"5","2017","31","Otros","2","27","5","11","4","4","9","15","3.2"
"5","2017","31","Otros","5","8","17","22","19","31","36","53","5"
"5","2017","31","Otros","3","4","41","88","12","15","53","103","12.2"
"5","2017","31","Otros","13","14","1","1","0","0","1","1","7.3846153846154"
"5","2017","31","Otros","9","37","52","154","0","0","52","154","4.5"
"5","2017","31","Hotel","10","23","488","580","35","56","523","636","1"
"5","2017","31","Otros","11","32","10","10","0","0","10","10","2.2857142857143"
"5","2017","31","Otros","11","15","1","2","0","0","1","2","2.3571428571429"
"5","2017","31","Otros","8","3","117","789","0","0","117","789","10"
"5","2017","31","Otros","16","20","20","38","0","0","20","38","3.0769230769231"
"5","2017","31","Otros","8","3","17","39","0","0","17","39","10"
"5","2017","31","Otros","16","27","14","14","0","0","14","14","2"
"5","2017","31","Hotel","16","19","12","14","0","0","12","14","4"
"5","2017","31","Hotel","16","27","30","78","2","4","32","82","5.8571428571429"
"5","2017","31","Otros","9","26","16","19","0","0","16","19","3.8888888888889"
"5","2017","31","Otros","5","5","6","20","5","9","11","29","3.65625"
"5","2017","31","Otros","14","27","2","2","0","0","2","2","11.833333333333"
"5","2017","31","Hotel","5","5","13","18","0","0","13","18","2.1428571428571"
"5","2017","31","Hotel","12","24","89","171","124","226","213","397","3"
"5","2017","31","Otros","16","27","5","18","0","0","5","18","13.818181818182"
"5","2017","31","Otros","8","3","6","36","0","0","6","36","1"
"5","2017","31","Otros","13","27","75","106","0","0","75","106","12.2"
"5","2017","31","Hotel","16","40","17","28","4","6","21","34","16.333333333333"
"5","2017","31","Otros","11","36","18","34","0","0","18","34","1"
"5","2017","31","Otros","10","27","6","22","1","1","7","23","4.84"
"5","2017","31","Otros","9","22","12","14","0","0","12","14","7.6428571428571"
"5","2017","31","Hotel","5","5","28","53","11","14","39","67","2.1428571428571"
"5","2017","31","Otros","2","29","78","219","63","203","141","422","3.28"
"5","2017","31","Otros","2","29","2","4","1","8","3","12","3.28"
"5","2017","31","Hotel","13","14","2","2","0","0","2","2","1"
"5","2017","31","Otros","6","25","7","7","0","0","7","7","2.3846153846154"
"5","2017","31","Otros","2","1","44","44","0","0","44","44","5.5"
"5","2017","31","Hotel","12","27","28","59","2","2","30","61","1"
"5","2017","31","Hotel","13","27","20","20","0","0","20","20","4.2"
"5","2017","31","Otros","6","12","69","231","0","0","69","231","1.8256578947368"
"5","2017","31","Otros","6","27","23","67","0","0","23","67","3.960088691796"
"5","2017","31","Otros","6","25","7","8","0","0","7","8","2.3846153846154"
"5","2017","31","Hotel","6","28","19","55","0","0","19","55","2.5833333333333"
"5","2017","31","Otros","5","5","1","1","0","0","1","1","3.65625"
"5","2017","31","Otros","5","9","10","13","0","0","10","13","4.0454545454545"
"5","2017","31","Otros","5","8","6","6","2","2","8","8","5"
"5","2017","31","Hotel","2","29","161","646","36","105","197","751","1"
"5","2017","31","Otros","5","5","78","152","55","125","133","277","3.65625"
"5","2017","31","Hotel","9","26","3","4","0","0","3","4","1.5"
"5","2017","31","Otros","9","30","15","36","0","0","15","36","2.3333333333333"
"5","2017","31","Otros","11","15","15","30","0","0","15","30","2.3571428571429"
"5","2017","31","Hotel","16","27","8","12","5","5","13","17","5.8571428571429"
"5","2017","31","Otros","9","30","14","14","0","0","14","14","2.3333333333333"
"5","2017","31","Otros","2","29","8","16","20","43","28","59","3.28"
"5","2017","31","Otros","7","38","17","36","33","42","50","78","2.75"
"5","2017","31","Otros","4","21","18","50","0","0","18","50","4.8333333333333"
"5","2017","31","Otros","9","22","25","52","0","0","25","52","7.6428571428571"
"5","2017","31","Otros","9","22","23","37","0","0","23","37","7.6428571428571"
"5","2017","31","Otros","13","27","3","6","0","0","3","6","12.2"
"5","2017","31","Hotel","11","36","1335","1477","48","154","1383","1631","1"
"5","2017","31","Otros","13","33","8","12","0","0","8","12","5.125"
"5","2017","31","Otros","11","36","83","199","64","148","147","347","5.1904761904762"
"5","2017","31","Otros","12","35","21","45","17","35","38","80","3.5"
"5","2017","31","Otros","12","35","4","11","0","0","4","11","3.5"
"5","2017","31","Otros","10","11","14","26","4","8","18","34","11.764705882353"
"5","2017","31","Otros","12","24","7","16","15","45","22","61","9.2"
"5","2017","31","Otros","16","20","7","22","0","0","7","22","3.0769230769231"
"5","2017","31","Hotel","7","27","27","37","3","3","30","40","1"
"5","2017","31","Otros","6","12","24","30","0","0","24","30","1.8256578947368"
"5","2017","31","Otros","11","32","19","37","5","10","24","47","2.2857142857143"
"5","2017","31","Otros","6","28","31","31","4","4","35","35","4.65"
"5","2017","31","Otros","8","34","1","1","0","0","1","1","5.75"
"5","2017","31","Otros","16","27","28","74","0","0","28","74","13.818181818182"
"5","2017","31","Otros","10","11","1","2","0","0","1","2","11.764705882353"
"5","2017","31","Otros","6","10","10","14","0","0","10","14","3.8518518518518"
"5","2017","31","Otros","8","3","6","6","0","0","6","6","10"
"5","2017","31","Hotel","16","20","90","116","24","32","114","148","1"
"5","2017","31","Hotel","11","32","52","108","6","6","58","114","1"
"5","2017","31","Otros","8","27","5","10","0","0","5","10","9.4"
"5","2017","31","Otros","12","27","8","8","3","3","11","11","3.4285714285714"
"5","2017","31","Otros","6","10","32","56","0","0","32","56","3.8518518518518"
"5","2017","31","Otros","6","10","26","69","0","0","26","69","3.8518518518518"
"5","2017","31","Otros","5","8","4","10","2","4","6","14","5"
"5","2017","31","Otros","5","8","19","19","10","10","29","29","5"
"5","2017","31","Hotel","9","26","36","52","8","18","44","70","1.5"
"5","2017","31","Hotel","13","14","9","31","0","0","9","31","1"
"5","2017","31","Otros","10","18","23","98","8","44","31","142","10.25"
"5","2017","31","Otros","8","2","20","22","33","37","53","59","6.4285714285714"
"5","2017","31","Otros","7","27","7","9","0","0","7","9","4.8333333333333"
"5","2017","31","Otros","2","29","2","3","0","0","2","3","3.28"
"5","2017","31","Otros","11","32","1","1","0","0","1","1","2.2857142857143"
"5","2017","31","Otros","9","30","13","29","0","0","13","29","2.3333333333333"
"5","2017","31","Otros","2","29","4","12","8","10","12","22","3.28"
"5","2017","31","Otros","5","5","2","6","0","0","2","6","3.65625"
"5","2017","31","Otros","11","15","27","36","0","0","27","36","2.3571428571429"
"5","2017","31","Otros","10","23","13","14","0","0","13","14","7"
"5","2017","31","Otros","11","36","85","181","16","34","101","215","5.1904761904762"
"5","2017","31","Hotel","3","7","23","64","41","69","64","133","1"
"5","2017","31","Otros","10","27","1","22","2","2","3","24","4.84"
"5","2017","31","Otros","2","27","15","25","0","0","15","25","3.2"
"5","2017","31","Otros","12","35","8","13","14","42","22","55","3.5"
"5","2017","31","Otros","10","27","8","10","4","4","12","14","4.84"
"5","2017","31","Otros","16","40","22","38","128","290","150","328","28.142857142857"
"5","2017","31","Hotel","8","3","176","261","80","147","256","408","4.1111111111111"
"5","2017","31","Otros","9","22","17","34","0","0","17","34","7.6428571428571"
"5","2017","31","Otros","13","14","11","24","0","0","11","24","7.3846153846154"
"5","2017","31","Otros","5","9","1","1","0","0","1","1","4.0454545454545"
"5","2017","31","Otros","10","18","28","47","7","11","35","58","10.25"
"5","2017","31","Otros","6","25","18","24","0","0","18","24","2.3846153846154"
"5","2017","31","Otros","9","22","6","18","0","0","6","18","7.6428571428571"
"5","2017","31","Otros","10","27","35","67","10","14","45","81","4.84"
"5","2017","31","Otros","16","20","26","30","0","0","26","30","3.0769230769231"
"5","2017","31","Hotel","7","17","68","155","0","0","68","155","10"
"5","2017","31","Otros","15","27","21","30","0","0","21","30","1.4222222222222"
"5","2017","31","Otros","12","35","4","6","0","0","4","6","3.5"
"5","2017","31","Otros","12","35","11","16","34","46","45","62","3.5"
"5","2017","31","Otros","3","7","2","3","0","0","2","3","2"
"5","2017","31","Otros","10","11","1","1","0","0","1","1","11.764705882353"
"5","2017","31","Otros","12","24","5","7","0","0","5","7","9.2"
"5","2017","31","Otros","10","23","11","13","0","0","11","13","7"
"5","2017","31","Otros","7","27","1","3","0","0","1","3","4.8333333333333"
"5","2017","31","","10","18","4","4","0","0","4","4","1"
"5","2017","31","Otros","16","27","5","5","2","2","7","7","13.818181818182"
"5","2017","31","Hotel","2","29","10","26","12","21","22","47","1"
"5","2017","31","Otros","14","27","27","45","0","0","27","45","11.833333333333"
"5","2017","31","Otros","11","32","26","32","0","0","26","32","2.2857142857143"
"5","2017","31","Otros","16","19","2","2","0","0","2","2","1"
"5","2017","31","Otros","16","27","35","43","0","0","35","43","13.818181818182"
"5","2017","31","Otros","8","3","19","48","4","8","23","56","10"
"5","2017","31","Otros","16","27","21","39","0","0","21","39","13.818181818182"
"5","2017","31","Otros","16","20","18","25","2","2","20","27","3.0769230769231"
"5","2017","31","Otros","16","40","73","105","13","16","86","121","28.142857142857"
"5","2017","31","Hotel","11","36","46","76","16","30","62","106","2.375"
"5","2017","31","Otros","6","10","40","56","0","0","40","56","3.8518518518518"
"5","2017","31","Otros","7","38","63","168","0","0","63","168","2.75"
"5","2017","31","Otros","13","14","11","18","0","0","11","18","7.3846153846154"
"5","2017","31","Otros","9","30","25","29","0","0","25","29","2.3333333333333"
"5","2017","31","Otros","13","27","53","258","0","0","53","258","12.2"
"5","2017","31","Otros","10","27","57","57","33","33","90","90","4.84"
"5","2017","31","Otros","6","25","4","6","0","0","4","6","2.3846153846154"
"5","2017","31","Otros","9","26","7","154","0","0","7","154","3.8888888888889"
"5","2017","31","Otros","10","18","9","19","0","0","9","19","10.25"
"5","2017","31","Otros","2","29","12","34","0","0","12","34","3.28"
"5","2017","31","Otros","6","25","4","7","0","0","4","7","2.3846153846154"
"5","2017","31","Otros","5","9","2","2","3","5","5","7","4.0454545454545"
"5","2017","31","Otros","5","9","11","44","0","0","11","44","4.0454545454545"
"5","2017","31","Hotel","9","37","61","138","1","2","62","140","3.4"
"5","2017","23","Hotel","7","38","60","128","2","4","62","132","1"
"5","2017","31","Otros","7","27","41","54","0","0","41","54","4.8333333333333"
"5","2017","31","Otros","5","9","1","1","0","0","1","1","4.0454545454545"
"5","2017","31","Otros","10","27","4","4","1","2","5","6","4.84"
"5","2017","31","Otros","7","27","30","39","0","0","30","39","4.8333333333333"
"5","2017","31","Otros","16","40","13","15","26","54","39","69","28.142857142857"
"5","2017","31","Otros","10","23","27","27","1","1","28","28","7"
"5","2017","31","Otros","15","16","63","135","18","36","81","171","9"
"5","2017","25","Otros","3","7","5","10","53","134","58","144","2"
"5","2017","31","Otros","7","17","48","98","0","0","48","98","17.166666666667"
"5","2017","31","Otros","8","27","46","93","0","0","46","93","9.4"
"5","2017","31","Otros","9","22","15","50","0","0","15","50","7.6428571428571"
"5","2017","31","Otros","16","19","1","1","0","0","1","1","10.263157894737"
"5","2017","31","","15","27","87","212","0","0","87","212","1"
"5","2017","31","Hotel","10","11","19","19","6","6","25","25","5.6666666666667"
"5","2017","31","Otros","2","27","5","5","4","4","9","9","3.2"
"5","2017","31","Otros","8","2","33","64","12","16","45","80","6.4285714285714"
"5","2017","31","Otros","5","5","1","1","0","0","1","1","3.65625"
"5","2017","31","Otros","12","35","0","0","30","41","30","41","3.5"
"5","2017","3","Otros","8","3","4","12","0","0","4","12","10"
"5","2017","31","Otros","12","24","7","13","13","30","20","43","9.2"
"5","2017","31","Otros","11","32","21","81","0","0","21","81","2.2857142857143"
"5","2017","10","Otros","10","27","2","2","7","7","9","9","4.84"
"5","2017","30","Otros","11","15","25","35","0","0","25","35","2.3571428571429"
"5","2017","31","Otros","5","8","6","10","2","12","8","22","5"
"5","2017","31","Otros","14","27","5","5","5","5","10","10","11.833333333333"
"5","2017","31","Otros","13","27","158","199","0","0","158","199","12.2"
"5","2017","31","Hotel","10","18","17","17","57","57","74","74","3.2"
"5","2017","31","Otros","10","27","38","38","19","19","57","57","4.84"
"5","2017","31","Otros","11","32","1","3","0","0","1","3","1"
"5","2017","31","Otros","9","37","48","191","0","0","48","191","4.5"
"5","2017","31","Otros","12","35","17","27","102","148","119","175","3.5"
"5","2017","31","Otros","8","34","84","138","70","113","154","251","5.75"
"5","2017","31","Hotel","16","40","15","27","29","70","44","97","16.333333333333"
"5","2017","31","Hotel","10","11","10","27","7","14","17","41","5.6666666666667"
"5","2017","31","Otros","7","27","20","40","0","0","20","40","4.8333333333333"
"5","2017","31","Hotel","7","38","2","2","0","0","2","2","1"
"5","2017","31","Otros","6","27","4","16","0","0","4","16","3.960088691796"
"5","2017","31","Otros","6","10","25","47","0","0","25","47","3.8518518518518"
"5","2017","20","Otros","6","25","41","55","0","0","41","55","1"
"5","2017","31","Otros","6","25","5","9","0","0","5","9","2.3846153846154"
"5","2017","31","Otros","6","27","33","42","0","0","33","42","3.960088691796"
"5","2017","31","Otros","6","27","86","200","0","0","86","200","3.960088691796"
"5","2017","31","Otros","5","5","5","75","1","2","6","77","3.65625"
"5","2017","31","Otros","5","5","5","6","0","0","5","6","3.65625"
"5","2017","31","Otros","3","4","15","19","3","3","18","22","12.2"
"5","2017","31","Otros","10","23","63","122","0","0","63","122","7"
"5","2017","31","Otros","8","3","16","42","0","0","16","42","10"
"5","2017","31","Otros","5","5","16","77","3","6","19","83","3.65625"
"5","2017","31","Otros","5","8","3","3","7","21","10","24","5"
"5","2017","31","Otros","6","10","6","6","0","0","6","6","3.8518518518518"
"5","2017","31","Otros","16","19","4","6","0","0","4","6","10.263157894737"
"5","2017","31","Otros","11","15","53","81","2","4","55","85","2.3571428571429"
"5","2017","31","Otros","7","38","13","19","0","0","13","19","2.75"
"5","2017","31","Otros","11","32","63","95","3","3","66","98","2.2857142857143"
"5","2017","31","Otros","8","2","17","35","0","0","17","35","6.4285714285714"
"5","2017","31","Otros","10","27","14","19","10","17","24","36","4.84"
"5","2017","31","Otros","6","27","18","42","0","0","18","42","3.960088691796"
"5","2017","31","Otros","11","32","18","25","0","0","18","25","2.2857142857143"
"5","2017","31","Otros","8","34","19","31","19","33","38","64","5.75"
"5","2017","31","Otros","11","32","1","1","0","0","1","1","2.2857142857143"
"5","2017","31","Otros","10","11","6","11","0","0","6","11","11.764705882353"
"5","2017","31","Otros","11","32","5","9","1","1","6","10","2.2857142857143"
"5","2017","31","Otros","14","31","16","32","0","0","16","32","20.2"
"5","2017","31","Hotel","14","31","171","357","417","1077","588","1434","17.4"
"5","2017","31","Otros","11","36","48","154","3","12","51","166","5.1904761904762"
"5","2017","31","Hotel","15","16","2022","3356","413","686","2435","4042","2"
"5","2017","31","Otros","15","27","1","1","0","0","1","1","1.4222222222222"
"5","2017","24","Otros","5","5","4","4","3","3","7","7","3.65625"
"5","2017","31","Otros","8","34","8","12","6","6","14","18","5.75"
"5","2017","31","Otros","7","27","16","28","0","0","16","28","4.8333333333333"
"5","2017","31","Otros","12","35","1","3","0","0","1","3","3.5"
"5","2017","31","Otros","5","5","48","129","0","0","48","129","3.65625"
"5","2017","31","Otros","10","11","8","13","0","0","8","13","11.764705882353"
"5","2017","31","Otros","10","11","1","1","0","0","1","1","11.764705882353"
"5","2017","31","Otros","9","30","6","120","0","0","6","120","2.3333333333333"
"5","2017","31","Otros","8","2","18","24","0","0","18","24","6.4285714285714"
"5","2017","31","Otros","10","27","80","106","18","20","98","126","4.84"
"5","2017","31","Otros","5","9","10","12","0","0","10","12","4.0454545454545"
"5","2017","31","Otros","6","27","10","21","0","0","10","21","3.960088691796"
"5","2017","31","Otros","6","10","48","63","5","10","53","73","3.8518518518518"
"5","2017","31","Otros","6","10","20","25","0","0","20","25","3.8518518518518"
"5","2017","31","Otros","6","27","25","42","0","0","25","42","3.960088691796"
"5","2017","31","Otros","6","12","4","44","0","0","4","44","1.8256578947368"
"5","2017","16","Otros","6","10","31","54","0","0","31","54","3.8518518518518"
"5","2017","12","Otros","6","10","21","39","0","0","21","39","3.8518518518518"
"5","2017","31","Otros","6","27","3","3","0","0","3","3","3.960088691796"
"5","2017","31","Otros","6","12","24","58","0","0","24","58","1.8256578947368"
"5","2017","31","Otros","6","10","22","37","0","0","22","37","3.8518518518518"
"5","2017","31","Hotel","6","25","14","20","0","0","14","20","1"
"5","2017","31","Otros","6","27","5","5","0","0","5","5","3.960088691796"
"5","2017","31","Otros","5","9","17","23","5","7","22","30","4.0454545454545"
"5","2017","31","Otros","5","5","11","24","15","19","26","43","3.65625"
"5","2017","31","Otros","5","5","9","11","0","0","9","11","3.65625"
"5","2017","31","Otros","5","5","32","50","9","23","41","73","3.65625"
"5","2017","31","Otros","11","36","30","52","0","0","30","52","5.1904761904762"
"5","2017","31","Hotel","6","10","420","1139","9","21","429","1160","1"
"5","2017","31","Otros","5","9","7","10","0","0","7","10","4.0454545454545"
"5","2017","31","Otros","5","8","9","16","5","7","14","23","5"
"5","2017","0","Hotel","15","27","0","0","0","0","0","0","1"
"5","2017","31","Hotel","3","4","297","1689","17","74","314","1763","3"
"5","2017","31","Otros","3","7","27","27","21","33","48","60","1"
"5","2017","31","Otros","7","38","36","45","3","5","39","50","2.75"
"5","2017","31","Hotel","10","27","23","27","1","1","24","28","1"
"5","2017","31","Hotel","12","35","0","0","1","1","1","1","1.7272727272727"
"5","2017","31","Hotel","10","27","7","13","0","0","7","13","2.25"
"5","2017","31","Hotel","7","17","512","900","71","201","583","1101","4"
"5","2017","31","Hotel","16","19","20","24","3","4","23","28","4"
"5","2017","31","Hotel","2","6","76","313","0","0","76","313","2.2"
"5","2017","31","Otros","5","5","76","175","6","46","82","221","3.65625"
"5","2017","31","Otros","12","24","23","45","22","42","45","87","9.2"
"5","2017","31","Otros","5","8","7","9","0","0","7","9","5"
"5","2017","31","Otros","4","13","102","119","7","7","109","126","1"
"5","2017","31","Otros","10","11","67","67","0","0","67","67","11.764705882353"
"5","2017","31","Otros","12","35","6","6","13","13","19","19","3.5"
"5","2017","31","Otros","10","23","56","58","6","6","62","64","7"
"5","2017","31","Otros","11","36","260","533","69","118","329","651","5.1904761904762"
"5","2017","31","Otros","12","35","10","18","5","6","15","24","3.5"
"5","2017","31","Otros","11","36","29","48","8","20","37","68","5.1904761904762"
"5","2017","31","Otros","8","2","88","222","2","4","90","226","6.4285714285714"
"5","2017","31","Otros","9","30","117","234","0","0","117","234","2.3333333333333"
"5","2017","31","Otros","11","36","67","113","7","35","74","148","5.1904761904762"
"5","2017","31","Otros","6","10","26","38","0","0","26","38","3.8518518518518"
"5","2017","31","Otros","10","18","9","19","0","0","9","19","10.25"
"5","2017","31","Otros","7","27","2","62","4","4","6","66","4.8333333333333"
"5","2017","31","Otros","16","20","5","25","0","0","5","25","1"
"5","2017","31","Otros","9","22","9","18","0","0","9","18","7.6428571428571"
"5","2017","31","Otros","5","5","125","171","13","19","138","190","3.65625"
"5","2017","31","Otros","12","35","6","9","3","3","9","12","3.5"
"5","2017","31","Otros","10","11","0","0","1","2","1","2","11.764705882353"
"5","2017","31","Otros","10","11","3","10","0","0","3","10","11.764705882353"
"5","2017","26","Otros","5","9","41","71","1","1","42","72","4.0454545454545"
"5","2017","31","Otros","5","5","4","120","0","0","4","120","3.65625"
"5","2017","31","Otros","12","35","1","1","4","6","5","7","3.5"
"5","2017","31","Otros","7","38","95","216","6","14","101","230","2.75"
"5","2017","31","Hotel","12","35","0","0","11","12","11","12","1.7272727272727"
"5","2017","31","Otros","13","14","18","18","0","0","18","18","1"
"5","2017","31","Otros","5","5","8","8","0","0","8","8","3.65625"
"5","2017","31","Hotel","9","26","6","12","0","0","6","12","1.5"
"5","2017","31","Hotel","16","19","10","10","0","0","10","10","1"
"5","2017","31","Otros","16","19","41","53","0","0","41","53","10.263157894737"
"5","2017","31","Otros","9","30","38","56","1","1","39","57","2.3333333333333"
"5","2017","31","Otros","16","19","2","2","0","0","2","2","10.263157894737"
"5","2017","31","Otros","16","19","86","203","0","0","86","203","10.263157894737"
"5","2017","31","Otros","9","26","14","50","0","0","14","50","3.8888888888889"
"5","2017","31","Otros","16","40","1","2","0","0","1","2","28.142857142857"
"5","2017","31","Hotel","16","27","16","26","0","0","16","26","5.8571428571429"
"5","2017","31","Otros","16","19","12","18","0","0","12","18","10.263157894737"
"5","2017","31","Otros","16","19","7","11","0","0","7","11","10.263157894737"
"5","2017","31","","9","30","179","250","15","21","194","271","1"
"5","2017","31","Otros","16","19","8","8","0","0","8","8","10.263157894737"
"5","2017","31","Otros","10","11","5","37","0","0","5","37","11.764705882353"
"5","2017","31","Otros","11","36","15","15","0","0","15","15","5.1904761904762"
"5","2017","31","Otros","16","19","1","2","0","0","1","2","10.263157894737"
"5","2017","31","Otros","16","19","45","64","0","0","45","64","1.3333333333333"
"5","2017","31","Otros","16","19","21","27","0","0","21","27","10.263157894737"
"5","2017","31","Otros","10","18","15","27","18","103","33","130","10.25"
"5","2017","31","Otros","16","19","4","7","0","0","4","7","10.263157894737"
"5","2017","31","Otros","16","19","4","6","0","0","4","6","1.3333333333333"
"5","2017","31","","9","26","337","1266","0","0","337","1266","1"
"5","2017","31","Otros","16","19","5","5","0","0","5","5","10.263157894737"
"5","2017","31","Otros","16","19","18","22","0","0","18","22","10.263157894737"
"5","2017","31","Hotel","8","2","358","761","38","74","396","835","1"
"5","2017","31","Otros","6","10","7","8","0","0","7","8","3.8518518518518"
"5","2017","31","Otros","6","12","24","46","0","0","24","46","1.8256578947368"
"5","2017","31","Hotel","16","19","45","159","23","50","68","209","1"
"5","2017","31","Otros","3","7","8","8","36","46","44","54","2"
"5","2017","31","Hotel","2","6","1057","2426","260","604","1317","3030","1"
"5","2017","31","Hotel","3","4","455","885","147","267","602","1152","2.6"
"5","2017","31","Hotel","16","40","1833","2539","733","1224","2566","3763","1"
"5","2017","31","Otros","16","27","83","85","0","0","83","85","13.818181818182"
"5","2017","30","Hotel","6","28","184","246","13","13","197","259","2.4"
"5","2017","31","Hotel","8","34","476","588","307","511","783","1099","1"
"5","2017","31","Otros","9","30","5","37","0","0","5","37","2.3333333333333"
"5","2017","31","Hotel","10","18","8","8","144","144","152","152","1"
"5","2017","31","Hotel","9","30","54","133","0","0","54","133","1"
"5","2017","31","Hotel","15","27","25","157","0","0","25","157","1"
"5","2017","31","Hotel","9","22","45","94","0","0","45","94","2.5555555555556"
"5","2017","0","","11","15","0","0","0","0","0","0","1"
"5","2017","31","Otros","6","12","19","24","2","3","21","27","1.8256578947368"
"5","2017","31","Hotel","15","27","30","900","0","0","30","900","1"
"5","2017","31","Otros","15","27","47","74","0","0","47","74","1.4222222222222"
"5","2017","31","Otros","15","27","1","1","0","0","1","1","1.4222222222222"
"5","2017","31","Otros","2","1","72","72","17","17","89","89","1"
"5","2017","31","Otros","12","24","3","4","0","0","3","4","9.2"
"5","2017","31","Otros","5","5","5","10","0","0","5","10","3.65625"
"5","2017","31","Hotel","7","27","179","220","12","12","191","232","1"
"5","2017","31","Otros","16","20","60","64","0","0","60","64","3.0769230769231"
"5","2017","0","","10","11","0","0","0","0","0","0","1"
"5","2017","31","Hotel","16","40","7","7","6","6","13","13","16.333333333333"
"5","2017","31","Otros","12","35","1","1","0","0","1","1","3.5"
"5","2017","31","Hotel","6","27","17","17","0","0","17","17","3"
"5","2017","31","Otros","5","5","14","28","4","8","18","36","3.65625"
"5","2017","31","Hotel","6","27","30","32","4","4","34","36","3"
"5","2017","31","Otros","6","25","25","25","0","0","25","25","2.3846153846154"
"5","2017","31","Hotel","15","27","50","86","0","0","50","86","1"
"5","2017","31","Otros","5","9","27","39","8","8","35","47","4.0454545454545"
"5","2017","31","Hotel","15","27","17","34","4","4","21","38","1"
"5","2017","0","Hotel","5","9","0","0","0","0","0","0","1"
"5","2017","31","Hotel","8","34","53","120","48","95","101","215","2.5714285714286"
"5","2017","0","Hotel","15","27","0","0","0","0","0","0","1"
"5","2017","31","Hotel","6","27","158","227","0","0","158","227","3"
"5","2017","0","Otros","6","27","0","0","0","0","0","0","1"
"5","2017","31","Otros","12","27","4","4","91","91","95","95","3.4285714285714"
"5","2017","31","Hotel","2","27","359","811","59","279","418","1090","1"
"5","2017","31","Hotel","2","6","19","209","0","0","19","209","1"
"5","2017","31","Otros","2","6","60","60","0","0","60","60","1"
"5","2017","31","Hotel","4","39","173","173","0","0","173","173","1"
"5","2017","31","Hotel","6","10","122","230","13","31","135","261","1"
"5","2017","31","Otros","5","8","25","40","0","0","25","40","5"
"5","2017","31","Hotel","13","33","817","1076","56","82","873","1158","1"
"5","2017","31","Hotel","13","33","52","92","0","0","52","92","1"
"5","2017","31","Otros","11","32","130","338","24","37","154","375","2.2857142857143"
"5","2017","31","Hotel","9","26","655","857","225","259","880","1116","1"
"5","2017","31","Hotel","16","20","32","34","4","4","36","38","1"
"5","2017","31","Otros","16","20","1","1","0","0","1","1","3.0769230769231"
"5","2017","31","","16","40","960","1372","4","4","964","1376","1"
"5","2017","31","Hotel","15","16","1291","2432","133","302","1424","2734","1"
"5","2017","0","Hotel","5","9","0","0","0","0","0","0","1"
"5","2017","31","Otros","7","38","41","264","1","1","42","265","2.75"
"5","2017","31","Otros","2","6","158","1024","0","0","158","1024","1"
"5","2017","31","Otros","2","6","54","135","0","0","54","135","1"
"5","2017","31","Hotel","15","27","195","757","19","19","214","776","1"
"5","2017","31","Otros","7","38","25","31","0","0","25","31","2.75"
"5","2017","31","Otros","2","1","19","37","0","0","19","37","1"
"5","2017","31","Otros","8","3","32","63","0","0","32","63","10"
"5","2017","31","Otros","11","36","18","73","0","0","18","73","5.1904761904762"
"5","2017","31","Otros","16","20","5","5","0","0","5","5","3.0769230769231"
"5","2017","31","Otros","8","3","156","312","0","0","156","312","1"
"5","2017","31","Otros","4","39","40","60","0","0","40","60","2.2222222222222"
"5","2017","31","Otros","5","5","180","379","15","38","195","417","3.65625"
"5","2017","31","Otros","12","27","0","0","0","0","0","0","3.4285714285714"
"5","2017","31","Otros","7","27","47","281","0","0","47","281","1"
"5","2017","31","Hotel","2","6","12","12","17","54","29","66","1"
"5","2017","31","Hotel","14","27","142","178","86","128","228","306","1"
"5","2017","31","Hotel","16","19","325","481","146","438","471","919","1"
"5","2017","31","","2","1","56","784","0","0","56","784","1"
"5","2017","31","Hotel","2","27","78","160","7","44","85","204","1"
"5","2017","31","Otros","16","20","18","18","0","0","18","18","1"
"5","2017","0","Otros","13","14","0","0","0","0","0","0","1"
"5","2017","31","Hotel","11","36","83","87","2","2","85","89","2.375"
"5","2017","31","Otros","13","14","4","124","0","0","4","124","7.3846153846154"
"5","2017","31","Otros","12","27","2","2","0","0","2","2","3.4285714285714"
"5","2017","31","Hotel","2","6","232","386","5","5","237","391","2.2"
"5","2017","31","Otros","2","6","882","3162","0","0","882","3162","1"
"5","2017","31","Otros","10","27","3","93","0","0","3","93","4.84"
"5","2017","31","Otros","12","27","1","2","1","1","2","3","3.4285714285714"
"5","2017","31","Otros","13","14","50","251","0","0","50","251","7.3846153846154"
"5","2017","31","Otros","6","12","139","272","23","40","162","312","1.8256578947368"
"5","2017","31","Otros","2","6","704","1697","7","25","711","1722","1"
"5","2017","31","Hotel","12","35","35","57","17","27","52","84","1.7272727272727"
"5","2017","31","Otros","5","5","16","22","13","20","29","42","3.65625"
"5","2017","31","Otros","9","30","0","0","2","62","2","62","2.3333333333333"
"5","2017","31","Hotel","8","2","2","2","2","4","4","6","1"
"5","2017","31","Otros","9","30","5","5","0","0","5","5","2.3333333333333"
"5","2017","31","Hotel","15","27","38","52","0","0","38","52","1"
"5","2017","31","Hotel","3","7","27","27","2","2","29","29","1"
"5","2017","31","Otros","6","12","410","597","0","0","410","597","1.8256578947368"
"5","2017","31","Otros","12","27","18","28","5","8","23","36","3.4285714285714"
"5","2017","31","Otros","2","6","3","22","1","4","4","26","5"
"5","2017","31","Otros","6","27","32","56","0","0","32","56","3.960088691796"
"5","2017","31","Hotel","10","11","35","79","2","4","37","83","1"
"5","2017","31","Otros","2","1","14","170","0","0","14","170","1"
"5","2017","31","Otros","11","36","24","24","0","0","24","24","5.1904761904762"
"5","2017","31","Hotel","11","32","0","0","0","0","0","0","1"
"5","2017","31","Otros","2","27","12","29","0","0","12","29","1"
"5","2017","31","Otros","12","27","6","18","0","0","6","18","3.4285714285714"
"5","2017","31","Hotel","8","2","15","15","4","4","19","19","3"
"5","2017","31","Hotel","16","20","24","24","0","0","24","24","1"
"5","2017","31","Otros","12","35","0","0","12","18","12","18","3.5"
"5","2017","31","Otros","13","14","8","8","0","0","8","8","1"
"5","2017","31","Otros","2","27","16","32","0","0","16","32","3.2"
"5","2017","31","Hotel","6","27","16","16","0","0","16","16","3"
"5","2017","31","Hotel","8","3","48","116","10","22","58","138","4.1111111111111"
"5","2017","25","Hotel","15","27","28","124","0","0","28","124","1"
"5","2017","31","Otros","8","3","47","135","1","1","48","136","10"
"5","2017","0","Hotel","16","20","0","0","0","0","0","0","1"
"5","2017","31","Hotel","6","28","48","94","0","0","48","94","2.4"
"5","2017","31","Otros","2","1","39","147","1","3","40","150","5.5"
"5","2017","31","Hotel","11","36","107","188","79","127","186","315","2.375"
"5","2017","31","Otros","4","13","163","163","0","0","163","163","1"
"5","2017","31","Otros","2","6","161","1218","0","0","161","1218","1"
"5","2017","31","Otros","8","34","53","100","54","78","107","178","5.75"
"5","2017","31","Hotel","11","15","0","0","0","0","0","0","1"
"5","2017","31","Otros","15","27","17","31","0","0","17","31","1.4222222222222"
"5","2017","9","Hotel","13","14","77","100","6","12","83","112","1"
"5","2017","31","Hotel","13","14","241","265","11","18","252","283","1"
"5","2017","31","Hotel","9","30","43","43","3","3","46","46","1"
"5","2017","31","Hotel","4","13","293","577","25","65","318","642","5.4"
"5","2017","31","Otros","6","27","2","3","0","0","2","3","3.960088691796"
"5","2017","0","Hotel","15","27","0","0","0","0","0","0","1"
"5","2017","31","Hotel","2","29","5","13","51","179","56","192","2"
"5","2017","31","Hotel","13","33","12","12","0","0","12","12","2"
"5","2017","31","Hotel","12","35","35","57","17","27","52","84","1.7272727272727"
"5","2017","31","Hotel","13","14","151","210","13","22","164","232","1"
"5","2017","31","Otros","6","25","18","18","0","0","18","18","2.3846153846154"
"5","2017","31","Hotel","8","2","3","3","3","4","6","7","3"
"5","2017","31","Otros","4","39","25","32","0","0","25","32","2.2222222222222"
"5","2017","31","Otros","6","12","103","106","30","51","133","157","1.8256578947368"
"5","2017","31","Otros","13","33","22","38","6","12","28","50","5.125"
"5","2017","31","Hotel","4","13","46","120","10","20","56","140","5.4"
"5","2017","31","Hotel","7","27","168","342","0","0","168","342","4.1666666666667"
"5","2017","31","Hotel","4","13","863","2245","102","156","965","2401","1"
"5","2017","31","","5","8","0","0","0","0","0","0","1"
"5","2017","31","Otros","8","2","33","55","3","3","36","58","6.4285714285714"
"5","2017","31","Otros","2","6","30","30","23","23","53","53","1"
"5","2017","31","","6","10","0","0","0","0","0","0","1"
"5","2017","31","Hotel","2","29","33","121","29","75","62","196","2"
"5","2017","31","","14","31","142","298","399","1303","541","1601","1"
"5","2017","31","Hotel","16","27","3833","11499","0","0","3833","11499","1"
"5","2017","31","Hotel","12","35","28","42","28","43","56","85","1.7272727272727"
"5","2017","31","","12","35","24","68","80","224","104","292","1"
"5","2017","31","","9","26","18","47","0","0","18","47","1"
"5","2017","31","Otros","11","32","46","57","0","0","46","57","2.2857142857143"
"5","2017","31","Otros","12","24","17","46","38","51","55","97","9.2"
"5","2017","31","Hotel","6","25","62","67","2","4","64","71","1"
"5","2017","31","Otros","11","32","4","6","0","0","4","6","2.2857142857143"
"5","2017","31","Hotel","16","19","39","53","0","0","39","53","4"
"5","2017","31","Otros","13","33","29","39","3","3","32","42","5.125"
"5","2017","31","Otros","16","27","15","56","1","4","16","60","13.818181818182"
"5","2017","31","Otros","6","12","126","365","0","0","126","365","1.8256578947368"
"5","2017","31","Otros","2","29","5","5","0","0","5","5","3.28"
"5","2017","31","Hotel","14","27","200","234","204","306","404","540","1"
"5","2017","31","Otros","2","1","77","1078","0","0","77","1078","1"
"5","2017","31","Otros","11","32","41","41","0","0","41","41","2.2857142857143"
"5","2017","31","Otros","2","27","1","1","0","0","1","1","1"
"5","2017","31","Hotel","2","29","178","712","0","0","178","712","1"
"5","2017","31","Hotel","4","13","22","467","0","0","22","467","3.2"
"5","2017","31","Hotel","4","21","8","9","2","2","10","11","3"
"5","2017","31","Otros","7","27","62","100","0","0","62","100","4.8333333333333"
"5","2017","31","","3","4","60","150","65","160","125","310","1"
"5","2017","31","Hotel","6","27","9","13","0","0","9","13","3"
"5","2017","31","Otros","16","19","5","8","0","0","5","8","10.263157894737"
"5","2017","31","Otros","11","32","23","39","1","1","24","40","2.2857142857143"
"5","2017","31","Otros","3","7","26","28","31","55","57","83","2"
"5","2017","31","Otros","5","5","28","43","0","0","28","43","3.65625"
"5","2017","24","Otros","15","27","1101","1626","0","0","1101","1626","1.4222222222222"
"5","2017","31","Otros","6","25","16","17","0","0","16","17","2.3846153846154"
"5","2017","0","","10","27","0","0","0","0","0","0","1"
"5","2017","31","Otros","2","29","17","41","63","158","80","199","3.28"
"5","2017","31","Otros","12","35","1","1","0","0","1","1","3.5"
"5","2017","7","Otros","16","19","2","4","0","0","2","4","10.263157894737"
"5","2017","31","Otros","9","26","22","48","0","0","22","48","3.8888888888889"
"5","2017","31","Hotel","13","33","63","63","6","6","69","69","2"
"5","2017","31","Otros","11","32","4","8","0","0","4","8","2.2857142857143"
"5","2017","31","Otros","9","22","4","8","0","0","4","8","7.6428571428571"
"5","2017","31","Otros","6","27","341","341","0","0","341","341","3.960088691796"
"5","2017","31","Otros","15","27","51","83","0","0","51","83","1.4222222222222"
"5","2017","31","Otros","11","32","93","93","3","3","96","96","2.2857142857143"
"5","2017","31","Otros","11","15","24","47","0","0","24","47","2.3571428571429"
"5","2017","31","Otros","9","37","3","6","0","0","3","6","4.5"
"5","2017","31","Otros","5","9","19","27","0","0","19","27","4.0454545454545"
"5","2017","31","Hotel","10","27","22","95","0","0","22","95","2.25"
"5","2017","31","Otros","6","28","55","407","0","0","55","407","4.65"
"5","2017","31","Otros","4","13","29","42","16","23","45","65","3.4"
"5","2017","31","Otros","2","1","1","1","0","0","1","1","1"
"5","2017","31","Otros","2","29","29","62","26","55","55","117","3.28"
"5","2017","31","Hotel","8","3","2","22","0","0","2","22","4.1111111111111"
"5","2017","31","Otros","16","19","16","35","0","0","16","35","1.3333333333333"
"5","2017","31","Otros","12","35","10","12","18","34","28","46","3.5"
"5","2017","31","Hotel","12","35","20","76","16","24","36","100","1.7272727272727"
"5","2017","31","Otros","12","35","15","29","21","52","36","81","3.5"
"5","2017","31","Otros","2","29","35","66","78","154","113","220","3.28"
"5","2017","31","Hotel","7","27","31","37","0","0","31","37","1"
"5","2017","31","Hotel","9","22","21","28","0","0","21","28","2.5555555555556"
"5","2017","31","Hotel","12","35","41","56","48","78","89","134","1.7272727272727"
"5","2017","31","Otros","15","16","119","277","8","12","127","289","2"
"5","2017","31","Hotel","15","27","4","4","0","0","4","4","1"
"5","2017","31","Otros","4","13","38","38","0","0","38","38","3.4"
"5","2017","31","Hotel","8","34","58","119","20","57","78","176","2.5714285714286"
"5","2017","31","Hotel","16","20","0","0","0","0","0","0","1"
"5","2017","31","Hotel","6","28","148","148","11","11","159","159","2.4"
"5","2017","31","Hotel","15","27","145","354","3","36","148","390","1"
"5","2017","31","Otros","12","35","63","231","17","32","80","263","3.5"
"5","2017","31","Otros","11","15","23","61","0","0","23","61","2.3571428571429"
"5","2017","31","Otros","11","15","34","65","0","0","34","65","2.3571428571429"
"5","2017","31","Otros","11","36","42","69","18","27","60","96","5.1904761904762"
"5","2017","31","Hotel","11","36","22","58","7","22","29","80","2.375"
"5","2017","31","Hotel","6","12","75","135","0","0","75","135","5"
"5","2017","31","Otros","8","3","24","26","20","26","44","52","10"
"5","2017","31","Otros","10","27","22","32","7","11","29","43","4.84"
"5","2017","31","Otros","8","3","16","16","0","0","16","16","10"
"5","2017","31","Otros","6","25","7","11","0","0","7","11","2.3846153846154"
"5","2017","31","Hotel","2","27","84","102","4","23","88","125","1"
"5","2017","31","Hotel","10","18","0","0","201","556","201","556","3.2"
"5","2017","31","Otros","11","32","22","63","7","14","29","77","1"
"5","2017","31","Hotel","6","10","774","985","531","768","1305","1753","1"
"5","2017","31","Otros","11","32","40","49","0","0","40","49","2.2857142857143"
"5","2017","0","Otros","2","27","0","0","0","0","0","0","1"
"5","2017","31","","12","24","87","293","194","654","281","947","1"
"5","2017","31","Hotel","16","27","311","455","0","0","311","455","5.8571428571429"
"5","2017","31","Hotel","7","38","23","23","0","0","23","23","1"
"5","2017","31","Hotel","6","12","2871","2871","33","33","2904","2904","1"
"6","2017","30","Hotel","14","31","1261","1749","7415","8600","8676","10349","1"
"6","2017","30","Hotel","14","31","414","753","1866","5383","2280","6136","1"
"6","2017","30","Hotel","14","31","357","667","1424","4437","1781","5104","1"
"6","2017","30","Hotel","11","32","116","215","24","44","140","259","1"
"6","2017","30","Hotel","14","27","2923","4482","602","918","3525","5400","1"
"6","2017","30","Otros","11","32","114","176","0","0","114","176","2.2857142857143"
"6","2017","30","Hotel","14","31","276","355","2844","3336","3120","3691","5.4"
"6","2017","30","Hotel","15","16","1037","3066","27","150","1064","3216","1"
"6","2017","30","Hotel","14","31","1049","1787","1012","3855","2061","5642","5.4"
"6","2017","30","Hotel","12","24","1553","1788","1017","1810","2570","3598","1"
"6","2017","30","Hotel","16","40","1122","1794","289","741","1411","2535","1"
"6","2017","30","Hotel","6","12","1387","2250","43","132","1430","2382","1"
"6","2017","30","Hotel","10","23","864","1112","98","173","962","1285","1"
"6","2017","30","Hotel","14","31","1628","2979","333","651","1961","3630","5.4"
"6","2017","30","Hotel","3","4","814","3060","70","198","884","3258","1"
"6","2017","30","","11","32","676","843","143","290","819","1133","1"
"6","2017","30","Hotel","6","12","969","1471","76","137","1045","1608","1"
"6","2017","30","Hotel","6","12","2284","2992","241","297","2525","3289","1"
"6","2017","30","Hotel","9","26","3045","3045","65","65","3110","3110","1"
"6","2017","30","Hotel","2","1","788","2364","17","190","805","2554","1"
"6","2017","30","Hotel","9","26","1095","1837","140","367","1235","2204","1"
"6","2017","30","Hotel","6","12","586","975","44","93","630","1068","1"
"6","2017","30","Hotel","14","31","73","92","5816","7604","5889","7696","5.4"
"6","2017","30","Hotel","11","32","269","536","33","69","302","605","1"
"6","2017","30","Hotel","2","6","979","1986","84","144","1063","2130","1"
"6","2017","30","Hotel","16","40","1074","2089","498","760","1572","2849","1"
"6","2017","30","Hotel","14","27","719","1940","496","1642","1215","3582","1"
"6","2017","30","Otros","11","36","98","156","8","12","106","168","1"
"6","2017","30","Hotel","10","23","941","1379","350","711","1291","2090","1"
"6","2017","30","Hotel","14","31","221","503","465","2725","686","3228","7.8"
"6","2017","30","Hotel","7","17","368","711","31","121","399","832","1"
"6","2017","30","Hotel","2","1","2399","2842","229","277","2628","3119","2"
"6","2017","30","Hotel","2","1","1631","2464","131","401","1762","2865","2"
"6","2017","30","Hotel","4","13","889","1590","175","392","1064","1982","1"
"6","2017","30","Hotel","2","1","1914","2066","255","267","2169","2333","2"
"6","2017","30","Hotel","10","27","1554","3892","484","794","2038","4686","1"
"6","2017","30","Hotel","14","27","1111","1662","1123","1685","2234","3347","1"
"6","2017","30","Hotel","14","27","1874","2552","921","2181","2795","4733","1"
"6","2017","30","Hotel","6","12","1186","1803","82","382","1268","2185","1"
"6","2017","30","Hotel","6","12","1302","1600","404","440","1706","2040","1"
"6","2017","30","Hotel","13","27","2258","4606","4","7","2262","4613","1"
"6","2017","30","Hotel","14","31","296","585","1157","3084","1453","3669","7.8"
"6","2017","30","Hotel","6","12","1323","1796","271","365","1594","2161","1"
"6","2017","30","Hotel","16","27","2090","3900","111","200","2201","4100","1"
"6","2017","30","","10","27","2","14","2","6","4","20","1"
"6","2017","30","Hotel","10","18","349","679","198","409","547","1088","1"
"6","2017","30","Hotel","9","37","1726","2581","183","368","1909","2949","1"
"6","2017","30","Hotel","16","27","528","2113","0","0","528","2113","1"
"6","2017","30","Hotel","15","16","896","1569","72","173","968","1742","2"
"6","2017","30","Hotel","2","1","1269","2092","260","428","1529","2520","2"
"6","2017","30","Hotel","3","4","664","1533","94","169","758","1702","1"
"6","2017","30","Hotel","16","40","1426","1935","685","861","2111","2796","1"
"6","2017","30","Hotel","7","17","2985","3643","185","216","3170","3859","1"
"6","2017","30","Hotel","12","24","863","1649","259","611","1122","2260","1"
"6","2017","30","Hotel","12","35","411","719","148","338","559","1057","1"
"6","2017","30","Hotel","2","6","343","592","2","2","345","594","1"
"6","2017","30","Hotel","13","33","1341","1341","87","87","1428","1428","1"
"6","2017","30","Hotel","10","27","1444","2260","562","824","2006","3084","1"
"6","2017","30","Hotel","10","23","1096","1679","185","344","1281","2023","1"
"6","2017","30","Hotel","11","36","1276","1747","114","438","1390","2185","1"
"6","2017","30","Hotel","8","34","1472","1932","40","106","1512","2038","1"
"6","2017","30","Hotel","2","6","500","1398","119","242","619","1640","1"
"6","2017","30","Hotel","14","31","654","942","1186","1843","1840","2785","7.8"
"6","2017","30","Hotel","11","36","1894","2869","74","179","1968","3048","1"
"6","2017","30","","10","27","455","888","236","518","691","1406","1"
"6","2017","30","Hotel","14","31","755","1000","1817","4853","2572","5853","5.4"
"6","2017","30","Hotel","4","13","2126","2138","0","0","2126","2138","1"
"6","2017","30","Hotel","6","28","864","1062","41","75","905","1137","1"
"6","2017","30","Otros","14","31","55","91","405","440","460","531","2.8"
"6","2017","30","Otros","16","27","40","80","0","0","40","80","2"
"6","2017","30","Hotel","2","1","744","1494","33","58","777","1552","2"
"6","2017","30","Hotel","10","18","728","1065","359","525","1087","1590","1"
"6","2017","30","Hotel","7","17","975","1094","55","64","1030","1158","1"
"6","2017","30","Hotel","12","24","517","1231","262","810","779","2041","1"
"6","2017","30","Hotel","10","18","558","939","249","598","807","1537","1"
"6","2017","30","Hotel","2","1","2201","2648","51","71","2252","2719","1"
"6","2017","30","Hotel","10","18","952","1607","207","767","1159","2374","1"
"6","2017","30","Hotel","6","28","1377","1783","290","343","1667","2126","1"
"6","2017","30","Hotel","5","5","777","777","191","191","968","968","1"
"6","2017","30","Hotel","4","13","522","922","31","178","553","1100","1"
"6","2017","30","Hotel","10","18","354","521","169","303","523","824","1"
"6","2017","30","Hotel","16","40","1061","1317","143","173","1204","1490","1"
"6","2017","30","Hotel","8","3","902","2251","271","572","1173","2823","1"
"6","2017","30","Hotel","15","16","1900","3719","774","1572","2674","5291","2"
"6","2017","30","Hotel","14","31","169","295","371","1251","540","1546","7.8"
"6","2017","30","Hotel","13","33","177","197","159","167","336","364","1"
"6","2017","30","Hotel","15","16","1213","1880","126","204","1339","2084","2"
"6","2017","30","Otros","4","21","192","346","0","0","192","346","1"
"6","2017","30","Hotel","6","10","983","1473","19","43","1002","1516","1"
"6","2017","30","Hotel","16","19","72","87","19","19","91","106","1"
"6","2017","30","Hotel","16","27","649","1602","0","0","649","1602","1"
"6","2017","30","Hotel","10","11","1296","2181","54","91","1350","2272","1"
"6","2017","30","Otros","10","23","305","678","7","10","312","688","1"
"6","2017","0","Hotel","12","35","0","0","0","0","0","0","1"
"6","2017","30","Hotel","11","36","542","911","24","55","566","966","1"
"6","2017","30","Hotel","14","31","50","143","1582","3284","1632","3427","17.4"
"6","2017","30","Hotel","10","18","564","1067","173","402","737","1469","3.2"
"6","2017","30","Hotel","4","13","327","592","5","5","332","597","1"
"6","2017","30","Hotel","6","12","277","563","24","51","301","614","5"
"6","2017","30","Hotel","6","10","575","836","25","46","600","882","1"
"6","2017","30","Otros","5","5","139","220","59","82","198","302","3.65625"
"6","2017","30","Hotel","12","24","555","806","154","319","709","1125","1"
"6","2017","30","Hotel","8","3","740","1519","87","175","827","1694","1"
"6","2017","30","Hotel","13","27","651","1144","0","0","651","1144","2.75"
"6","2017","30","Hotel","15","16","689","1603","44","146","733","1749","4"
"6","2017","30","Otros","15","16","177","603","73","249","250","852","2"
"6","2017","30","Otros","16","20","107","146","0","0","107","146","1"
"6","2017","30","Hotel","3","4","552","1104","2","6","554","1110","1"
"6","2017","30","Hotel","11","36","129","158","0","0","129","158","1"
"6","2017","30","Hotel","2","6","342","1138","56","221","398","1359","1"
"6","2017","30","Hotel","8","34","578","1058","126","217","704","1275","1"
"6","2017","30","Hotel","4","13","11","17","0","0","11","17","3.2"
"6","2017","30","Hotel","13","27","1016","2005","0","0","1016","2005","2.75"
"6","2017","30","Hotel","2","29","401","798","585","1098","986","1896","1"
"6","2017","30","Otros","11","36","56","158","0","0","56","158","1"
"6","2017","30","","10","11","0","0","2","2","2","2","1"
"6","2017","30","Hotel","4","13","996","1287","48","124","1044","1411","1"
"6","2017","30","Hotel","16","40","2137","3208","315","475","2452","3683","5.6666666666667"
"6","2017","30","Hotel","10","23","939","1545","221","386","1160","1931","2.8"
"6","2017","30","Hotel","8","34","277","501","124","292","401","793","1"
"6","2017","30","Hotel","5","5","250","600","44","46","294","646","1"
"6","2017","30","Hotel","3","4","38","81","92","161","130","242","3"
"6","2017","30","Hotel","9","26","36","79","3","4","39","83","1"
"6","2017","30","Hotel","8","34","360","509","169","298","529","807","1"
"6","2017","30","Hotel","7","17","138","237","22","42","160","279","4"
"6","2017","30","Hotel","4","13","226","573","27","147","253","720","3.2"
"6","2017","30","Hotel","12","35","6","13","49","190","55","203","1"
"6","2017","30","Hotel","16","40","881","1450","139","292","1020","1742","1"
"6","2017","30","Hotel","9","26","215","389","20","70","235","459","1"
"6","2017","30","","6","27","132","236","8","13","140","249","1"
"6","2017","30","Hotel","9","26","196","281","0","0","196","281","1"
"6","2017","30","Hotel","4","13","139","301","65","145","204","446","3.2"
"6","2017","30","Hotel","6","28","204","249","7","7","211","256","1"
"6","2017","30","","2","29","70","215","344","1114","414","1329","1"
"6","2017","30","Hotel","13","33","1202","1553","71","146","1273","1699","1"
"6","2017","30","Hotel","8","3","179","428","24","35","203","463","1"
"6","2017","30","Hotel","14","27","414","493","810","1399","1224","1892","1"
"6","2017","30","Hotel","16","40","255","513","0","0","255","513","5.6666666666667"
"6","2017","30","Hotel","12","24","160","251","166","339","326","590","1"
"6","2017","30","Hotel","10","18","1049","1416","109","156","1158","1572","3.2"
"6","2017","30","Otros","15","16","44","45","2","2","46","47","9"
"6","2017","30","Hotel","6","10","558","582","0","0","558","582","1"
"6","2017","30","Hotel","10","11","612","935","21","75","633","1010","1"
"6","2017","30","Otros","6","10","87","196","0","0","87","196","3.8518518518518"
"6","2017","30","Otros","10","23","135","358","12","36","147","394","1"
"6","2017","30","Hotel","10","23","355","529","125","235","480","764","2.8"
"6","2017","30","Hotel","6","12","110","193","0","0","110","193","5"
"6","2017","30","Hotel","6","27","81","126","0","0","81","126","3"
"6","2017","30","Hotel","10","23","512","780","133","247","645","1027","2.8"
"6","2017","30","","4","39","155","403","0","0","155","403","1"
"6","2017","30","Hotel","8","34","350","461","305","446","655","907","1"
"6","2017","30","Hotel","8","34","567","881","127","172","694","1053","1"
"6","2017","30","Otros","4","39","7","8","0","0","7","8","2.2222222222222"
"6","2017","30","Otros","13","14","118","236","0","0","118","236","1"
"6","2017","30","Hotel","10","23","184","352","6","13","190","365","2.8"
"6","2017","30","Otros","13","14","360","1160","0","0","360","1160","1"
"6","2017","30","Hotel","12","24","297","462","368","604","665","1066","1"
"6","2017","30","","6","25","24","58","0","0","24","58","1"
"6","2017","30","Hotel","15","27","500","828","1","7","501","835","1"
"6","2017","0","Hotel","12","35","0","0","0","0","0","0","1"
"6","2017","30","Hotel","16","40","415","1858","0","0","415","1858","1"
"6","2017","30","Hotel","16","27","178","425","490","1469","668","1894","1"
"6","2017","30","Hotel","9","30","59","135","0","0","59","135","1"
"6","2017","30","Hotel","4","13","263","563","82","174","345","737","3.2"
"6","2017","30","Hotel","2","29","162","344","129","405","291","749","1"
"6","2017","30","Hotel","16","20","433","769","14","20","447","789","1"
"6","2017","30","Hotel","5","5","537","624","45","99","582","723","1"
"6","2017","30","Hotel","13","33","722","1140","83","157","805","1297","1"
"6","2017","30","Otros","16","19","76","87","0","0","76","87","1.3333333333333"
"6","2017","30","Hotel","12","24","148","339","200","481","348","820","1"
"6","2017","30","","8","2","419","746","22","36","441","782","1"
"6","2017","0","Hotel","12","35","0","0","0","0","0","0","1"
"6","2017","30","Hotel","16","27","23","38","167","209","190","247","2.5"
"6","2017","30","Otros","16","27","321","585","10","14","331","599","2"
"6","2017","30","Hotel","8","34","326","559","84","198","410","757","1"
"6","2017","30","Otros","8","3","0","0","0","0","0","0","1"
"6","2017","30","Hotel","7","27","212","293","56","104","268","397","1"
"6","2017","30","Hotel","4","39","231","360","0","0","231","360","1"
"6","2017","30","Hotel","15","16","121","241","19","54","140","295","4"
"6","2017","30","Hotel","4","39","3","8","0","0","3","8","1"
"6","2017","30","Hotel","4","39","169","288","8","15","177","303","1"
"6","2017","30","Hotel","15","16","140","402","5","5","145","407","4"
"6","2017","30","Hotel","14","31","269","459","257","648","526","1107","17.4"
"6","2017","30","Hotel","8","34","228","432","98","156","326","588","1"
"6","2017","30","Hotel","6","28","217","277","4","4","221","281","1"
"6","2017","30","Hotel","7","17","623","1083","10","26","633","1109","4"
"6","2017","30","Otros","7","27","1","3","0","0","1","3","1"
"6","2017","30","Hotel","11","36","1124","1468","14","36","1138","1504","1"
"6","2017","30","Otros","4","21","242","423","49","50","291","473","1"
"6","2017","30","Otros","15","16","82","111","19","48","101","159","2"
"6","2017","30","Otros","7","17","148","308","0","0","148","308","3"
"6","2017","30","Hotel","7","38","105","107","6","6","111","113","1"
"6","2017","30","Hotel","16","27","501","579","38","87","539","666","2.5"
"6","2017","30","Hotel","2","6","81","128","1","1","82","129","2.2"
"6","2017","30","Hotel","11","36","241","440","32","67","273","507","1"
"6","2017","30","Hotel","6","28","67","89","0","0","67","89","1"
"6","2017","30","Hotel","6","12","72","97","0","0","72","97","5"
"6","2017","30","Otros","9","22","16","40","0","0","16","40","1"
"6","2017","30","","13","14","90","142","3","6","93","148","2"
"6","2017","30","Hotel","2","29","82","202","78","236","160","438","1"
"6","2017","30","Hotel","2","29","3","5","8","9","11","14","1"
"6","2017","30","Otros","4","13","310","322","8","8","318","330","1"
"6","2017","30","Hotel","15","16","112","192","29","66","141","258","4"
"6","2017","30","Hotel","2","1","128","378","0","0","128","378","6.4"
"6","2017","30","Otros","7","27","41","66","0","0","41","66","1"
"6","2017","30","Otros","13","33","46","86","0","0","46","86","5.125"
"6","2017","30","","4","21","298","398","0","0","298","398","1"
"6","2017","30","Hotel","6","10","363","363","4","4","367","367","1"
"6","2017","30","Hotel","11","36","66","192","0","0","66","192","1"
"6","2017","30","Otros","14","31","36","75","135","254","171","329","2.8"
"6","2017","30","Hotel","7","27","131","224","5","15","136","239","1"
"6","2017","30","Otros","6","10","48","142","1","1","49","143","3.8518518518518"
"6","2017","30","Hotel","4","39","32","36","2","2","34","38","2.6"
"6","2017","11","Otros","8","2","0","0","2","4","2","4","6.4285714285714"
"6","2017","30","Otros","11","36","23","47","5","10","28","57","5.1904761904762"
"6","2017","30","Hotel","13","33","30","30","0","0","30","30","1"
"6","2017","30","","3","4","140","238","60","76","200","314","1"
"6","2017","30","Hotel","7","17","311","739","16","33","327","772","4"
"6","2017","30","Hotel","8","2","136","174","7","9","143","183","1"
"6","2017","30","Otros","15","16","151","261","20","42","171","303","2"
"6","2017","30","Hotel","10","11","219","302","1","3","220","305","1"
"6","2017","30","Hotel","16","19","179","244","0","0","179","244","1"
"6","2017","30","Hotel","10","23","106","225","12","23","118","248","4"
"6","2017","30","","7","38","195","285","13","35","208","320","1"
"6","2017","30","Hotel","7","27","43","86","0","0","43","86","1"
"6","2017","30","Hotel","11","36","465","990","44","113","509","1103","1"
"6","2017","30","Hotel","16","40","168","249","11","18","179","267","16.333333333333"
"6","2017","20","Hotel","16","19","0","0","0","0","0","0","1"
"6","2017","30","Hotel","16","19","0","0","0","0","0","0","1"
"6","2017","30","Hotel","16","20","0","0","0","0","0","0","1"
"6","2017","30","Hotel","10","11","193","281","18","48","211","329","1"
"6","2017","30","Otros","7","27","67","149","1","1","68","150","4.8333333333333"
"6","2017","30","Otros","7","27","28","100","0","0","28","100","1"
"6","2017","30","Hotel","7","27","38","59","2","4","40","63","4.1666666666667"
"6","2017","30","Otros","13","14","35","47","0","0","35","47","1"
"6","2017","30","Otros","11","15","43","53","0","0","43","53","2.3571428571429"
"6","2017","30","Otros","10","27","12","24","8","8","20","32","4.84"
"6","2017","30","Otros","14","31","102","102","2325","2325","2427","2427","2.8"
"6","2017","30","Otros","11","36","14","20","1","1","15","21","5.1904761904762"
"6","2017","30","Hotel","16","19","34","40","0","0","34","40","1"
"6","2017","30","","14","27","67","94","25","32","92","126","2.6666666666667"
"6","2017","30","Hotel","16","40","66","70","4","4","70","74","5.6666666666667"
"6","2017","30","Hotel","10","27","9","23","0","0","9","23","2.25"
"6","2017","30","Otros","2","29","54","91","107","346","161","437","3.28"
"6","2017","30","Hotel","13","27","6","6","9","9","15","15","1"
"6","2017","30","Otros","9","22","11","11","0","0","11","11","1"
"6","2017","30","Hotel","2","27","89","157","6","26","95","183","1"
"6","2017","30","Hotel","8","34","209","283","407","486","616","769","1"
"6","2017","30","Hotel","7","27","245","404","0","0","245","404","1"
"6","2017","30","Hotel","15","16","203","435","33","77","236","512","4"
"6","2017","30","Hotel","16","20","48","59","3","4","51","63","1"
"6","2017","30","Otros","4","13","33","223","0","0","33","223","1"
"6","2017","30","Hotel","2","1","163","502","5","32","168","534","6.4"
"6","2017","30","Otros","11","32","7","12","0","0","7","12","2.2857142857143"
"6","2017","30","Hotel","2","29","22","173","89","643","111","816","1"
"6","2017","30","Hotel","16","27","151","162","68","86","219","248","2.5"
"6","2017","30","Hotel","10","18","270","1027","0","0","270","1027","3.2"
"6","2017","30","Otros","11","36","308","572","0","0","308","572","1"
"6","2017","30","Otros","13","14","26","70","0","0","26","70","1"
"6","2017","30","Hotel","7","27","136","176","0","0","136","176","1"
"6","2017","30","Otros","7","17","136","371","4","16","140","387","3"
"6","2017","30","Otros","14","31","293","393","110","210","403","603","2.8"
"6","2017","30","Hotel","2","29","150","447","268","904","418","1351","1"
"6","2017","30","Hotel","8","3","52","604","46","82","98","686","1"
"6","2017","30","Hotel","8","34","261","427","49","81","310","508","2.5714285714286"
"6","2017","30","Hotel","8","34","262","323","76","169","338","492","2.5714285714286"
"6","2017","30","Hotel","12","35","147","179","109","140","256","319","1"
"6","2017","30","Hotel","11","32","142","310","13","24","155","334","1"
"6","2017","30","Hotel","13","33","172","263","8","8","180","271","2"
"6","2017","30","Hotel","10","23","175","288","25","50","200","338","2.8"
"6","2017","30","Hotel","12","35","129","148","8","8","137","156","1"
"6","2017","30","","16","40","183","235","19","21","202","256","3.0555555555556"
"6","2017","30","Otros","16","19","3","4","0","0","3","4","1.3333333333333"
"6","2017","30","Otros","16","20","12","96","0","0","12","96","1"
"6","2017","30","Hotel","6","12","223","460","12","23","235","483","5"
"6","2017","30","Hotel","16","19","95","106","0","0","95","106","4"
"6","2017","30","Hotel","12","24","76","250","108","251","184","501","1"
"6","2017","30","Hotel","12","24","128","312","32","43","160","355","3"
"6","2017","0","Hotel","8","3","0","0","0","0","0","0","1"
"6","2017","30","Hotel","5","9","0","0","0","0","0","0","1"
"6","2017","30","Hotel","16","27","297","544","5","18","302","562","2.5"
"6","2017","30","Otros","10","23","30","30","0","0","30","30","7"
"6","2017","30","Otros","13","14","38","50","0","0","38","50","7.3846153846154"
"6","2017","30","Otros","2","6","45","133","16","36","61","169","1"
"6","2017","17","Hotel","15","16","8","11","80","101","88","112","7.8"
"6","2017","30","Hotel","8","3","194","892","0","0","194","892","1"
"6","2017","30","Hotel","8","34","330","599","135","157","465","756","1"
"6","2017","30","Hotel","8","3","54","66","14","18","68","84","1"
"6","2017","30","","2","29","68","119","31","73","99","192","1"
"6","2017","30","Hotel","2","1","228","384","6","8","234","392","6.4"
"6","2017","30","Hotel","7","17","92","152","2","10","94","162","4"
"6","2017","30","Otros","7","17","165","408","0","0","165","408","3"
"6","2017","30","Hotel","16","40","57","83","23","52","80","135","5.6666666666667"
"6","2017","30","Hotel","12","24","115","227","58","82","173","309","1"
"6","2017","30","Hotel","14","31","197","409","173","599","370","1008","17.4"
"6","2017","0","Hotel","9","26","0","0","0","0","0","0","1"
"6","2017","30","Hotel","6","12","237","381","15","22","252","403","5"
"6","2017","30","Otros","5","9","11","11","0","0","11","11","4.0454545454545"
"6","2017","30","Otros","5","9","9","9","2","2","11","11","4.0454545454545"
"6","2017","30","Otros","15","27","64","72","0","0","64","72","1.4222222222222"
"6","2017","30","Hotel","8","34","2","2","2","2","4","4","2.5714285714286"
"6","2017","30","Hotel","10","18","268","555","51","107","319","662","7.75"
"6","2017","30","Hotel","15","16","310","593","42","82","352","675","7.8"
"6","2017","23","Hotel","2","29","94","215","94","271","188","486","1"
"6","2017","30","Hotel","4","39","109","229","1","4","110","233","2.6"
"6","2017","30","Otros","4","39","109","158","3","18","112","176","2.2222222222222"
"6","2017","30","Hotel","4","13","108","246","11","46","119","292","5.4"
"6","2017","30","Otros","10","23","59","94","0","0","59","94","7"
"6","2017","30","Otros","14","31","87","129","165","631","252","760","20.2"
"6","2017","30","Hotel","3","4","51","62","10","14","61","76","2.6"
"6","2017","30","Hotel","10","23","67","143","10","20","77","163","4"
"6","2017","30","Otros","9","22","152","1059","4","8","156","1067","1"
"6","2017","30","Hotel","12","24","154","359","64","118","218","477","3"
"6","2017","30","Hotel","13","14","9","11","0","0","9","11","1"
"6","2017","30","Hotel","12","35","116","301","46","61","162","362","1.7272727272727"
"6","2017","30","Hotel","6","28","452","658","0","0","452","658","1"
"6","2017","30","","6","28","40","71","0","0","40","71","1"
"6","2017","30","Hotel","12","24","169","415","86","217","255","632","3"
"6","2017","30","Otros","5","9","11","30","1","3","12","33","4.0454545454545"
"6","2017","30","Hotel","16","20","29","33","1","1","30","34","1"
"6","2017","30","Hotel","4","21","157","220","64","64","221","284","3"
"6","2017","30","Otros","10","11","16","33","0","0","16","33","11.764705882353"
"6","2017","30","Otros","13","14","4","11","0","0","4","11","7.3846153846154"
"6","2017","30","Otros","16","27","22","22","0","0","22","22","13.818181818182"
"6","2017","12","Hotel","9","26","323","323","0","0","323","323","1"
"6","2017","30","Hotel","16","27","203","425","87","169","290","594","2.5"
"6","2017","30","Hotel","3","4","1165","1725","381","753","1546","2478","3"
"6","2017","30","Otros","16","27","50","50","0","0","50","50","2"
"6","2017","30","Otros","16","19","363","444","0","0","363","444","1.3333333333333"
"6","2017","30","Hotel","6","12","482","666","31","33","513","699","5"
"6","2017","30","Hotel","2","1","220","511","4","4","224","515","6.4"
"6","2017","30","Hotel","10","11","295","413","3","4","298","417","1"
"6","2017","30","Otros","10","23","81","81","0","0","81","81","1"
"6","2017","30","Otros","10","27","395","489","46","63","441","552","4.84"
"6","2017","30","Hotel","16","27","126","213","5","5","131","218","2.5"
"6","2017","30","Hotel","6","28","112","139","3","3","115","142","1"
"6","2017","30","Hotel","4","13","76","175","2","20","78","195","5.4"
"6","2017","30","Hotel","14","27","495","618","14","15","509","633","8.5"
"6","2017","30","Hotel","10","27","101","187","140","156","241","343","1"
"6","2017","30","Hotel","13","27","65","95","56","68","121","163","4.2"
"6","2017","30","Hotel","3","4","583","888","9","16","592","904","3"
"6","2017","30","Otros","4","13","62","68","0","0","62","68","3.4"
"6","2017","30","Otros","11","15","20","66","0","0","20","66","2.3571428571429"
"6","2017","30","Otros","6","10","184","444","97","291","281","735","3.8518518518518"
"6","2017","30","Otros","2","1","55","66","2","2","57","68","1"
"6","2017","30","","6","12","48","117","0","0","48","117","1"
"6","2017","30","Otros","10","23","230","764","0","0","230","764","1"
"6","2017","30","Hotel","16","19","82","135","0","0","82","135","4"
"6","2017","30","Hotel","10","11","3","9","0","0","3","9","5.6666666666667"
"6","2017","30","Hotel","10","23","48","48","4","4","52","52","4"
"6","2017","30","Otros","14","31","89","138","189","379","278","517","2.8"
"6","2017","30","Otros","13","27","4","4","0","0","4","4","12.2"
"6","2017","30","Hotel","2","1","211","743","0","0","211","743","6.4"
"6","2017","30","Hotel","16","19","22","26","0","0","22","26","4"
"6","2017","30","Otros","12","35","9","13","1","3","10","16","3.5"
"6","2017","30","Otros","15","16","88","179","6","26","94","205","2"
"6","2017","30","Otros","9","22","111","222","36","72","147","294","1"
"6","2017","30","Hotel","10","27","221","332","303","349","524","681","1"
"6","2017","30","Hotel","2","27","74","91","8","11","82","102","3.6"
"6","2017","30","Hotel","16","20","69","186","27","56","96","242","1"
"6","2017","30","Hotel","10","18","133","265","26","56","159","321","7.75"
"6","2017","30","Hotel","6","12","180","196","0","0","180","196","5"
"6","2017","30","Hotel","2","27","45","96","0","0","45","96","3.6"
"6","2017","30","Hotel","15","16","94","177","6","11","100","188","7.8"
"6","2017","30","Hotel","10","23","99","99","26","26","125","125","4"
"6","2017","30","Hotel","11","32","26","30","0","0","26","30","1"
"6","2017","30","Hotel","14","27","77","253","34","98","111","351","8.5"
"6","2017","30","Otros","10","11","15","15","0","0","15","15","11.764705882353"
"6","2017","30","Hotel","2","27","78","168","8","13","86","181","3.6"
"6","2017","30","Otros","13","14","126","215","3","6","129","221","7.3846153846154"
"6","2017","30","Hotel","2","1","129","197","0","0","129","197","6.4"
"6","2017","30","Otros","7","17","218","540","2","2","220","542","17.166666666667"
"6","2017","30","Otros","10","23","24","165","0","0","24","165","7"
"6","2017","30","Hotel","13","27","167","167","0","0","167","167","2.75"
"6","2017","30","Otros","10","18","10","16","0","0","10","16","10.25"
"6","2017","30","Otros","5","9","8","240","0","0","8","240","4.0454545454545"
"6","2017","30","Hotel","4","39","37","51","10","26","47","77","2.6"
"6","2017","30","Otros","16","27","37","183","0","0","37","183","13.818181818182"
"6","2017","30","Hotel","14","27","16","24","41","151","57","175","8.5"
"6","2017","30","Hotel","10","11","51","84","10","16","61","100","5.6666666666667"
"6","2017","30","Hotel","10","18","91","167","20","36","111","203","7.75"
"6","2017","30","Otros","14","31","162","184","144","200","306","384","20.2"
"6","2017","30","Otros","11","32","14","30","0","0","14","30","2.2857142857143"
"6","2017","30","Otros","5","5","63","63","0","0","63","63","3.65625"
"6","2017","30","Otros","6","25","31","56","0","0","31","56","2.3846153846154"
"6","2017","30","Hotel","3","4","26","116","4","9","30","125","2.6"
"6","2017","30","Otros","7","27","50","83","0","0","50","83","4.8333333333333"
"6","2017","30","Otros","2","29","30","61","43","103","73","164","3.28"
"6","2017","30","Hotel","2","29","70","102","125","218","195","320","1"
"6","2017","30","Otros","4","21","31","49","0","0","31","49","1"
"6","2017","30","Hotel","7","27","215","215","0","0","215","215","4.1666666666667"
"6","2017","30","Otros","5","5","8","47","1","3","9","50","3.65625"
"6","2017","30","Otros","11","36","33","50","5","11","38","61","5.1904761904762"
"6","2017","30","Hotel","7","27","320","320","0","0","320","320","4.1666666666667"
"6","2017","30","Hotel","16","20","0","0","0","0","0","0","1"
"6","2017","30","Hotel","12","24","103","179","25","42","128","221","3"
"6","2017","30","Hotel","9","26","77","136","5","9","82","145","1.5"
"6","2017","30","Hotel","7","17","129","242","7","35","136","277","10"
"6","2017","30","Hotel","9","37","174","265","11","22","185","287","3.4"
"6","2017","30","Hotel","5","5","167","331","35","47","202","378","2.1428571428571"
"6","2017","30","Otros","6","27","32","64","0","0","32","64","3.960088691796"
"6","2017","30","Hotel","9","37","42","43","13","20","55","63","3.4"
"6","2017","30","Otros","10","27","33","57","0","0","33","57","4.84"
"6","2017","30","Otros","8","3","190","366","4","12","194","378","10"
"6","2017","30","Otros","16","20","4","4","0","0","4","4","3.0769230769231"
"6","2017","30","Otros","9","22","39","88","1","2","40","90","7.6428571428571"
"6","2017","30","Otros","10","27","164","218","4","4","168","222","4.84"
"6","2017","30","Otros","10","23","42","52","0","0","42","52","7"
"6","2017","30","Otros","2","6","311","317","62","62","373","379","1"
"6","2017","30","Otros","4","39","20","32","1","1","21","33","2.2222222222222"
"6","2017","30","Hotel","2","27","46","51","1","1","47","52","1"
"6","2017","30","Hotel","14","31","36","53","96","461","132","514","24"
"6","2017","30","Otros","2","29","43","82","22","43","65","125","3.28"
"6","2017","30","Otros","8","3","440","2200","0","0","440","2200","10"
"6","2017","30","","13","14","25","33","0","0","25","33","1"
"6","2017","30","Hotel","6","10","123","181","7","13","130","194","6.6"
"6","2017","30","Hotel","8","34","199","299","31","35","230","334","2.5714285714286"
"6","2017","30","Hotel","9","22","294","1468","0","0","294","1468","2.5555555555556"
"6","2017","30","Hotel","2","6","33","90","20","48","53","138","2.2"
"6","2017","30","Hotel","10","27","121","217","104","125","225","342","2.25"
"6","2017","30","Otros","14","27","108","108","0","0","108","108","11.833333333333"
"6","2017","30","Otros","6","12","273","429","0","0","273","429","1.8256578947368"
"6","2017","30","Hotel","6","27","197","351","0","0","197","351","3"
"6","2017","30","Hotel","5","5","13","20","18","28","31","48","2.1428571428571"
"6","2017","30","Hotel","5","5","47","88","4","16","51","104","2.1428571428571"
"6","2017","30","Hotel","13","27","355","455","0","0","355","455","4.2"
"6","2017","30","Hotel","2","27","124","180","2","4","126","184","3.6"
"6","2017","30","Hotel","8","3","46","46","37","37","83","83","4.1111111111111"
"6","2017","30","Otros","11","36","39","136","3","18","42","154","5.1904761904762"
"6","2017","30","Otros","9","30","44","88","0","0","44","88","2.3333333333333"
"6","2017","30","Otros","16","19","1","2","0","0","1","2","10.263157894737"
"6","2017","30","Hotel","14","31","50","80","335","925","385","1005","17.4"
"6","2017","30","Hotel","2","1","353","411","9","13","362","424","6.4"
"6","2017","30","Hotel","16","40","707","1280","283","346","990","1626","5.6666666666667"
"6","2017","30","Otros","7","17","180","269","0","0","180","269","17.166666666667"
"6","2017","30","Hotel","13","27","352","560","108","164","460","724","2.75"
"6","2017","30","Hotel","14","31","149","192","333","504","482","696","24"
"6","2017","30","Otros","3","4","26","78","5","17","31","95","12.2"
"6","2017","30","Otros","8","34","172","217","146","233","318","450","5.75"
"6","2017","30","Hotel","9","22","52","63","2","2","54","65","2.5555555555556"
"6","2017","30","Hotel","4","21","53","93","1","2","54","95","3"
"6","2017","30","Hotel","6","27","84","142","0","0","84","142","3"
"6","2017","30","Hotel","12","35","96","115","8","11","104","126","1.7272727272727"
"6","2017","30","Hotel","2","29","8","22","12","20","20","42","2"
"6","2017","30","Otros","10","11","37","47","8","10","45","57","11.764705882353"
"6","2017","30","Hotel","6","10","58","156","0","0","58","156","6.6"
"6","2017","30","Hotel","13","14","44","61","0","0","44","61","2"
"6","2017","30","Otros","16","27","15","16","0","0","15","16","13.818181818182"
"6","2017","30","Otros","6","27","21","21","0","0","21","21","3.960088691796"
"6","2017","30","Hotel","16","40","99","193","247","479","346","672","5.6666666666667"
"6","2017","30","Otros","6","10","88","154","10","80","98","234","3.8518518518518"
"6","2017","30","Otros","10","23","48","87","14","19","62","106","7"
"6","2017","30","Hotel","6","28","275","330","6","6","281","336","1"
"6","2017","30","Otros","7","38","122","208","63","137","185","345","2.75"
"6","2017","30","Hotel","6","12","285","425","0","0","285","425","5"
"6","2017","30","Hotel","13","27","216","315","0","0","216","315","4.2"
"6","2017","30","Otros","4","21","11","25","0","0","11","25","4.8333333333333"
"6","2017","30","Hotel","16","27","70","185","6","6","76","191","5.8571428571429"
"6","2017","30","Hotel","5","5","45","85","13","21","58","106","2.1428571428571"
"6","2017","30","Otros","12","24","39","79","32","45","71","124","9.2"
"6","2017","30","Otros","15","16","49","71","7","9","56","80","9"
"6","2017","30","Hotel","8","27","72","72","2","2","74","74","4.5"
"6","2017","30","Hotel","9","22","3","5","0","0","3","5","2.5555555555556"
"6","2017","30","Hotel","10","11","157","225","2","4","159","229","5.6666666666667"
"6","2017","30","Hotel","8","3","38","77","0","0","38","77","4.1111111111111"
"6","2017","30","Hotel","6","10","455","893","2","23","457","916","6.6"
"6","2017","30","Otros","9","26","22","50","0","0","22","50","3.8888888888889"
"6","2017","30","Hotel","4","39","64","127","8","102","72","229","2.6"
"6","2017","30","Otros","6","27","2","3","0","0","2","3","3.960088691796"
"6","2017","30","Otros","6","12","118","168","0","0","118","168","1.8256578947368"
"6","2017","30","Hotel","6","27","53","103","2","2","55","105","3"
"6","2017","30","Otros","5","9","44","63","13","32","57","95","4.0454545454545"
"6","2017","30","Hotel","2","27","112","124","10","14","122","138","3.6"
"6","2017","0","Hotel","2","29","0","0","0","0","0","0","1"
"6","2017","30","Hotel","4","13","11","28","3","6","14","34","5.4"
"6","2017","30","","11","15","14","280","0","0","14","280","1"
"6","2017","30","Hotel","6","10","218","256","16","20","234","276","6.6"
"6","2017","30","Otros","6","12","27","91","0","0","27","91","1.8256578947368"
"6","2017","30","Otros","10","18","74","74","6","6","80","80","10.25"
"6","2017","30","Otros","9","22","108","169","2","4","110","173","7.6428571428571"
"6","2017","30","","14","27","66","121","61","88","127","209","1"
"6","2017","30","Hotel","16","27","113","121","3","3","116","124","5.8571428571429"
"6","2017","30","Otros","2","29","17","39","15","23","32","62","3.28"
"6","2017","30","Otros","13","33","33","33","0","0","33","33","5.125"
"6","2017","30","Otros","13","33","15","15","5","5","20","20","5.125"
"6","2017","30","Otros","6","10","89","364","0","0","89","364","3.8518518518518"
"6","2017","30","Hotel","10","18","36","75","10","22","46","97","7.75"
"6","2017","30","Hotel","14","31","98","134","20","65","118","199","24"
"6","2017","30","Hotel","4","21","62","70","0","0","62","70","3"
"6","2017","30","Hotel","3","4","49","257","0","0","49","257","2.6"
"6","2017","0","Otros","8","27","0","0","0","0","0","0","1"
"6","2017","30","Otros","6","27","7","33","0","0","7","33","3.960088691796"
"6","2017","30","Hotel","6","25","385","448","0","0","385","448","1"
"6","2017","30","Otros","6","12","198","368","1","1","199","369","1.8256578947368"
"6","2017","30","Hotel","6","27","13","13","0","0","13","13","3"
"6","2017","30","Otros","6","27","2","4","0","0","2","4","3.960088691796"
"6","2017","30","Otros","6","10","64","108","0","0","64","108","3.8518518518518"
"6","2017","30","Otros","6","12","59","123","0","0","59","123","1.8256578947368"
"6","2017","30","Otros","5","5","11","17","0","0","11","17","3.65625"
"6","2017","30","Hotel","12","24","194","422","3","6","197","428","3"
"6","2017","30","Hotel","15","16","36","86","0","0","36","86","7.8"
"6","2017","18","Otros","4","13","12","15","0","0","12","15","3.4"
"6","2017","30","Hotel","2","29","168","425","39","140","207","565","1"
"6","2017","30","Hotel","4","21","8","20","0","0","8","20","3"
"6","2017","30","Hotel","10","27","300","439","117","125","417","564","2.25"
"6","2017","30","Hotel","8","3","94","160","25","42","119","202","4.1111111111111"
"6","2017","30","Hotel","12","27","36","95","13","28","49","123","1"
"6","2017","30","Otros","5","5","73","114","17","41","90","155","3.65625"
"6","2017","30","Otros","13","14","11","12","0","0","11","12","7.3846153846154"
"6","2017","30","Otros","10","11","84","106","0","0","84","106","11.764705882353"
"6","2017","30","Otros","16","40","121","170","5","26","126","196","28.142857142857"
"6","2017","30","Hotel","11","36","116","250","6","14","122","264","1"
"6","2017","30","Otros","8","34","107","125","28","38","135","163","5.75"
"6","2017","30","Hotel","7","17","78","97","10","16","88","113","10"
"6","2017","30","Otros","12","35","144","252","6","8","150","260","3.5"
"6","2017","30","Otros","5","9","17","50","1","1","18","51","4.0454545454545"
"6","2017","30","Hotel","9","22","20","26","0","0","20","26","2.5555555555556"
"6","2017","30","Otros","2","29","18","35","22","46","40","81","3.28"
"6","2017","30","Otros","2","29","50","112","56","130","106","242","3.28"
"6","2017","30","Hotel","10","27","100","199","17","25","117","224","2.25"
"6","2017","30","Hotel","16","19","88","131","15","42","103","173","4"
"6","2017","30","Hotel","16","40","162","318","18","36","180","354","16.333333333333"
"6","2017","30","Hotel","8","27","147","234","23","23","170","257","4.5"
"6","2017","30","Otros","13","14","39","366","0","0","39","366","7.3846153846154"
"6","2017","30","Hotel","7","27","18","19","0","0","18","19","4.1666666666667"
"6","2017","30","Otros","2","6","1","1","0","0","1","1","5"
"6","2017","30","Hotel","7","17","213","387","9","9","222","396","10"
"6","2017","30","Hotel","3","4","137","251","26","53","163","304","2.6"
"6","2017","30","Otros","6","12","14","78","0","0","14","78","1.8256578947368"
"6","2017","30","Otros","6","10","4","4","0","0","4","4","3.8518518518518"
"6","2017","30","Hotel","16","40","24","40","4","12","28","52","16.333333333333"
"6","2017","30","Otros","4","39","35","155","2","2","37","157","2.2222222222222"
"6","2017","8","Otros","13","14","9","12","0","0","9","12","7.3846153846154"
"6","2017","30","Otros","7","38","65","98","13","18","78","116","2.75"
"6","2017","30","Hotel","11","32","73","123","0","0","73","123","1"
"6","2017","30","Otros","11","36","99","215","7","12","106","227","5.1904761904762"
"6","2017","30","Hotel","4","21","33","39","0","0","33","39","3"
"6","2017","30","Otros","3","4","20","60","0","0","20","60","12.2"
"6","2017","30","Otros","5","9","5","7","7","7","12","14","4.0454545454545"
"6","2017","30","Hotel","8","27","71","117","0","0","71","117","4.5"
"6","2017","30","","7","17","88","159","0","0","88","159","1"
"6","2017","30","Otros","16","20","10","32","0","0","10","32","3.0769230769231"
"6","2017","30","Otros","4","21","73","135","0","0","73","135","4.8333333333333"
"6","2017","30","Otros","13","33","41","43","1","1","42","44","5.125"
"6","2017","0","","12","35","0","0","0","0","0","0","1"
"6","2017","30","Hotel","13","33","0","0","3","3","3","3","2"
"6","2017","30","Otros","4","39","13","22","0","0","13","22","2.2222222222222"
"6","2017","30","Otros","10","18","4","10","0","0","4","10","10.25"
"6","2017","30","Otros","6","27","86","137","10","10","96","147","3.960088691796"
"6","2017","30","Hotel","4","39","71","185","0","0","71","185","2.6"
"6","2017","30","Otros","14","31","42","86","109","205","151","291","20.2"
"6","2017","30","Hotel","2","29","31","66","35","78","66","144","2"
"6","2017","30","Hotel","9","26","202","350","2","2","204","352","1.5"
"6","2017","30","Otros","12","35","5","6","3","5","8","11","3.5"
"6","2017","30","Hotel","14","27","91","134","61","76","152","210","8.5"
"6","2017","30","Otros","11","36","37","65","0","0","37","65","5.1904761904762"
"6","2017","30","Otros","16","20","75","175","3","13","78","188","3.0769230769231"
"6","2017","30","Otros","4","39","9","16","0","0","9","16","2.2222222222222"
"6","2017","30","Otros","7","27","118","141","5","5","123","146","4.8333333333333"
"6","2017","30","Otros","6","27","58","115","0","0","58","115","3.960088691796"
"6","2017","30","Otros","5","8","8","240","0","0","8","240","5"
"6","2017","30","Otros","9","37","125","215","5","5","130","220","4.5"
"6","2017","30","Hotel","2","6","52","261","0","0","52","261","5.5"
"6","2017","30","Hotel","10","27","325","620","151","200","476","820","2.25"
"6","2017","30","Hotel","9","30","91","178","5","8","96","186","1"
"6","2017","30","Otros","4","13","34","130","3","4","37","134","3.4"
"6","2017","30","Hotel","5","5","313","313","13","13","326","326","1"
"6","2017","30","Otros","7","38","51","106","0","0","51","106","2.75"
"6","2017","30","Hotel","13","14","19","29","0","0","19","29","1"
"6","2017","30","Otros","5","9","9","16","0","0","9","16","4.0454545454545"
"6","2017","30","Otros","5","8","1","1","0","0","1","1","5"
"6","2017","30","Otros","10","27","16","450","0","0","16","450","4.84"
"6","2017","30","Hotel","13","14","3","6","0","0","3","6","1"
"6","2017","30","Otros","11","15","21","66","0","0","21","66","2.3571428571429"
"6","2017","30","Hotel","9","22","284","594","0","0","284","594","2.5555555555556"
"6","2017","30","Otros","11","36","81","139","10","10","91","149","5.1904761904762"
"6","2017","30","Hotel","10","18","2245","4215","799","1750","3044","5965","1"
"6","2017","30","Hotel","6","12","174","347","0","0","174","347","5"
"6","2017","30","","2","29","449","1140","97","328","546","1468","1"
"6","2017","30","Hotel","16","27","871","2535","26","73","897","2608","1"
"6","2017","30","","14","31","263","585","388","1642","651","2227","1"
"6","2017","30","Hotel","8","3","10","12","2","2","12","14","4.1111111111111"
"6","2017","30","Otros","13","33","81","119","2","4","83","123","5.125"
"6","2017","30","","14","27","34","43","5","6","39","49","2.6666666666667"
"6","2017","30","Otros","9","22","14","31","0","0","14","31","7.6428571428571"
"6","2017","30","Hotel","10","11","10","12","4","8","14","20","5.6666666666667"
"6","2017","30","Otros","6","12","12","12","0","0","12","12","1.8256578947368"
"6","2017","30","Hotel","8","3","47","56","8","17","55","73","4.1111111111111"
"6","2017","30","Otros","6","12","151","211","0","0","151","211","1.8256578947368"
"6","2017","30","Hotel","8","27","133","133","0","0","133","133","4.5"
"6","2017","30","Hotel","6","28","198","255","0","0","198","255","2.4"
"6","2017","30","Otros","6","25","28","148","0","0","28","148","2.3846153846154"
"6","2017","30","Otros","6","25","49","63","0","0","49","63","2.3846153846154"
"6","2017","30","Hotel","11","36","540","1448","0","0","540","1448","1"
"6","2017","30","Otros","2","6","25","62","153","486","178","548","5"
"6","2017","30","Hotel","14","31","45","79","94","347","139","426","24"
"6","2017","30","Otros","4","21","17","37","0","0","17","37","4.8333333333333"
"6","2017","30","Otros","7","38","6","6","0","0","6","6","2.75"
"6","2017","30","Otros","13","14","14","14","0","0","14","14","7.3846153846154"
"6","2017","30","Otros","2","29","33","53","35","57","68","110","3.28"
"6","2017","30","Otros","3","4","118","122","21","24","139","146","12.2"
"6","2017","30","Hotel","3","4","353","696","17","30","370","726","3"
"6","2017","30","Otros","7","27","117","167","0","0","117","167","1"
"6","2017","30","Otros","7","17","75","75","2","8","77","83","3"
"6","2017","30","Hotel","12","27","142","349","22","22","164","371","1"
"6","2017","30","Otros","5","5","24","24","2","2","26","26","3.65625"
"6","2017","30","Hotel","6","10","80","148","3","39","83","187","6.6"
"6","2017","30","Otros","10","18","4","4","0","0","4","4","10.25"
"6","2017","30","Otros","8","27","42","71","0","0","42","71","9.4"
"6","2017","30","Otros","8","3","25","47","3","6","28","53","10"
"6","2017","30","Hotel","16","27","48","59","0","0","48","59","5.8571428571429"
"6","2017","30","Otros","6","10","38","95","0","0","38","95","3.8518518518518"
"6","2017","30","Hotel","2","6","20","38","0","0","20","38","5.5"
"6","2017","30","Hotel","8","3","18","36","2","2","20","38","4.1111111111111"
"6","2017","30","Otros","10","11","19","25","3","5","22","30","11.764705882353"
"6","2017","30","Otros","6","27","2","3","0","0","2","3","3.960088691796"
"6","2017","30","Otros","15","16","3","5","0","0","3","5","9"
"6","2017","30","Otros","5","5","27","51","5","10","32","61","3.65625"
"6","2017","30","Otros","10","27","30","44","14","14","44","58","4.84"
"6","2017","30","Hotel","7","38","57","80","0","0","57","80","1"
"6","2017","30","Hotel","13","27","3","3","0","0","3","3","4.2"
"6","2017","30","Hotel","16","20","84","84","0","0","84","84","1"
"6","2017","30","Otros","10","27","18","18","0","0","18","18","4.84"
"6","2017","30","Hotel","3","7","87","319","8","8","95","327","1"
"6","2017","30","Otros","2","29","56","103","6","9","62","112","3.28"
"6","2017","30","Otros","10","18","6","12","0","0","6","12","10.25"
"6","2017","30","Otros","9","22","162","447","0","0","162","447","7.6428571428571"
"6","2017","30","Otros","15","27","44","305","0","0","44","305","1.4222222222222"
"6","2017","30","Otros","11","36","5","8","0","0","5","8","5.1904761904762"
"6","2017","30","Otros","5","5","18","33","4","8","22","41","3.65625"
"6","2017","30","Otros","2","29","40","80","48","120","88","200","3.28"
"6","2017","30","Hotel","9","22","168","194","2","2","170","196","2.5555555555556"
"6","2017","30","Otros","11","32","11","11","0","0","11","11","2.2857142857143"
"6","2017","30","Hotel","10","27","208","325","96","109","304","434","1"
"6","2017","30","Otros","16","27","48","74","0","0","48","74","2"
"6","2017","30","Hotel","16","20","12","24","0","0","12","24","1"
"6","2017","30","Otros","11","15","20","34","0","0","20","34","2.3571428571429"
"6","2017","30","Otros","7","17","192","794","0","0","192","794","3"
"6","2017","30","Otros","5","8","8","11","0","0","8","11","5"
"6","2017","30","Hotel","13","33","70","95","6","6","76","101","2"
"6","2017","30","Otros","5","9","13","28","10","10","23","38","4.0454545454545"
"6","2017","30","Otros","10","27","74","94","25","45","99","139","4.84"
"6","2017","30","Otros","9","22","10","12","8","26","18","38","7.6428571428571"
"6","2017","30","Otros","16","40","41","88","0","0","41","88","28.142857142857"
"6","2017","30","Hotel","16","40","55","55","0","0","55","55","1"
"6","2017","30","Otros","15","16","26","97","0","0","26","97","9"
"6","2017","30","Hotel","8","2","9","9","0","0","9","9","3"
"6","2017","30","Otros","8","3","8","48","0","0","8","48","10"
"6","2017","30","Otros","7","17","31","32","0","0","31","32","17.166666666667"
"6","2017","30","Otros","16","20","35","79","0","0","35","79","3.0769230769231"
"6","2017","30","Otros","6","27","16","22","0","0","16","22","3.960088691796"
"6","2017","15","Otros","12","35","31","77","11","19","42","96","3.5"
"6","2017","30","Otros","6","28","156","489","4","8","160","497","4.65"
"6","2017","30","Otros","6","28","33","61","0","0","33","61","4.65"
"6","2017","30","Hotel","8","34","65","175","0","0","65","175","2.5714285714286"
"6","2017","30","Hotel","16","20","637","1553","4","10","641","1563","1"
"6","2017","30","Hotel","2","6","364","747","0","0","364","747","2.2"
"6","2017","30","Hotel","7","27","56","56","0","0","56","56","4.1666666666667"
"6","2017","30","Hotel","10","23","116","138","1","1","117","139","4"
"6","2017","30","Hotel","9","26","7","7","5","7","12","14","1.5"
"6","2017","30","Otros","8","27","25","52","0","0","25","52","9.4"
"6","2017","30","Otros","10","27","0","0","1","1","1","1","4.84"
"6","2017","30","Otros","11","15","8","14","0","0","8","14","2.3571428571429"
"6","2017","30","Otros","16","20","20","34","0","0","20","34","3.0769230769231"
"6","2017","30","Otros","11","32","63","90","0","0","63","90","1"
"6","2017","30","Otros","16","27","45","45","0","0","45","45","13.818181818182"
"6","2017","30","Otros","9","37","161","161","0","0","161","161","4.5"
"6","2017","30","Hotel","2","29","2","2","14","16","16","18","2"
"6","2017","30","Hotel","2","1","84","269","0","0","84","269","6.4"
"6","2017","30","Otros","5","8","14","35","2","4","16","39","5"
"6","2017","30","Otros","9","37","48","77","17","31","65","108","4.5"
"6","2017","30","Otros","7","38","137","190","0","0","137","190","2.75"
"6","2017","30","Otros","11","32","32","42","4","4","36","46","1"
"6","2017","30","Otros","4","39","47","59","4","8","51","67","2.2222222222222"
"6","2017","30","Hotel","11","36","48","100","25","50","73","150","2.375"
"6","2017","30","Otros","10","23","55","141","18","61","73","202","7"
"6","2017","30","Hotel","15","16","918","1583","95","301","1013","1884","2"
"6","2017","30","Otros","2","29","28","70","51","118","79","188","3.28"
"6","2017","30","Hotel","6","12","942","1245","35","49","977","1294","1"
"6","2017","30","Hotel","11","15","21","93","0","0","21","93","1"
"6","2017","30","Otros","4","21","117","146","0","0","117","146","1"
"6","2017","30","Otros","16","19","45","110","0","0","45","110","10.263157894737"
"6","2017","30","","9","37","412","584","0","0","412","584","1"
"6","2017","30","Otros","10","27","120","169","89","113","209","282","4.84"
"6","2017","30","Otros","11","15","23","346","2","2","25","348","2.3571428571429"
"6","2017","30","Hotel","2","29","38","114","24","72","62","186","2"
"6","2017","30","Hotel","10","27","126","126","44","50","170","176","1"
"6","2017","30","Hotel","11","36","104","562","3","9","107","571","2.375"
"6","2017","30","Hotel","9","37","107","133","15","39","122","172","3.4"
"6","2017","30","Otros","14","27","10","20","4","8","14","28","11.833333333333"
"6","2017","30","Otros","7","38","86","97","0","0","86","97","1"
"6","2017","30","Hotel","2","1","38","206","0","0","38","206","6.4"
"6","2017","30","Otros","2","29","16","31","80","242","96","273","3.28"
"6","2017","30","Hotel","6","27","9","30","0","0","9","30","3"
"6","2017","30","Otros","5","9","22","55","0","0","22","55","4.0454545454545"
"6","2017","30","Hotel","2","1","173","240","0","0","173","240","6.4"
"6","2017","30","Hotel","3","7","29","115","13","17","42","132","1"
"6","2017","30","Otros","7","38","53","53","116","116","169","169","2.75"
"6","2017","30","Otros","7","17","10","15","0","0","10","15","17.166666666667"
"6","2017","30","Otros","7","38","3","27","0","0","3","27","2.75"
"6","2017","30","Otros","4","21","18","18","0","0","18","18","4.8333333333333"
"6","2017","30","Otros","2","1","55","65","5","5","60","70","5.5"
"6","2017","30","Otros","12","35","16","29","4","4","20","33","3.5"
"6","2017","30","Otros","12","35","16","29","4","4","20","33","3.5"
"6","2017","30","Otros","4","21","43","47","3","3","46","50","4.8333333333333"
"6","2017","30","Otros","12","24","12","33","6","8","18","41","9.2"
"6","2017","30","Otros","16","19","3","3","0","0","3","3","10.263157894737"
"6","2017","30","Otros","10","11","26","125","0","0","26","125","11.764705882353"
"6","2017","30","Otros","16","19","34","41","0","0","34","41","10.263157894737"
"6","2017","30","Hotel","2","27","20","21","0","0","20","21","1"
"6","2017","30","Otros","6","28","4","4","0","0","4","4","4.65"
"6","2017","30","Otros","10","18","170","352","9","34","179","386","10.25"
"6","2017","30","Otros","14","27","16","31","0","0","16","31","11.833333333333"
"6","2017","30","Hotel","11","32","13","19","0","0","13","19","1"
"6","2017","30","Otros","8","27","2","2","0","0","2","2","9.4"
"6","2017","30","Hotel","12","35","67","100","16","36","83","136","1.7272727272727"
"6","2017","30","Otros","13","14","14","16","0","0","14","16","7.3846153846154"
"6","2017","30","Otros","11","36","25","49","0","0","25","49","5.1904761904762"
"6","2017","30","Otros","16","20","25","28","0","0","25","28","3.0769230769231"
"6","2017","30","Hotel","14","31","175","175","953","2253","1128","2428","7.8"
"6","2017","30","Otros","2","27","130","347","5","55","135","402","3.2"
"6","2017","30","","16","40","160","432","0","0","160","432","3.0555555555556"
"6","2017","30","Hotel","11","36","55","90","6","34","61","124","2.375"
"6","2017","30","Hotel","9","22","24","36","0","0","24","36","2.5555555555556"
"6","2017","30","Otros","2","29","4","6","4","4","8","10","3.28"
"6","2017","30","Hotel","10","27","12","22","36","38","48","60","2.25"
"6","2017","30","Otros","10","27","12","76","0","0","12","76","4.84"
"6","2017","30","Hotel","16","19","6","6","0","0","6","6","4"
"6","2017","20","Otros","2","6","8","15","0","0","8","15","5"
"6","2017","30","Otros","7","27","71","89","0","0","71","89","4.8333333333333"
"6","2017","30","Hotel","2","6","64","570","0","0","64","570","5.5"
"6","2017","30","Hotel","6","28","8","10","5","5","13","15","2.4"
"6","2017","30","Otros","6","10","226","519","0","0","226","519","3.8518518518518"
"6","2017","30","Hotel","6","27","40","40","0","0","40","40","3"
"6","2017","30","Otros","5","5","18","33","4","8","22","41","3.65625"
"6","2017","30","Otros","12","24","55","118","22","28","77","146","9.2"
"6","2017","30","Hotel","8","2","52","92","1","1","53","93","3"
"6","2017","30","Hotel","11","32","9","58","0","0","9","58","1"
"6","2017","30","Otros","10","18","10","50","2","6","12","56","10.25"
"6","2017","30","Hotel","9","37","2","2","4","4","6","6","3.4"
"6","2017","30","Otros","5","9","11","28","1","3","12","31","4.0454545454545"
"6","2017","30","Otros","12","24","0","0","22","49","22","49","9.2"
"6","2017","30","Otros","9","22","1","1","0","0","1","1","7.6428571428571"
"6","2017","30","Otros","2","29","4","9","12","41","16","50","3.28"
"6","2017","30","Otros","10","23","3","3","0","0","3","3","7"
"6","2017","30","Otros","10","27","38","54","2","2","40","56","4.84"
"6","2017","30","Otros","10","11","33","33","0","0","33","33","11.764705882353"
"6","2017","30","Otros","8","3","2","2","0","0","2","2","10"
"6","2017","30","Otros","14","31","31","59","41","83","72","142","20.2"
"6","2017","30","Otros","2","29","59","191","65","218","124","409","3.28"
"6","2017","0","Otros","6","25","0","0","0","0","0","0","1"
"6","2017","30","Hotel","15","16","36","139","0","0","36","139","7.8"
"6","2017","30","Hotel","15","27","26","37","0","0","26","37","1"
"6","2017","30","Otros","10","27","1","3","2","3","3","6","4.84"
"6","2017","30","Otros","10","23","44","44","0","0","44","44","7"
"6","2017","30","Otros","6","27","7","123","0","0","7","123","3.960088691796"
"6","2017","30","Otros","16","40","98","160","4","12","102","172","28.142857142857"
"6","2017","30","Otros","11","36","76","99","0","0","76","99","5.1904761904762"
"6","2017","30","Otros","8","34","74","144","43","56","117","200","5.75"
"6","2017","30","Otros","6","12","37","65","0","0","37","65","1.8256578947368"
"6","2017","30","Otros","6","10","195","265","0","0","195","265","3.8518518518518"
"6","2017","30","Hotel","4","21","67","94","8","17","75","111","3"
"6","2017","30","Hotel","11","36","59","268","0","0","59","268","2.375"
"6","2017","30","Otros","5","8","64","94","16","19","80","113","5"
"6","2017","30","Hotel","7","17","88","119","0","0","88","119","10"
"6","2017","25","Hotel","11","36","170","204","14","14","184","218","1"
"6","2017","30","Otros","9","30","4","4","0","0","4","4","2.3333333333333"
"6","2017","30","Hotel","12","35","69","111","33","59","102","170","1.7272727272727"
"6","2017","30","Otros","2","1","76","114","20","30","96","144","5.5"
"6","2017","30","Hotel","6","25","75","80","0","0","75","80","1"
"6","2017","30","Otros","5","5","4","8","4","10","8","18","3.65625"
"6","2017","30","Otros","2","29","20","34","62","186","82","220","3.28"
"6","2017","30","Hotel","2","6","10","15","10","15","20","30","5.5"
"6","2017","30","Otros","7","17","4","6","1","1","5","7","17.166666666667"
"6","2017","30","Hotel","8","2","0","0","10","10","10","10","3"
"6","2017","30","Hotel","13","14","6","15","0","0","6","15","1"
"6","2017","30","Otros","7","38","29","66","10","18","39","84","2.75"
"6","2017","30","Hotel","14","31","16","38","42","139","58","177","24"
"6","2017","30","Hotel","5","5","27","49","14","29","41","78","2.1428571428571"
"6","2017","30","Otros","2","27","0","0","4","6","4","6","3.2"
"6","2017","30","Otros","5","8","16","20","1","1","17","21","5"
"6","2017","30","Otros","3","4","18","34","0","0","18","34","12.2"
"6","2017","30","Otros","13","14","2","3","0","0","2","3","7.3846153846154"
"6","2017","30","Otros","9","37","26","30","0","0","26","30","4.5"
"6","2017","30","Hotel","10","23","377","586","12","21","389","607","1"
"6","2017","30","Otros","11","32","1","1","3","3","4","4","2.2857142857143"
"6","2017","30","Otros","11","15","20","66","0","0","20","66","2.3571428571429"
"6","2017","30","Otros","8","3","37","259","0","0","37","259","10"
"6","2017","30","Otros","16","20","47","63","0","0","47","63","3.0769230769231"
"6","2017","30","Otros","8","3","17","28","0","0","17","28","10"
"6","2017","30","Otros","16","27","3","3","0","0","3","3","2"
"6","2017","30","Hotel","16","19","10","12","0","0","10","12","4"
"6","2017","30","Hotel","16","27","39","67","0","0","39","67","5.8571428571429"
"6","2017","30","Otros","9","26","20","36","0","0","20","36","3.8888888888889"
"6","2017","30","Otros","5","5","0","0","5","20","5","20","3.65625"
"6","2017","30","Otros","14","27","3","3","0","0","3","3","11.833333333333"
"6","2017","30","Hotel","5","5","1","1","0","0","1","1","2.1428571428571"
"6","2017","30","Hotel","12","24","60","274","40","102","100","376","3"
"6","2017","30","Otros","16","27","2","8","5","20","7","28","13.818181818182"
"6","2017","30","Otros","8","3","6","14","0","0","6","14","1"
"6","2017","30","Otros","13","27","26","59","3","4","29","63","12.2"
"6","2017","30","Hotel","16","40","23","33","10","12","33","45","16.333333333333"
"6","2017","30","Otros","11","36","23","40","0","0","23","40","1"
"6","2017","30","Otros","10","27","8","8","10","17","18","25","4.84"
"6","2017","30","Otros","9","22","8","12","0","0","8","12","7.6428571428571"
"6","2017","30","Hotel","5","5","15","18","2","4","17","22","2.1428571428571"
"6","2017","30","Otros","2","29","51","119","28","60","79","179","3.28"
"6","2017","30","Otros","2","29","0","0","6","7","6","7","3.28"
"6","2017","30","Hotel","13","14","2","2","0","0","2","2","1"
"6","2017","30","Otros","6","25","2","2","0","0","2","2","2.3846153846154"
"6","2017","30","Otros","2","1","1","1","0","0","1","1","5.5"
"6","2017","11","Hotel","12","27","35","41","0","0","35","41","1"
"6","2017","30","Hotel","13","27","46","46","0","0","46","46","4.2"
"6","2017","30","Otros","6","12","88","244","0","0","88","244","1.8256578947368"
"6","2017","30","Otros","6","27","3","4","0","0","3","4","3.960088691796"
"6","2017","30","Otros","6","25","5","6","12","12","17","18","2.3846153846154"
"6","2017","30","Hotel","6","28","18","53","0","0","18","53","2.5833333333333"
"6","2017","30","Otros","5","5","18","34","4","9","22","43","3.65625"
"6","2017","30","Otros","5","9","5","10","0","0","5","10","4.0454545454545"
"6","2017","30","Otros","5","8","10","10","2","2","12","12","5"
"6","2017","30","Hotel","2","29","79","177","19","43","98","220","1"
"6","2017","21","Otros","5","5","52","124","19","30","71","154","3.65625"
"6","2017","30","Hotel","9","26","9","9","7","9","16","18","1.5"
"6","2017","30","Otros","9","30","11","14","0","0","11","14","2.3333333333333"
"6","2017","30","Otros","11","15","9","72","0","0","9","72","2.3571428571429"
"6","2017","30","Hotel","16","27","5","9","0","0","5","9","5.8571428571429"
"6","2017","30","Otros","9","30","1","1","0","0","1","1","2.3333333333333"
"6","2017","30","Otros","2","29","17","25","24","42","41","67","3.28"
"6","2017","30","Otros","7","38","39","58","36","47","75","105","2.75"
"6","2017","30","Otros","4","21","26","56","0","0","26","56","4.8333333333333"
"6","2017","30","Otros","9","22","16","28","0","0","16","28","7.6428571428571"
"6","2017","30","Otros","9","22","48","95","0","0","48","95","7.6428571428571"
"6","2017","30","Otros","13","27","6","12","0","0","6","12","12.2"
"6","2017","30","Hotel","11","36","1194","1229","29","71","1223","1300","1"
"6","2017","30","Otros","13","33","9","18","0","0","9","18","5.125"
"6","2017","30","Otros","11","36","60","180","48","128","108","308","5.1904761904762"
"6","2017","30","Otros","12","35","2","4","0","0","2","4","3.5"
"6","2017","30","Otros","12","35","16","29","4","4","20","33","3.5"
"6","2017","30","Otros","10","11","10","10","4","8","14","18","11.764705882353"
"6","2017","30","Otros","12","24","24","41","10","10","34","51","9.2"
"6","2017","30","Otros","16","20","26","70","0","0","26","70","3.0769230769231"
"6","2017","30","Hotel","7","27","30","134","1","1","31","135","1"
"6","2017","30","Otros","6","12","15","19","0","0","15","19","1.8256578947368"
"6","2017","30","Otros","11","32","24","54","6","18","30","72","2.2857142857143"
"6","2017","30","Otros","6","28","22","26","2","2","24","28","4.65"
"6","2017","30","Otros","8","34","1","1","0","0","1","1","5.75"
"6","2017","30","Otros","16","27","24","116","5","50","29","166","13.818181818182"
"6","2017","30","Otros","10","11","1","2","0","0","1","2","11.764705882353"
"6","2017","30","Otros","6","10","55","117","0","0","55","117","3.8518518518518"
"6","2017","30","Otros","8","3","76","235","2","3","78","238","10"
"6","2017","30","Hotel","16","20","0","0","6","7","6","7","1"
"6","2017","30","Hotel","11","32","52","85","0","0","52","85","1"
"6","2017","30","Otros","8","27","0","0","4","4","4","4","9.4"
"6","2017","30","Otros","12","27","5","11","2","2","7","13","3.4285714285714"
"6","2017","30","Otros","6","10","59","135","0","0","59","135","3.8518518518518"
"6","2017","30","Otros","6","10","31","97","0","0","31","97","3.8518518518518"
"6","2017","30","Otros","5","8","31","41","1","3","32","44","5"
"6","2017","30","Otros","5","8","9","19","16","32","25","51","5"
"6","2017","30","Hotel","9","26","44","51","2","2","46","53","1.5"
"6","2017","30","Hotel","13","14","2","5","0","0","2","5","1"
"6","2017","30","Otros","10","18","25","49","0","0","25","49","10.25"
"6","2017","30","Otros","8","2","31","33","40","44","71","77","6.4285714285714"
"6","2017","30","Otros","7","27","6","9","0","0","6","9","4.8333333333333"
"6","2017","30","Otros","2","29","19","38","4","4","23","42","3.28"
"6","2017","30","Otros","11","32","40","77","2","2","42","79","2.2857142857143"
"6","2017","30","Otros","9","30","4","4","0","0","4","4","2.3333333333333"
"6","2017","20","Otros","2","29","2","6","5","11","7","17","3.28"
"6","2017","30","Otros","5","5","7","43","0","0","7","43","3.65625"
"6","2017","30","Otros","11","15","13","13","0","0","13","13","2.3571428571429"
"6","2017","30","Otros","10","23","3","3","0","0","3","3","7"
"6","2017","30","Otros","11","36","84","125","6","12","90","137","5.1904761904762"
"6","2017","30","Hotel","3","7","52","72","27","40","79","112","1"
"6","2017","30","Otros","10","27","4","13","0","0","4","13","4.84"
"6","2017","30","Otros","2","27","12","14","0","0","12","14","3.2"
"6","2017","30","Otros","12","35","0","0","2","2","2","2","3.5"
"6","2017","30","Otros","10","27","3","3","0","0","3","3","4.84"
"6","2017","30","Otros","16","40","22","38","133","351","155","389","28.142857142857"
"6","2017","30","Hotel","8","3","109","173","62","79","171","252","4.1111111111111"
"6","2017","30","Otros","9","22","34","34","0","0","34","34","7.6428571428571"
"6","2017","30","Otros","13","14","51","131","0","0","51","131","7.3846153846154"
"6","2017","30","Otros","5","9","11","28","1","3","12","31","4.0454545454545"
"6","2017","30","Otros","10","18","16","28","9","9","25","37","10.25"
"6","2017","30","Otros","6","25","23","27","2","4","25","31","2.3846153846154"
"6","2017","30","Otros","9","22","20","40","0","0","20","40","7.6428571428571"
"6","2017","30","Otros","10","27","18","37","9","9","27","46","4.84"
"6","2017","30","Otros","16","20","9","12","0","0","9","12","3.0769230769231"
"6","2017","30","Hotel","7","17","182","362","0","0","182","362","10"
"6","2017","30","Otros","15","27","52","65","0","0","52","65","1.4222222222222"
"6","2017","30","Otros","12","35","2","4","2","3","4","7","3.5"
"6","2017","30","Otros","12","35","1","2","6","10","7","12","3.5"
"6","2017","30","Otros","3","7","5","22","0","0","5","22","2"
"6","2017","30","Otros","10","11","24","32","0","0","24","32","11.764705882353"
"6","2017","30","Otros","12","24","7","8","1","1","8","9","9.2"
"6","2017","30","Otros","10","23","10","20","0","0","10","20","7"
"6","2017","30","Otros","7","27","2","5","0","0","2","5","4.8333333333333"
"6","2017","30","","10","18","8","8","0","0","8","8","1"
"6","2017","30","Otros","16","27","0","0","1","1","1","1","13.818181818182"
"6","2017","30","Hotel","2","29","3","5","6","7","9","12","1"
"6","2017","30","Otros","14","27","18","36","0","0","18","36","11.833333333333"
"6","2017","30","Otros","11","32","51","56","0","0","51","56","2.2857142857143"
"6","2017","30","Otros","16","19","0","0","0","0","0","0","1"
"6","2017","30","Otros","16","27","7","7","0","0","7","7","13.818181818182"
"6","2017","30","Otros","8","3","21","107","0","0","21","107","10"
"6","2017","30","Otros","16","27","8","16","0","0","8","16","13.818181818182"
"6","2017","30","Otros","16","20","36","62","0","0","36","62","3.0769230769231"
"6","2017","30","Otros","16","40","142","241","19","45","161","286","28.142857142857"
"6","2017","30","Hotel","11","36","46","158","8","16","54","174","2.375"
"6","2017","30","Otros","6","10","80","144","0","0","80","144","3.8518518518518"
"6","2017","30","Otros","7","38","41","102","8","21","49","123","2.75"
"6","2017","30","Otros","13","14","12","18","0","0","12","18","7.3846153846154"
"6","2017","30","Otros","9","30","13","17","0","0","13","17","2.3333333333333"
"6","2017","30","Otros","13","27","152","414","0","0","152","414","12.2"
"6","2017","30","Otros","10","27","2","2","2","2","4","4","4.84"
"6","2017","30","Otros","6","25","10","20","7","7","17","27","2.3846153846154"
"6","2017","30","Otros","9","26","128","128","0","0","128","128","3.8888888888889"
"6","2017","7","Otros","10","18","2","2","0","0","2","2","10.25"
"6","2017","30","Otros","2","29","21","88","0","0","21","88","3.28"
"6","2017","30","Otros","6","25","2","2","0","0","2","2","2.3846153846154"
"6","2017","30","Otros","5","9","6","6","3","3","9","9","4.0454545454545"
"6","2017","30","Otros","5","9","11","28","1","3","12","31","4.0454545454545"
"6","2017","30","Hotel","9","37","50","76","6","26","56","102","3.4"
"6","2017","30","Hotel","7","38","111","206","2","4","113","210","1"
"6","2017","30","Otros","7","27","95","111","0","0","95","111","4.8333333333333"
"6","2017","30","Otros","5","9","11","28","1","3","12","31","4.0454545454545"
"6","2017","30","Otros","10","27","13","13","5","5","18","18","4.84"
"6","2017","30","Otros","7","27","63","68","0","0","63","68","4.8333333333333"
"6","2017","30","Otros","16","40","25","38","18","46","43","84","28.142857142857"
"6","2017","30","Otros","10","23","22","22","0","0","22","22","7"
"6","2017","30","Otros","15","16","87","158","15","32","102","190","9"
"6","2017","30","Otros","3","7","4","8","14","23","18","31","2"
"6","2017","30","Otros","7","17","46","82","0","0","46","82","17.166666666667"
"6","2017","30","Otros","8","27","60","103","0","0","60","103","9.4"
"6","2017","30","Otros","9","22","43","126","3","5","46","131","7.6428571428571"
"6","2017","30","Otros","16","19","12","14","0","0","12","14","10.263157894737"
"6","2017","30","","15","27","155","344","0","0","155","344","1"
"6","2017","30","Hotel","10","11","16","16","6","6","22","22","5.6666666666667"
"6","2017","30","Otros","2","27","4","6","0","0","4","6","3.2"
"6","2017","30","Otros","8","2","48","60","9","11","57","71","6.4285714285714"
"6","2017","30","Otros","5","5","18","33","4","8","22","41","3.65625"
"6","2017","30","Otros","12","35","1","1","0","0","1","1","3.5"
"6","2017","30","Otros","8","3","1","1","0","0","1","1","10"
"6","2017","30","Otros","12","24","22","46","26","57","48","103","9.2"
"6","2017","30","Otros","11","32","28","112","0","0","28","112","2.2857142857143"
"6","2017","30","Otros","10","27","15","21","0","0","15","21","4.84"
"6","2017","30","Otros","11","15","6","6","0","0","6","6","2.3571428571429"
"6","2017","30","Otros","5","8","4","6","0","0","4","6","5"
"6","2017","30","Otros","14","27","10","10","0","0","10","10","11.833333333333"
"6","2017","30","Otros","13","27","180","231","0","0","180","231","12.2"
"6","2017","30","Hotel","10","18","48","48","97","97","145","145","3.2"
"6","2017","30","Otros","10","27","25","25","14","14","39","39","4.84"
"6","2017","0","Otros","11","32","0","0","0","0","0","0","1"
"6","2017","30","Otros","9","37","50","166","0","0","50","166","4.5"
"6","2017","30","Otros","12","35","12","27","28","42","40","69","3.5"
"6","2017","30","Otros","8","34","123","190","37","54","160","244","5.75"
"6","2017","30","Hotel","16","40","8","22","22","47","30","69","16.333333333333"
"6","2017","30","Hotel","10","11","36","72","1","4","37","76","5.6666666666667"
"6","2017","30","Otros","7","27","16","32","0","0","16","32","4.8333333333333"
"6","2017","30","Hotel","7","38","0","0","0","0","0","0","1"
"6","2017","30","Otros","6","27","3","12","0","0","3","12","3.960088691796"
"6","2017","30","Otros","6","10","93","179","0","0","93","179","3.8518518518518"
"6","2017","12","Otros","6","25","30","41","0","0","30","41","1"
"6","2017","30","Otros","6","25","1","1","0","0","1","1","2.3846153846154"
"6","2017","30","Otros","6","27","58","94","0","0","58","94","3.960088691796"
"6","2017","30","Otros","6","27","32","74","0","0","32","74","3.960088691796"
"6","2017","30","Otros","5","5","5","13","0","0","5","13","3.65625"
"6","2017","30","Otros","5","5","3","3","0","0","3","3","3.65625"
"6","2017","30","Otros","3","4","14","16","0","0","14","16","12.2"
"6","2017","30","Otros","10","23","11","16","0","0","11","16","7"
"6","2017","30","Otros","8","3","3","4","0","0","3","4","10"
"6","2017","30","Otros","5","5","10","21","3","6","13","27","3.65625"
"6","2017","30","Otros","5","8","18","26","0","0","18","26","5"
"6","2017","30","Otros","6","10","32","73","6","12","38","85","3.8518518518518"
"6","2017","30","Otros","16","19","16","32","0","0","16","32","10.263157894737"
"6","2017","30","Otros","11","15","25","47","0","0","25","47","2.3571428571429"
"6","2017","30","Otros","7","38","28","30","0","0","28","30","2.75"
"6","2017","30","Otros","11","32","116","250","8","12","124","262","2.2857142857143"
"6","2017","30","Otros","8","2","41","63","0","0","41","63","6.4285714285714"
"6","2017","30","Otros","10","27","20","41","5","7","25","48","4.84"
"6","2017","30","Otros","6","27","10","14","0","0","10","14","3.960088691796"
"6","2017","30","Otros","11","32","40","77","2","2","42","79","2.2857142857143"
"6","2017","30","Otros","8","34","5","5","5","8","10","13","5.75"
"6","2017","30","Otros","11","32","17","32","0","0","17","32","2.2857142857143"
"6","2017","30","Otros","10","11","4","12","0","0","4","12","11.764705882353"
"6","2017","30","Otros","11","32","12","33","0","0","12","33","2.2857142857143"
"6","2017","30","Otros","14","31","1","3","0","0","1","3","20.2"
"6","2017","30","Hotel","14","31","184","333","554","2093","738","2426","17.4"
"6","2017","30","Otros","11","36","80","139","0","0","80","139","5.1904761904762"
"6","2017","30","Hotel","15","16","1711","2818","350","577","2061","3395","2"
"6","2017","30","Otros","15","27","10","42","0","0","10","42","1.4222222222222"
"6","2017","30","Otros","5","5","5","10","1","5","6","15","3.65625"
"6","2017","30","Otros","8","34","7","7","8","8","15","15","5.75"
"6","2017","30","Otros","7","27","15","17","0","0","15","17","4.8333333333333"
"6","2017","30","Otros","12","35","16","29","4","4","20","33","3.5"
"6","2017","30","Otros","5","5","37","82","0","0","37","82","3.65625"
"6","2017","30","Otros","10","11","1","1","0","0","1","1","11.764705882353"
"6","2017","30","Otros","10","11","1","1","0","0","1","1","11.764705882353"
"6","2017","30","Otros","9","30","15","300","0","0","15","300","2.3333333333333"
"6","2017","30","Otros","8","2","20","46","7","22","27","68","6.4285714285714"
"6","2017","30","Otros","10","27","27","63","6","6","33","69","4.84"
"6","2017","30","Otros","5","9","11","28","1","3","12","31","4.0454545454545"
"6","2017","30","Otros","6","27","4","8","0","0","4","8","3.960088691796"
"6","2017","30","Otros","6","10","119","224","10","16","129","240","3.8518518518518"
"6","2017","30","Otros","6","10","52","82","4","4","56","86","3.8518518518518"
"6","2017","30","Otros","6","27","13","13","0","0","13","13","3.960088691796"
"6","2017","30","Otros","6","12","4","30","0","0","4","30","1.8256578947368"
"6","2017","18","Otros","6","10","31","75","0","0","31","75","3.8518518518518"
"6","2017","8","Otros","6","10","16","26","0","0","16","26","3.8518518518518"
"6","2017","30","Otros","6","27","3","3","0","0","3","3","3.960088691796"
"6","2017","30","Otros","6","12","28","28","0","0","28","28","1.8256578947368"
"6","2017","30","Otros","6","10","13","21","0","0","13","21","3.8518518518518"
"6","2017","30","Hotel","6","25","21","35","0","0","21","35","1"
"6","2017","30","Otros","6","27","3","3","0","0","3","3","3.960088691796"
"6","2017","30","Otros","5","9","12","23","0","0","12","23","4.0454545454545"
"6","2017","30","Otros","5","5","9","28","8","35","17","63","3.65625"
"6","2017","30","Otros","5","5","6","9","0","0","6","9","3.65625"
"6","2017","30","Otros","5","5","38","63","8","21","46","84","3.65625"
"6","2017","30","Otros","11","36","39","69","0","0","39","69","5.1904761904762"
"6","2017","30","Hotel","6","10","1316","2671","66","148","1382","2819","1"
"6","2017","30","Otros","5","9","11","28","1","3","12","31","4.0454545454545"
"6","2017","30","Otros","5","8","4","6","0","0","4","6","5"
"6","2017","0","Hotel","15","27","0","0","0","0","0","0","1"
"6","2017","30","Hotel","3","4","314","1700","22","112","336","1812","3"
"6","2017","30","Otros","3","7","21","21","7","7","28","28","1"
"6","2017","30","Otros","7","38","44","69","0","0","44","69","2.75"
"6","2017","30","Hotel","10","27","15","26","0","0","15","26","1"
"6","2017","30","Hotel","12","35","2","2","8","8","10","10","1.7272727272727"
"6","2017","30","Hotel","10","27","2","2","0","0","2","2","2.25"
"6","2017","30","Hotel","7","17","502","891","43","96","545","987","4"
"6","2017","30","Hotel","16","19","3","3","0","0","3","3","4"
"6","2017","30","Hotel","2","6","37","127","0","0","37","127","2.2"
"6","2017","17","Otros","5","5","40","92","0","0","40","92","3.65625"
"6","2017","30","Otros","12","24","83","119","59","59","142","178","9.2"
"6","2017","30","Otros","5","8","26","32","8","12","34","44","5"
"6","2017","30","Otros","4","13","161","198","3","3","164","201","1"
"6","2017","30","Otros","10","11","142","142","0","0","142","142","11.764705882353"
"6","2017","30","Otros","12","35","1","1","9","17","10","18","3.5"
"6","2017","30","Otros","10","23","63","63","1","1","64","64","7"
"6","2017","30","Otros","11","36","285","590","38","78","323","668","5.1904761904762"
"6","2017","30","Otros","12","35","16","29","4","4","20","33","3.5"
"6","2017","30","Otros","11","36","55","81","0","0","55","81","5.1904761904762"
"6","2017","30","Otros","8","2","75","180","19","28","94","208","6.4285714285714"
"6","2017","30","Otros","9","30","119","238","0","0","119","238","2.3333333333333"
"6","2017","30","Otros","11","36","53","77","0","0","53","77","5.1904761904762"
"6","2017","30","Otros","6","10","12","24","0","0","12","24","3.8518518518518"
"6","2017","30","Otros","10","18","14","19","0","0","14","19","10.25"
"6","2017","30","Otros","7","27","0","0","2","2","2","2","4.8333333333333"
"6","2017","30","Otros","16","20","8","32","0","0","8","32","1"
"6","2017","30","Otros","9","22","9","27","0","0","9","27","7.6428571428571"
"6","2017","30","Otros","5","5","100","138","9","17","109","155","3.65625"
"6","2017","30","Otros","12","35","16","29","4","4","20","33","3.5"
"6","2017","30","Otros","10","11","1","1","0","0","1","1","11.764705882353"
"6","2017","30","Otros","10","11","9","28","0","0","9","28","11.764705882353"
"6","2017","30","Otros","5","9","40","124","2","2","42","126","4.0454545454545"
"6","2017","30","Otros","5","5","3","12","5","10","8","22","3.65625"
"6","2017","30","Otros","12","35","34","58","39","68","73","126","3.5"
"6","2017","15","Otros","7","38","52","108","2","4","54","112","2.75"
"6","2017","30","Hotel","12","35","1","1","0","0","1","1","1.7272727272727"
"6","2017","30","Otros","13","14","12","16","0","0","12","16","1"
"6","2017","30","Otros","5","5","3","5","0","0","3","5","3.65625"
"6","2017","30","Hotel","9","26","7","15","0","0","7","15","1.5"
"6","2017","30","Hotel","16","19","3","6","0","0","3","6","1"
"6","2017","30","Otros","16","19","38","54","0","0","38","54","10.263157894737"
"6","2017","30","Otros","9","30","24","24","0","0","24","24","2.3333333333333"
"6","2017","30","Otros","16","19","32","46","0","0","32","46","10.263157894737"
"6","2017","30","Otros","16","19","47","108","0","0","47","108","10.263157894737"
"6","2017","30","Otros","9","26","15","125","0","0","15","125","3.8888888888889"
"6","2017","30","Otros","16","40","1","1","0","0","1","1","28.142857142857"
"6","2017","30","Hotel","16","27","9","37","0","0","9","37","5.8571428571429"
"6","2017","30","Otros","16","19","12","12","0","0","12","12","10.263157894737"
"6","2017","30","Otros","16","19","6","6","0","0","6","6","10.263157894737"
"6","2017","30","","9","30","206","262","24","24","230","286","1"
"6","2017","30","Otros","16","19","11","15","0","0","11","15","10.263157894737"
"6","2017","30","Otros","10","11","1","1","0","0","1","1","11.764705882353"
"6","2017","30","Otros","11","36","11","11","0","0","11","11","5.1904761904762"
"6","2017","30","Otros","16","19","8","16","0","0","8","16","10.263157894737"
"6","2017","30","Otros","16","19","48","64","0","0","48","64","1.3333333333333"
"6","2017","30","Otros","16","19","12","12","0","0","12","12","10.263157894737"
"6","2017","30","Otros","10","18","4","5","12","26","16","31","10.25"
"6","2017","30","Otros","16","19","13","22","0","0","13","22","10.263157894737"
"6","2017","30","Otros","16","19","1","1","0","0","1","1","1.3333333333333"
"6","2017","30","","9","26","377","2012","0","0","377","2012","1"
"6","2017","30","Otros","16","19","3","5","0","0","3","5","10.263157894737"
"6","2017","30","Otros","16","19","22","26","0","0","22","26","10.263157894737"
"6","2017","30","Hotel","8","2","302","1219","0","0","302","1219","1"
"6","2017","30","Otros","6","10","32","50","25","35","57","85","3.8518518518518"
"6","2017","30","Otros","6","12","98","247","0","0","98","247","1.8256578947368"
"6","2017","30","Hotel","16","19","40","435","16","116","56","551","1"
"6","2017","30","Otros","3","7","10","10","2","2","12","12","2"
"6","2017","30","Hotel","2","6","865","2135","109","274","974","2409","1"
"6","2017","30","Hotel","3","4","409","581","30","60","439","641","2.6"
"6","2017","30","Hotel","16","40","1621","2512","450","624","2071","3136","1"
"6","2017","30","Otros","16","27","48","48","0","0","48","48","13.818181818182"
"6","2017","30","Hotel","6","28","133","236","9","20","142","256","2.4"
"6","2017","30","Hotel","8","34","758","864","231","335","989","1199","1"
"6","2017","30","Otros","9","30","4","4","0","0","4","4","2.3333333333333"
"6","2017","30","Hotel","10","18","36","36","75","75","111","111","1"
"6","2017","30","Hotel","9","30","59","359","0","0","59","359","1"
"6","2017","30","Hotel","15","27","8","8","0","0","8","8","1"
"6","2017","30","Hotel","9","22","103","1006","0","0","103","1006","2.5555555555556"
"6","2017","0","","11","15","0","0","0","0","0","0","1"
"6","2017","30","Otros","6","12","27","27","0","0","27","27","1.8256578947368"
"6","2017","30","Hotel","15","27","30","900","0","0","30","900","1"
"6","2017","30","Otros","15","27","122","211","0","0","122","211","1.4222222222222"
"6","2017","30","Otros","15","27","4","4","0","0","4","4","1.4222222222222"
"6","2017","30","Otros","2","1","35","35","0","0","35","35","1"
"6","2017","30","Otros","12","24","9","26","1","1","10","27","9.2"
"6","2017","30","Otros","5","5","18","33","4","8","22","41","3.65625"
"6","2017","30","Hotel","7","27","153","180","0","0","153","180","1"
"6","2017","30","Otros","16","20","12","24","0","0","12","24","3.0769230769231"
"6","2017","0","","10","11","0","0","0","0","0","0","1"
"6","2017","30","Hotel","16","40","16","16","0","0","16","16","16.333333333333"
"6","2017","30","Otros","12","35","19","31","4","5","23","36","3.5"
"6","2017","30","Hotel","6","27","15","21","0","0","15","21","3"
"6","2017","30","Otros","5","5","3","5","1","1","4","6","3.65625"
"6","2017","30","Hotel","6","27","29","33","0","0","29","33","3"
"6","2017","30","Otros","6","25","14","20","0","0","14","20","2.3846153846154"
"6","2017","0","Hotel","15","27","0","0","0","0","0","0","1"
"6","2017","30","Otros","5","9","12","21","10","17","22","38","4.0454545454545"
"6","2017","30","Hotel","15","27","16","32","4","4","20","36","1"
"6","2017","30","Hotel","5","9","1","1","0","0","1","1","1"
"6","2017","30","Hotel","8","34","58","126","9","19","67","145","2.5714285714286"
"6","2017","0","Hotel","15","27","0","0","0","0","0","0","1"
"6","2017","30","Hotel","6","27","248","461","0","0","248","461","3"
"6","2017","0","Otros","6","27","0","0","0","0","0","0","1"
"6","2017","30","Otros","12","27","0","0","48","48","48","48","3.4285714285714"
"6","2017","30","Hotel","2","27","368","836","40","193","408","1029","1"
"6","2017","30","Hotel","2","6","31","138","0","0","31","138","1"
"6","2017","30","Otros","2","6","26","54","0","0","26","54","1"
"6","2017","30","Hotel","4","39","125","125","0","0","125","125","1"
"6","2017","30","Hotel","6","10","134","151","2","2","136","153","1"
"6","2017","30","Otros","5","8","2","6","0","0","2","6","5"
"6","2017","30","Hotel","13","33","847","1132","27","55","874","1187","1"
"6","2017","30","Hotel","13","33","116","116","47","52","163","168","1"
"6","2017","30","Otros","11","32","189","603","0","0","189","603","2.2857142857143"
"6","2017","30","Hotel","9","26","615","1165","357","410","972","1575","1"
"6","2017","30","Hotel","16","20","23","23","1","1","24","24","1"
"6","2017","30","Otros","16","20","29","60","1","1","30","61","3.0769230769231"
"6","2017","30","","16","40","751","1250","0","0","751","1250","1"
"6","2017","30","Hotel","15","16","1419","2868","110","225","1529","3093","1"
"6","2017","30","Hotel","5","9","4","4","2","4","6","8","1"
"6","2017","30","Otros","7","38","24","124","0","0","24","124","2.75"
"6","2017","30","Otros","2","6","203","1015","0","0","203","1015","1"
"6","2017","30","Otros","2","6","51","97","17","25","68","122","1"
"6","2017","30","Hotel","15","27","207","586","7","7","214","593","1"
"6","2017","30","Otros","7","38","39","65","0","0","39","65","2.75"
"6","2017","30","Otros","2","1","4","9","0","0","4","9","1"
"6","2017","30","Otros","8","3","76","235","2","3","78","238","10"
"6","2017","30","Otros","11","36","28","34","0","0","28","34","5.1904761904762"
"6","2017","30","Otros","16","20","30","69","0","0","30","69","3.0769230769231"
"6","2017","30","Otros","8","3","412","712","0","0","412","712","1"
"6","2017","30","Otros","4","39","29","49","1","4","30","53","2.2222222222222"
"6","2017","30","Otros","5","5","91","261","0","0","91","261","3.65625"
"6","2017","30","Otros","12","27","5","10","0","0","5","10","3.4285714285714"
"6","2017","30","Otros","7","27","38","117","0","0","38","117","1"
"6","2017","30","Hotel","2","6","25","26","3","3","28","29","1"
"6","2017","30","Hotel","14","27","172","505","107","167","279","672","1"
"6","2017","30","Hotel","16","19","392","535","0","0","392","535","1"
"6","2017","30","","2","1","21","297","0","0","21","297","1"
"6","2017","30","Hotel","2","27","93","255","2","32","95","287","1"
"6","2017","30","Otros","16","20","43","70","0","0","43","70","1"
"6","2017","0","Otros","13","14","0","0","0","0","0","0","1"
"6","2017","30","Hotel","11","36","87","134","4","6","91","140","2.375"
"6","2017","30","Otros","13","14","6","180","0","0","6","180","7.3846153846154"
"6","2017","30","Otros","12","27","15","48","0","0","15","48","3.4285714285714"
"6","2017","30","Hotel","2","6","150","232","0","0","150","232","2.2"
"6","2017","30","Otros","2","6","56","297","0","0","56","297","1"
"6","2017","30","Otros","10","27","6","180","0","0","6","180","4.84"
"6","2017","30","Otros","12","27","4","5","4","4","8","9","3.4285714285714"
"6","2017","30","Otros","13","14","149","192","0","0","149","192","7.3846153846154"
"6","2017","30","Otros","6","12","125","185","32","56","157","241","1.8256578947368"
"6","2017","30","Otros","2","6","1","1","17","25","18","26","1"
"6","2017","30","Hotel","12","35","69","111","33","59","102","170","1.7272727272727"
"6","2017","30","Otros","5","5","10","18","0","0","10","18","3.65625"
"6","2017","30","Otros","9","30","12","240","0","0","12","240","2.3333333333333"
"6","2017","30","Hotel","8","2","1","1","1","1","2","2","1"
"6","2017","30","Otros","9","30","2","4","0","0","2","4","2.3333333333333"
"6","2017","30","Hotel","15","27","31","33","0","0","31","33","1"
"6","2017","30","Hotel","3","7","17","17","0","0","17","17","1"
"6","2017","30","Otros","6","12","418","628","0","0","418","628","1.8256578947368"
"6","2017","30","Otros","12","27","32","45","3","5","35","50","3.4285714285714"
"6","2017","30","Otros","2","6","6","20","0","0","6","20","5"
"6","2017","30","Otros","6","27","2","3","0","0","2","3","3.960088691796"
"6","2017","30","Hotel","10","11","32","41","0","0","32","41","1"
"6","2017","30","Otros","2","1","24","160","0","0","24","160","1"
"6","2017","30","Otros","11","36","18","18","0","0","18","18","5.1904761904762"
"6","2017","30","Hotel","11","32","0","0","0","0","0","0","1"
"6","2017","30","Otros","2","27","7","15","0","0","7","15","1"
"6","2017","30","Otros","12","27","4","4","0","0","4","4","3.4285714285714"
"6","2017","30","Hotel","8","2","15","15","0","0","15","15","3"
"6","2017","30","Hotel","16","20","35","35","0","0","35","35","1"
"6","2017","30","Otros","12","35","12","36","20","40","32","76","3.5"
"6","2017","30","Otros","13","14","11","11","0","0","11","11","1"
"6","2017","30","Otros","2","27","4","8","0","0","4","8","3.2"
"6","2017","30","Hotel","6","27","18","18","0","0","18","18","3"
"6","2017","30","Hotel","8","3","33","73","0","0","33","73","4.1111111111111"
"6","2017","26","Hotel","15","27","57","107","0","0","57","107","1"
"6","2017","30","Otros","8","3","72","221","2","3","74","224","10"
"6","2017","0","Hotel","16","20","0","0","0","0","0","0","1"
"6","2017","30","Hotel","6","28","60","102","0","0","60","102","2.4"
"6","2017","30","Otros","2","1","31","111","1","1","32","112","5.5"
"6","2017","30","Hotel","11","36","62","99","58","88","120","187","2.375"
"6","2017","30","Otros","4","13","68","133","0","0","68","133","1"
"6","2017","30","Otros","2","6","146","534","0","0","146","534","1"
"6","2017","30","Otros","8","34","60","84","32","48","92","132","5.75"
"6","2017","30","Hotel","11","15","0","0","0","0","0","0","1"
"6","2017","30","Otros","15","27","4","4","0","0","4","4","1.4222222222222"
"6","2017","30","Hotel","13","14","56","94","0","0","56","94","1"
"6","2017","30","Hotel","13","14","118","150","5","5","123","155","1"
"6","2017","30","Hotel","9","30","13","17","5","5","18","22","1"
"6","2017","30","Hotel","4","13","239","733","11","37","250","770","5.4"
"6","2017","30","Otros","6","27","45","60","0","0","45","60","3.960088691796"
"6","2017","21","Hotel","15","27","0","0","0","0","0","0","1"
"6","2017","30","Hotel","2","29","6","12","30","88","36","100","2"
"6","2017","30","Hotel","13","33","39","82","0","0","39","82","2"
"6","2017","30","Hotel","12","35","69","111","33","59","102","170","1.7272727272727"
"6","2017","30","Hotel","13","14","175","231","3","3","178","234","1"
"6","2017","30","Otros","6","25","4","7","0","0","4","7","2.3846153846154"
"6","2017","30","Hotel","8","2","18","27","2","4","20","31","3"
"6","2017","30","Otros","4","39","12","12","0","0","12","12","2.2222222222222"
"6","2017","30","Otros","6","12","129","133","20","42","149","175","1.8256578947368"
"6","2017","30","Otros","13","33","58","96","0","0","58","96","5.125"
"6","2017","30","Hotel","4","13","25","35","6","7","31","42","5.4"
"6","2017","30","Hotel","7","27","17","185","0","0","17","185","4.1666666666667"
"6","2017","30","Hotel","4","13","813","2161","93","191","906","2352","1"
"6","2017","30","","5","8","57","110","74","107","131","217","1"
"6","2017","30","Otros","8","2","104","181","16","21","120","202","6.4285714285714"
"6","2017","30","Otros","2","6","3","3","10","11","13","14","1"
"6","2017","30","","6","10","46","120","0","0","46","120","1"
"6","2017","30","Hotel","2","29","67","90","42","52","109","142","2"
"6","2017","30","","14","31","70","111","208","748","278","859","1"
"6","2017","30","Hotel","16","27","2543","10173","0","0","2543","10173","1"
"6","2017","30","Hotel","12","35","21","23","6","10","27","33","1.7272727272727"
"6","2017","30","","12","35","5","13","10","26","15","39","1"
"6","2017","30","","9","26","55","195","0","0","55","195","1"
"6","2017","30","Otros","11","32","65","101","0","0","65","101","2.2857142857143"
"6","2017","30","Otros","12","24","22","36","39","59","61","95","9.2"
"6","2017","30","Hotel","6","25","15","18","0","0","15","18","1"
"6","2017","30","Otros","11","32","2","5","0","0","2","5","2.2857142857143"
"6","2017","30","Hotel","16","19","64","110","4","11","68","121","4"
"6","2017","30","Otros","13","33","30","32","9","16","39","48","5.125"
"6","2017","30","Otros","16","27","22","51","1","3","23","54","13.818181818182"
"6","2017","30","Otros","6","12","122","124","5","5","127","129","1.8256578947368"
"6","2017","30","Otros","2","29","4","4","0","0","4","4","3.28"
"6","2017","30","Hotel","14","27","115","122","28","33","143","155","1"
"6","2017","30","Otros","2","1","100","1400","0","0","100","1400","1"
"6","2017","30","Otros","11","32","24","35","0","0","24","35","2.2857142857143"
"6","2017","30","Otros","2","27","6","12","0","0","6","12","1"
"6","2017","30","Hotel","2","29","302","1206","0","0","302","1206","1"
"6","2017","30","Hotel","4","13","24","473","0","0","24","473","3.2"
"6","2017","30","Hotel","4","21","15","21","2","3","17","24","3"
"6","2017","30","Otros","7","27","126","163","4","6","130","169","4.8333333333333"
"6","2017","30","","3","4","132","226","120","238","252","464","1"
"6","2017","30","Hotel","6","27","22","53","8","18","30","71","3"
"6","2017","30","Otros","16","19","2","3","0","0","2","3","10.263157894737"
"6","2017","30","Otros","11","32","7","7","0","0","7","7","2.2857142857143"
"6","2017","30","Otros","3","7","37","58","71","132","108","190","2"
"6","2017","30","Otros","5","5","7","12","0","0","7","12","3.65625"
"6","2017","24","Otros","15","27","862","1276","0","0","862","1276","1.4222222222222"
"6","2017","30","Otros","6","25","2","2","0","0","2","2","2.3846153846154"
"6","2017","30","","10","27","6","35","0","0","6","35","1"
"6","2017","30","Otros","2","29","13","22","20","33","33","55","3.28"
"6","2017","30","Otros","12","35","16","29","4","4","20","33","3.5"
"6","2017","30","Otros","16","19","14","23","0","0","14","23","10.263157894737"
"6","2017","30","Otros","9","26","59","59","0","0","59","59","3.8888888888889"
"6","2017","30","Hotel","13","33","31","31","2","2","33","33","2"
"6","2017","30","Otros","11","32","2","2","0","0","2","2","2.2857142857143"
"6","2017","30","Otros","9","22","40","121","3","5","43","126","7.6428571428571"
"6","2017","30","Otros","6","27","2","60","0","0","2","60","3.960088691796"
"6","2017","30","Otros","15","27","134","233","0","0","134","233","1.4222222222222"
"6","2017","30","Otros","11","32","67","73","0","0","67","73","2.2857142857143"
"6","2017","30","Otros","11","15","29","45","1","1","30","46","2.3571428571429"
"6","2017","30","Otros","9","37","6","22","0","0","6","22","4.5"
"6","2017","30","Otros","5","9","14","26","5","10","19","36","4.0454545454545"
"6","2017","30","Hotel","10","27","60","80","0","0","60","80","2.25"
"6","2017","30","Otros","6","28","24","720","0","0","24","720","4.65"
"6","2017","30","Otros","4","13","46","140","4","5","50","145","3.4"
"6","2017","30","Otros","2","1","1","1","0","0","1","1","1"
"6","2017","30","Otros","2","29","30","53","19","33","49","86","3.28"
"6","2017","30","Hotel","8","3","4","6","0","0","4","6","4.1111111111111"
"6","2017","30","Otros","16","19","22","49","0","0","22","49","1.3333333333333"
"6","2017","30","Otros","12","35","10","19","3","3","13","22","3.5"
"6","2017","15","Hotel","12","35","5","6","1","3","6","9","1.7272727272727"
"6","2017","30","Otros","12","35","19","31","4","5","23","36","3.5"
"6","2017","30","Otros","2","29","17","21","20","31","37","52","3.28"
"6","2017","30","Hotel","7","27","139","197","3","6","142","203","1"
"6","2017","30","Hotel","9","22","33","53","0","0","33","53","2.5555555555556"
"6","2017","30","Hotel","12","35","44","84","37","91","81","175","1.7272727272727"
"6","2017","30","Otros","15","16","125","180","4","7","129","187","2"
"6","2017","30","Hotel","15","27","14","20","1","2","15","22","1"
"6","2017","30","Otros","4","13","20","20","0","0","20","20","3.4"
"6","2017","30","Hotel","8","34","105","192","11","21","116","213","2.5714285714286"
"6","2017","30","Hotel","16","20","0","0","0","0","0","0","1"
"6","2017","30","Hotel","6","28","176","176","54","54","230","230","2.4"
"6","2017","30","Hotel","15","27","75","398","4","4","79","402","1"
"6","2017","30","Otros","12","35","128","222","8","8","136","230","3.5"
"6","2017","30","Otros","11","15","28","71","0","0","28","71","2.3571428571429"
"6","2017","30","Otros","11","15","13","27","0","0","13","27","2.3571428571429"
"6","2017","13","Otros","11","36","47","82","15","20","62","102","5.1904761904762"
"6","2017","30","Hotel","11","36","16","19","0","0","16","19","2.375"
"6","2017","30","Hotel","6","12","89","189","0","0","89","189","5"
"6","2017","30","Otros","8","3","29","39","21","33","50","72","10"
"6","2017","30","Otros","10","27","37","54","9","9","46","63","4.84"
"6","2017","30","Otros","8","3","16","74","0","0","16","74","10"
"6","2017","30","Otros","6","25","22","45","0","0","22","45","2.3846153846154"
"6","2017","30","Hotel","2","27","68","110","0","0","68","110","1"
"6","2017","30","Hotel","10","18","0","0","77","217","77","217","3.2"
"6","2017","30","Otros","11","32","42","76","9","16","51","92","1"
"6","2017","30","Hotel","6","10","660","780","380","552","1040","1332","1"
"6","2017","30","Otros","11","32","29","46","0","0","29","46","2.2857142857143"
"6","2017","30","Otros","2","27","6","12","0","0","6","12","1"
"6","2017","30","","12","24","29","102","89","315","118","417","1"
"6","2017","30","Hotel","16","27","750","858","0","0","750","858","5.8571428571429"
"6","2017","30","Hotel","7","38","51","532","0","0","51","532","1"
"6","2017","30","Hotel","6","12","1784","1790","32","47","1816","1837","1"
"7","2017","31","Hotel","14","31","1877","2728","9622","12248","11499","14976","1"
"7","2017","31","Hotel","14","31","706","1147","3642","9519","4348","10666","1"
"7","2017","31","Hotel","14","31","855","1097","1114","3179","1969","4276","1"
"7","2017","31","Hotel","11","32","125","180","0","0","125","180","1"
"7","2017","31","Hotel","14","27","3447","5005","707","1026","4154","6031","1"
"7","2017","31","Otros","11","32","50","82","0","0","50","82","2.2857142857143"
"7","2017","31","Hotel","14","31","317","506","3515","4881","3832","5387","5.4"
"7","2017","31","Hotel","15","16","1327","3399","98","230","1425","3629","1"
"7","2017","31","Hotel","14","31","964","1641","1394","5494","2358","7135","5.4"
"7","2017","31","Hotel","12","24","636","898","778","904","1414","1802","1"
"7","2017","31","Hotel","16","40","1166","1824","384","754","1550","2578","1"
"7","2017","31","Hotel","6","12","1172","1772","41","99","1213","1871","1"
"7","2017","31","Hotel","10","23","1038","1503","107","137","1145","1640","1"
"7","2017","31","Hotel","14","31","1703","4271","350","876","2053","5147","5.4"
"7","2017","31","Hotel","3","4","950","1896","118","591","1068","2487","1"
"7","2017","31","","11","32","623","873","108","242","731","1115","1"
"7","2017","31","Hotel","6","12","588","1185","73","196","661","1381","1"
"7","2017","31","Hotel","6","12","2055","3030","176","329","2231","3359","1"
"7","2017","31","Hotel","9","26","2584","5200","69","138","2653","5338","1"
"7","2017","31","Hotel","2","1","1588","2554","75","232","1663","2786","1"
"7","2017","31","Hotel","9","26","1347","2080","287","524","1634","2604","1"
"7","2017","31","Hotel","6","12","597","1050","55","160","652","1210","1"
"7","2017","31","Hotel","14","31","80","93","4636","9407","4716","9500","5.4"
"7","2017","31","Hotel","11","32","404","933","28","55","432","988","1"
"7","2017","31","Hotel","2","6","1020","2042","99","234","1119","2276","1"
"7","2017","31","Hotel","16","40","1752","3581","624","962","2376","4543","1"
"7","2017","31","Hotel","14","27","1186","2569","743","3175","1929","5744","1"
"7","2017","31","Otros","11","36","110","375","8","16","118","391","1"
"7","2017","31","Hotel","10","23","1142","1709","546","1034","1688","2743","1"
"7","2017","31","Hotel","14","31","391","1145","729","5050","1120","6195","7.8"
"7","2017","31","Hotel","7","17","425","891","70","184","495","1075","1"
"7","2017","31","Hotel","2","1","2322","2830","212","267","2534","3097","2"
"7","2017","31","Hotel","2","1","1637","2575","236","573","1873","3148","2"
"7","2017","31","Hotel","4","13","1046","1904","264","570","1310","2474","1"
"7","2017","31","Hotel","2","1","2273","2635","284","316","2557","2951","2"
"7","2017","31","Hotel","10","27","2186","5246","586","1406","2772","6652","1"
"7","2017","31","Hotel","14","27","615","1332","952","2295","1567","3627","1"
"7","2017","31","Hotel","14","27","1772","2622","1113","3092","2885","5714","1"
"7","2017","31","Hotel","6","12","1352","2007","62","148","1414","2155","1"
"7","2017","31","Hotel","6","12","1463","1868","548","702","2011","2570","1"
"7","2017","31","Hotel","13","27","3469","7638","6","21","3475","7659","1"
"7","2017","31","Hotel","14","31","423","658","2132","3051","2555","3709","7.8"
"7","2017","31","Hotel","6","12","1308","1872","268","384","1576","2256","1"
"7","2017","31","Hotel","16","27","2726","5279","163","318","2889","5597","1"
"7","2017","31","","10","27","36","95","4","4","40","99","1"
"7","2017","31","Hotel","10","18","742","1582","320","721","1062","2303","1"
"7","2017","31","Hotel","9","37","1988","3796","162","267","2150","4063","1"
"7","2017","31","Hotel","16","27","1752","7009","0","0","1752","7009","1"
"7","2017","31","Hotel","15","16","1193","2494","124","296","1317","2790","2"
"7","2017","31","Hotel","2","1","1333","2319","264","479","1597","2798","2"
"7","2017","31","Hotel","3","4","798","1510","184","324","982","1834","1"
"7","2017","31","Hotel","16","40","1556","2198","882","1355","2438","3553","1"
"7","2017","31","Hotel","7","17","3805","4756","167","208","3972","4964","1"
"7","2017","31","Hotel","12","24","807","1555","527","929","1334","2484","1"
"7","2017","31","Hotel","12","35","389","779","179","334","568","1113","1"
"7","2017","31","Hotel","2","6","237","586","20","20","257","606","1"
"7","2017","31","Hotel","13","33","1181","1181","56","56","1237","1237","1"
"7","2017","31","Hotel","10","27","1277","1971","799","1218","2076","3189","1"
"7","2017","31","Hotel","10","23","952","1461","255","380","1207","1841","1"
"7","2017","31","Hotel","11","36","1291","2027","140","598","1431","2625","1"
"7","2017","31","Hotel","8","34","1580","2319","86","172","1666","2491","1"
"7","2017","31","Hotel","2","6","511","1514","65","380","576","1894","1"
"7","2017","31","Hotel","14","31","816","1332","1504","2532","2320","3864","7.8"
"7","2017","31","Hotel","11","36","2228","3632","155","249","2383","3881","1"
"7","2017","31","","10","27","1025","3894","126","870","1151","4764","1"
"7","2017","31","Hotel","14","31","1683","2582","3319","11580","5002","14162","5.4"
"7","2017","31","Hotel","4","13","2242","2252","4","8","2246","2260","1"
"7","2017","31","Hotel","6","28","1156","1348","68","85","1224","1433","1"
"7","2017","31","Otros","14","31","68","68","0","0","68","68","2.8"
"7","2017","31","Otros","16","27","54","108","0","0","54","108","2"
"7","2017","31","Hotel","2","1","994","1642","78","143","1072","1785","2"
"7","2017","31","Hotel","10","18","1195","2018","337","569","1532","2587","1"
"7","2017","31","Hotel","7","17","1304","1645","59","97","1363","1742","1"
"7","2017","31","Hotel","12","24","454","1357","452","1711","906","3068","1"
"7","2017","31","Hotel","10","18","710","2401","136","145","846","2546","1"
"7","2017","31","Hotel","2","1","1922","2240","29","58","1951","2298","1"
"7","2017","31","Hotel","10","18","687","1375","151","343","838","1718","1"
"7","2017","31","Hotel","6","28","1753","2626","337","414","2090","3040","1"
"7","2017","31","Hotel","5","5","442","1098","91","308","533","1406","1"
"7","2017","31","Hotel","4","13","501","853","81","276","582","1129","1"
"7","2017","31","Hotel","10","18","1390","2425","265","462","1655","2887","1"
"7","2017","31","Hotel","16","40","873","1438","50","63","923","1501","1"
"7","2017","31","Hotel","8","3","916","2012","282","658","1198","2670","1"
"7","2017","31","Hotel","15","16","1101","1638","131","200","1232","1838","2"
"7","2017","31","Hotel","14","31","111","198","484","2160","595","2358","7.8"
"7","2017","31","Hotel","13","33","274","426","185","435","459","861","1"
"7","2017","31","Hotel","15","16","1305","2116","223","407","1528","2523","2"
"7","2017","31","Otros","4","21","302","828","0","0","302","828","1"
"7","2017","31","Hotel","6","10","1183","2526","233","621","1416","3147","1"
"7","2017","31","Hotel","16","19","235","464","3","6","238","470","1"
"7","2017","31","Hotel","16","27","1119","3287","6","17","1125","3304","1"
"7","2017","31","Hotel","10","11","1380","1916","46","81","1426","1997","1"
"7","2017","31","Otros","10","23","656","1383","12","21","668","1404","1"
"7","2017","0","Hotel","12","35","0","0","0","0","0","0","1"
"7","2017","31","Hotel","11","36","664","1208","47","116","711","1324","1"
"7","2017","31","Hotel","14","31","50","143","282","1784","332","1927","17.4"
"7","2017","31","Hotel","10","18","823","1871","388","852","1211","2723","3.2"
"7","2017","31","Hotel","4","13","505","717","3","3","508","720","1"
"7","2017","31","Hotel","6","12","504","731","100","185","604","916","5"
"7","2017","31","Hotel","6","10","984","1240","56","100","1040","1340","1"
"7","2017","31","Otros","5","5","148","301","89","118","237","419","3.65625"
"7","2017","31","Hotel","12","24","715","822","680","1369","1395","2191","1"
"7","2017","31","Hotel","8","3","1278","3120","330","759","1608","3879","1"
"7","2017","31","Hotel","13","27","1040","2083","0","0","1040","2083","2.75"
"7","2017","31","Hotel","15","16","156","461","109","446","265","907","4"
"7","2017","31","Otros","15","16","409","1499","73","254","482","1753","2"
"7","2017","31","Otros","16","20","250","413","0","0","250","413","1"
"7","2017","31","Hotel","3","4","1217","1547","0","0","1217","1547","1"
"7","2017","31","Hotel","11","36","103","129","0","0","103","129","1"
"7","2017","31","Hotel","2","6","257","1604","41","252","298","1856","1"
"7","2017","31","Hotel","8","34","860","1455","177","296","1037","1751","1"
"7","2017","31","Hotel","4","13","8","16","4","7","12","23","3.2"
"7","2017","31","Hotel","13","27","1332","2825","0","0","1332","2825","2.75"
"7","2017","31","Hotel","2","29","112","495","214","987","326","1482","1"
"7","2017","31","Otros","11","36","120","246","0","0","120","246","1"
"7","2017","31","","10","11","13","13","0","0","13","13","1"
"7","2017","31","Hotel","4","13","1153","1487","34","115","1187","1602","1"
"7","2017","31","Hotel","16","40","2794","4193","525","789","3319","4982","5.6666666666667"
"7","2017","31","Hotel","10","23","1068","1782","358","638","1426","2420","2.8"
"7","2017","31","Hotel","8","34","1094","2062","719","1464","1813","3526","1"
"7","2017","31","Hotel","5","5","300","760","46","54","346","814","1"
"7","2017","31","Hotel","3","4","117","236","53","104","170","340","3"
"7","2017","31","Hotel","9","26","73","187","5","21","78","208","1"
"7","2017","31","Hotel","8","34","770","1022","415","779","1185","1801","1"
"7","2017","31","Hotel","7","17","177","299","13","27","190","326","4"
"7","2017","31","Hotel","4","13","234","651","55","147","289","798","3.2"
"7","2017","31","Hotel","12","35","25","105","69","252","94","357","1"
"7","2017","31","Hotel","16","40","829","1603","517","957","1346","2560","1"
"7","2017","31","Hotel","9","26","345","572","45","178","390","750","1"
"7","2017","31","","6","27","162","266","15","38","177","304","1"
"7","2017","31","Hotel","9","26","238","387","2","2","240","389","1"
"7","2017","31","Hotel","4","13","169","217","61","178","230","395","3.2"
"7","2017","31","Hotel","6","28","590","671","18","18","608","689","1"
"7","2017","31","","2","29","113","333","548","1805","661","2138","1"
"7","2017","31","Hotel","14","31","36","109","218","832","254","941","1"
"7","2017","31","Hotel","13","33","1468","1853","97","148","1565","2001","1"
"7","2017","31","Hotel","8","3","399","1002","153","406","552","1408","1"
"7","2017","31","Hotel","14","27","547","665","1164","1398","1711","2063","1"
"7","2017","31","Hotel","16","40","398","725","7","12","405","737","5.6666666666667"
"7","2017","31","Hotel","12","24","372","624","427","730","799","1354","1"
"7","2017","31","Hotel","10","18","1491","2150","82","184","1573","2334","3.2"
"7","2017","31","Otros","15","16","118","118","19","19","137","137","9"
"7","2017","31","Hotel","6","10","619","732","18","18","637","750","1"
"7","2017","31","Hotel","10","11","644","1060","24","76","668","1136","1"
"7","2017","31","Otros","6","10","119","303","9","50","128","353","3.8518518518518"
"7","2017","31","Otros","10","23","35","165","0","0","35","165","1"
"7","2017","31","Hotel","10","23","495","703","220","448","715","1151","2.8"
"7","2017","31","Hotel","6","12","139","165","13","13","152","178","5"
"7","2017","31","Hotel","6","27","93","147","2","2","95","149","3"
"7","2017","31","Hotel","10","23","586","996","324","676","910","1672","2.8"
"7","2017","31","","4","39","212","495","0","0","212","495","1"
"7","2017","31","Hotel","8","34","427","605","545","891","972","1496","1"
"7","2017","31","Hotel","8","34","544","817","227","308","771","1125","1"
"7","2017","31","Otros","4","39","3","3","0","0","3","3","2.2222222222222"
"7","2017","31","Otros","13","14","88","176","0","0","88","176","1"
"7","2017","31","Hotel","10","23","320","427","46","92","366","519","2.8"
"7","2017","31","Otros","13","14","400","1200","0","0","400","1200","1"
"7","2017","31","Hotel","12","24","482","706","266","540","748","1246","1"
"7","2017","31","","6","25","126","252","0","0","126","252","1"
"7","2017","31","Hotel","15","27","602","1022","12","22","614","1044","1"
"7","2017","0","Hotel","12","35","0","0","0","0","0","0","1"
"7","2017","31","Hotel","16","40","144","290","0","0","144","290","1"
"7","2017","31","Hotel","16","27","577","2492","2186","9216","2763","11708","1"
"7","2017","31","Hotel","9","30","51","132","0","0","51","132","1"
"7","2017","31","Hotel","4","13","348","727","70","135","418","862","3.2"
"7","2017","31","Hotel","2","29","183","590","152","566","335","1156","1"
"7","2017","31","Hotel","16","20","489","798","48","91","537","889","1"
"7","2017","31","Hotel","5","5","568","683","112","169","680","852","1"
"7","2017","31","Hotel","13","33","701","1108","80","151","781","1259","1"
"7","2017","31","Otros","16","19","101","179","0","0","101","179","1.3333333333333"
"7","2017","31","Hotel","12","24","110","281","367","706","477","987","1"
"7","2017","31","","8","2","774","1931","21","46","795","1977","1"
"7","2017","0","Hotel","12","35","0","0","0","0","0","0","1"
"7","2017","31","Hotel","16","27","41","60","713","832","754","892","2.5"
"7","2017","31","Otros","16","27","776","1193","10","20","786","1213","2"
"7","2017","31","Hotel","8","34","378","611","262","429","640","1040","1"
"7","2017","31","Otros","8","3","230","732","0","0","230","732","1"
"7","2017","31","Hotel","7","27","209","320","62","87","271","407","1"
"7","2017","31","Hotel","4","39","242","401","7","9","249","410","1"
"7","2017","31","Hotel","15","16","174","352","12","44","186","396","4"
"7","2017","31","Hotel","4","39","14","28","0","0","14","28","1"
"7","2017","31","Hotel","4","39","247","449","1","1","248","450","1"
"7","2017","31","Hotel","15","16","235","622","21","43","256","665","4"
"7","2017","31","Hotel","14","31","184","387","112","284","296","671","17.4"
"7","2017","31","Hotel","8","34","373","500","332","506","705","1006","1"
"7","2017","31","Hotel","6","28","248","353","33","59","281","412","1"
"7","2017","31","Hotel","7","17","1013","1572","28","54","1041","1626","4"
"7","2017","31","Otros","7","27","27","299","0","0","27","299","1"
"7","2017","31","Hotel","11","36","1141","1368","40","100","1181","1468","1"
"7","2017","31","Otros","4","21","481","920","29","45","510","965","1"
"7","2017","31","Otros","15","16","122","204","41","66","163","270","2"
"7","2017","31","Otros","7","17","409","1102","0","0","409","1102","3"
"7","2017","31","Hotel","7","38","195","228","9","12","204","240","1"
"7","2017","31","Hotel","16","27","581","754","25","54","606","808","2.5"
"7","2017","31","Hotel","2","6","49","86","2","2","51","88","2.2"
"7","2017","31","Hotel","11","36","343","569","85","151","428","720","1"
"7","2017","31","Hotel","6","28","85","109","8","18","93","127","1"
"7","2017","31","Hotel","6","12","55","95","0","0","55","95","5"
"7","2017","31","Otros","9","22","55","84","0","0","55","84","1"
"7","2017","31","","13","14","129","198","0","0","129","198","2"
"7","2017","31","Hotel","2","29","102","121","203","398","305","519","1"
"7","2017","31","Hotel","2","29","17","73","44","299","61","372","1"
"7","2017","31","Otros","4","13","445","458","13","13","458","471","1"
"7","2017","31","Hotel","15","16","109","198","33","70","142","268","4"
"7","2017","31","Hotel","2","1","109","348","0","0","109","348","6.4"
"7","2017","31","Otros","7","27","86","150","0","0","86","150","1"
"7","2017","31","Otros","13","33","67","73","0","0","67","73","5.125"
"7","2017","31","","4","21","348","419","7","9","355","428","1"
"7","2017","31","Hotel","6","10","371","371","4","4","375","375","1"
"7","2017","31","Hotel","11","36","62","136","0","0","62","136","1"
"7","2017","31","Otros","14","31","122","141","55","116","177","257","2.8"
"7","2017","31","Hotel","7","27","173","267","5","8","178","275","1"
"7","2017","31","Otros","6","10","46","57","0","0","46","57","3.8518518518518"
"7","2017","31","Hotel","4","39","60","70","4","4","64","74","2.6"
"7","2017","31","Otros","8","2","128","516","5","9","133","525","6.4285714285714"
"7","2017","31","Otros","11","36","42","101","8","10","50","111","5.1904761904762"
"7","2017","31","Hotel","13","33","178","178","0","0","178","178","1"
"7","2017","31","","3","4","90","209","78","101","168","310","1"
"7","2017","31","Hotel","7","17","331","810","30","71","361","881","4"
"7","2017","31","Hotel","8","2","533","935","10","34","543","969","1"
"7","2017","31","Otros","15","16","272","413","43","44","315","457","2"
"7","2017","31","Hotel","10","11","250","404","1","1","251","405","1"
"7","2017","31","Hotel","16","19","252","382","0","0","252","382","1"
"7","2017","31","Hotel","10","23","80","111","42","52","122","163","4"
"7","2017","31","","7","38","283","376","19","21","302","397","1"
"7","2017","31","Hotel","7","27","88","176","0","0","88","176","1"
"7","2017","31","Hotel","11","36","398","957","57","103","455","1060","1"
"7","2017","31","Hotel","16","40","165","262","15","26","180","288","16.333333333333"
"7","2017","31","Hotel","16","19","22","53","0","0","22","53","1"
"7","2017","31","Hotel","16","19","0","0","0","0","0","0","1"
"7","2017","0","Hotel","16","20","0","0","0","0","0","0","1"
"7","2017","31","Hotel","10","11","226","352","12","22","238","374","1"
"7","2017","31","Otros","7","27","67","140","0","0","67","140","4.8333333333333"
"7","2017","31","Otros","7","27","28","88","0","0","28","88","1"
"7","2017","31","Hotel","7","27","50","58","1","1","51","59","4.1666666666667"
"7","2017","31","Otros","13","14","102","158","0","0","102","158","1"
"7","2017","31","Otros","11","15","51","53","0","0","51","53","2.3571428571429"
"7","2017","31","Otros","10","27","19","19","28","44","47","63","4.84"
"7","2017","31","Otros","14","31","193","193","2521","2521","2714","2714","2.8"
"7","2017","31","Otros","11","36","16","33","0","0","16","33","5.1904761904762"
"7","2017","31","Hotel","16","19","108","118","4","8","112","126","1"
"7","2017","31","","14","27","152","194","22","26","174","220","2.6666666666667"
"7","2017","31","Hotel","16","40","90","183","4","4","94","187","5.6666666666667"
"7","2017","31","Hotel","10","27","8","30","0","0","8","30","2.25"
"7","2017","31","Otros","2","29","91","210","187","480","278","690","3.28"
"7","2017","31","Hotel","13","27","525","1575","8","25","533","1600","1"
"7","2017","31","Otros","9","22","30","36","0","0","30","36","1"
"7","2017","31","Hotel","2","27","119","166","5","9","124","175","1"
"7","2017","31","Hotel","8","34","217","324","443","575","660","899","1"
"7","2017","31","Hotel","7","27","316","526","0","0","316","526","1"
"7","2017","31","Hotel","15","16","299","627","36","63","335","690","4"
"7","2017","31","Hotel","16","20","33","60","0","0","33","60","1"
"7","2017","31","Otros","4","13","57","250","0","0","57","250","1"
"7","2017","31","Hotel","2","1","210","501","11","27","221","528","6.4"
"7","2017","31","Otros","11","32","23","67","0","0","23","67","2.2857142857143"
"7","2017","31","Hotel","2","29","27","131","134","1098","161","1229","1"
"7","2017","31","Hotel","16","27","111","134","163","195","274","329","2.5"
"7","2017","31","Hotel","10","18","122","496","0","0","122","496","3.2"
"7","2017","31","Otros","11","36","438","591","51","55","489","646","1"
"7","2017","31","Otros","13","14","37","72","0","0","37","72","1"
"7","2017","31","Hotel","7","27","154","261","0","0","154","261","1"
"7","2017","31","Otros","7","17","276","583","0","0","276","583","3"
"7","2017","31","Otros","14","31","264","264","249","249","513","513","2.8"
"7","2017","31","Hotel","2","29","118","431","312","1191","430","1622","1"
"7","2017","31","Hotel","8","3","188","475","0","0","188","475","1"
"7","2017","31","Hotel","8","34","302","495","115","230","417","725","2.5714285714286"
"7","2017","31","Hotel","8","34","272","367","133","383","405","750","2.5714285714286"
"7","2017","31","Hotel","12","35","102","126","68","86","170","212","1"
"7","2017","31","Hotel","11","32","150","391","18","37","168","428","1"
"7","2017","31","Hotel","13","33","192","269","5","5","197","274","2"
"7","2017","31","Hotel","10","23","146","269","30","40","176","309","2.8"
"7","2017","31","Hotel","12","35","77","287","5","5","82","292","1"
"7","2017","31","","16","40","371","512","52","105","423","617","3.0555555555556"
"7","2017","31","Otros","16","19","6","10","0","0","6","10","1.3333333333333"
"7","2017","31","Otros","16","20","31","82","0","0","31","82","1"
"7","2017","31","Hotel","6","12","208","443","8","14","216","457","5"
"7","2017","31","Hotel","16","19","176","306","0","0","176","306","4"
"7","2017","31","Hotel","12","24","107","333","44","131","151","464","1"
"7","2017","31","Hotel","12","24","140","311","91","158","231","469","3"
"7","2017","0","Hotel","8","3","0","0","0","0","0","0","1"
"7","2017","31","Hotel","5","9","0","0","0","0","0","0","1"
"7","2017","31","Hotel","16","27","294","519","15","28","309","547","2.5"
"7","2017","27","Otros","10","23","32","32","0","0","32","32","7"
"7","2017","31","Otros","13","14","79","128","0","0","79","128","7.3846153846154"
"7","2017","31","Otros","2","6","41","97","9","20","50","117","1"
"7","2017","24","Hotel","15","16","13","15","166","219","179","234","7.8"
"7","2017","31","Hotel","8","3","268","658","0","0","268","658","1"
"7","2017","31","Hotel","8","34","300","484","389","758","689","1242","1"
"7","2017","31","Hotel","8","3","109","214","29","51","138","265","1"
"7","2017","31","","2","29","87","196","68","168","155","364","1"
"7","2017","31","Hotel","2","1","228","361","42","64","270","425","6.4"
"7","2017","31","Hotel","7","17","141","231","8","9","149","240","4"
"7","2017","31","Otros","7","17","210","796","0","0","210","796","3"
"7","2017","31","Hotel","16","40","86","145","37","101","123","246","5.6666666666667"
"7","2017","31","Hotel","12","24","175","456","168","246","343","702","1"
"7","2017","31","Hotel","14","31","219","397","360","1536","579","1933","17.4"
"7","2017","0","Hotel","9","26","0","0","0","0","0","0","1"
"7","2017","31","Hotel","6","12","39","52","5","5","44","57","5"
"7","2017","30","Otros","5","9","10","10","2","2","12","12","4.0454545454545"
"7","2017","31","Otros","5","9","3","5","0","0","3","5","4.0454545454545"
"7","2017","31","Otros","15","27","131","228","0","0","131","228","1.4222222222222"
"7","2017","31","Hotel","8","34","3","3","4","4","7","7","2.5714285714286"
"7","2017","31","Hotel","10","18","346","738","52","117","398","855","7.75"
"7","2017","31","Hotel","15","16","315","682","56","120","371","802","7.8"
"7","2017","31","Hotel","2","29","122","372","187","638","309","1010","1"
"7","2017","31","Hotel","4","39","164","290","14","16","178","306","2.6"
"7","2017","31","Otros","4","39","142","240","2","2","144","242","2.2222222222222"
"7","2017","31","Hotel","4","13","238","492","27","67","265","559","5.4"
"7","2017","31","Otros","10","23","70","70","7","7","77","77","7"
"7","2017","31","Otros","14","31","126","206","337","969","463","1175","20.2"
"7","2017","31","Hotel","3","4","38","56","15","29","53","85","2.6"
"7","2017","31","Hotel","10","23","115","167","29","33","144","200","4"
"7","2017","31","Otros","9","22","286","500","2","4","288","504","1"
"7","2017","31","Hotel","12","24","186","470","120","199","306","669","3"
"7","2017","31","Hotel","13","14","2","2","0","0","2","2","1"
"7","2017","31","Hotel","12","35","215","262","61","86","276","348","1.7272727272727"
"7","2017","31","Hotel","6","28","437","643","0","0","437","643","1"
"7","2017","31","","6","28","44","70","0","0","44","70","1"
"7","2017","31","Hotel","12","24","240","473","154","270","394","743","3"
"7","2017","31","Otros","5","9","0","0","3","3","3","3","4.0454545454545"
"7","2017","31","Hotel","16","20","28","32","0","0","28","32","1"
"7","2017","31","Hotel","4","21","270","380","7","7","277","387","3"
"7","2017","31","Otros","10","11","26","36","1","1","27","37","11.764705882353"
"7","2017","31","Otros","13","14","16","34","0","0","16","34","7.3846153846154"
"7","2017","31","Otros","16","27","19","25","0","0","19","25","13.818181818182"
"7","2017","31","Hotel","9","26","230","230","22","22","252","252","1"
"7","2017","31","Hotel","16","27","259","505","276","498","535","1003","2.5"
"7","2017","31","Hotel","3","4","1679","2414","160","340","1839","2754","3"
"7","2017","31","Otros","16","27","92","92","0","0","92","92","2"
"7","2017","31","Otros","16","19","769","1412","2","2","771","1414","1.3333333333333"
"7","2017","31","Hotel","6","12","393","592","14","15","407","607","5"
"7","2017","31","Hotel","2","1","261","658","7","10","268","668","6.4"
"7","2017","31","Hotel","10","11","373","569","12","20","385","589","1"
"7","2017","31","Otros","10","23","98","98","0","0","98","98","1"
"7","2017","31","Otros","10","27","606","713","48","53","654","766","4.84"
"7","2017","31","Hotel","16","27","82","451","16","178","98","629","2.5"
"7","2017","31","Hotel","6","28","186","228","22","25","208","253","1"
"7","2017","31","Hotel","4","13","103","251","11","11","114","262","5.4"
"7","2017","31","Hotel","14","27","657","888","32","51","689","939","8.5"
"7","2017","31","Hotel","10","27","120","190","337","419","457","609","1"
"7","2017","31","Hotel","13","27","91","125","39","47","130","172","4.2"
"7","2017","31","Hotel","3","4","625","886","20","33","645","919","3"
"7","2017","31","Otros","4","13","69","69","2","2","71","71","3.4"
"7","2017","31","Otros","11","15","31","60","0","0","31","60","2.3571428571429"
"7","2017","31","Otros","6","10","270","741","90","220","360","961","3.8518518518518"
"7","2017","31","Otros","2","1","76","85","3","5","79","90","1"
"7","2017","31","","6","12","41","118","0","0","41","118","1"
"7","2017","31","Otros","10","23","235","776","0","0","235","776","1"
"7","2017","31","Hotel","16","19","84","166","0","0","84","166","4"
"7","2017","31","Hotel","10","11","21","105","0","0","21","105","5.6666666666667"
"7","2017","31","Hotel","10","23","87","87","6","6","93","93","4"
"7","2017","31","Otros","14","31","80","196","259","646","339","842","2.8"
"7","2017","31","Otros","13","27","5","5","0","0","5","5","12.2"
"7","2017","31","Hotel","2","1","262","950","0","0","262","950","6.4"
"7","2017","31","Hotel","16","19","42","49","0","0","42","49","4"
"7","2017","31","Otros","12","35","10","15","2","2","12","17","3.5"
"7","2017","31","Otros","15","16","191","498","31","52","222","550","2"
"7","2017","31","Otros","9","22","185","370","20","40","205","410","1"
"7","2017","31","Hotel","10","27","269","374","700","868","969","1242","1"
"7","2017","31","Hotel","2","27","116","143","0","0","116","143","3.6"
"7","2017","31","Hotel","16","20","126","316","54","120","180","436","1"
"7","2017","31","Hotel","10","18","175","309","38","73","213","382","7.75"
"7","2017","31","Hotel","6","12","329","331","0","0","329","331","5"
"7","2017","31","Hotel","2","27","49","117","1","2","50","119","3.6"
"7","2017","31","Hotel","15","16","211","472","31","56","242","528","7.8"
"7","2017","31","Hotel","10","23","76","76","5","5","81","81","4"
"7","2017","31","Hotel","11","32","66","92","4","4","70","96","1"
"7","2017","31","Hotel","14","27","148","353","56","199","204","552","8.5"
"7","2017","31","Otros","10","11","27","31","0","0","27","31","11.764705882353"
"7","2017","31","Hotel","2","27","81","131","9","14","90","145","3.6"
"7","2017","31","Otros","13","14","160","480","0","0","160","480","7.3846153846154"
"7","2017","31","Hotel","2","1","154","238","18","18","172","256","6.4"
"7","2017","31","Otros","7","17","202","802","0","0","202","802","17.166666666667"
"7","2017","31","Otros","10","23","20","196","0","0","20","196","7"
"7","2017","21","Hotel","13","27","154","154","0","0","154","154","2.75"
"7","2017","31","Otros","10","18","33","110","13","20","46","130","10.25"
"7","2017","31","Otros","5","9","25","38","0","0","25","38","4.0454545454545"
"7","2017","31","Hotel","4","39","38","47","10","16","48","63","2.6"
"7","2017","31","Otros","16","27","106","327","0","0","106","327","13.818181818182"
"7","2017","31","Hotel","14","27","46","86","101","315","147","401","8.5"
"7","2017","31","Hotel","10","11","76","158","6","6","82","164","5.6666666666667"
"7","2017","31","Hotel","10","18","220","318","53","104","273","422","7.75"
"7","2017","31","Otros","14","31","194","306","136","236","330","542","20.2"
"7","2017","31","Otros","11","32","46","60","0","0","46","60","2.2857142857143"
"7","2017","31","Otros","5","5","85","85","0","0","85","85","3.65625"
"7","2017","31","Otros","6","25","13","26","0","0","13","26","2.3846153846154"
"7","2017","31","Hotel","3","4","67","200","8","24","75","224","2.6"
"7","2017","31","Otros","7","27","120","180","5","5","125","185","4.8333333333333"
"7","2017","31","Otros","2","29","160","306","117","252","277","558","3.28"
"7","2017","31","Hotel","2","29","99","143","111","212","210","355","1"
"7","2017","31","Otros","4","21","136","341","7","14","143","355","1"
"7","2017","31","Hotel","7","27","182","188","0","0","182","188","4.1666666666667"
"7","2017","31","Otros","5","5","13","71","5","15","18","86","3.65625"
"7","2017","31","Otros","11","36","54","99","22","39","76","138","5.1904761904762"
"7","2017","31","Hotel","7","27","370","370","0","0","370","370","4.1666666666667"
"7","2017","31","Hotel","16","20","0","0","0","0","0","0","1"
"7","2017","31","Hotel","12","24","78","164","69","97","147","261","3"
"7","2017","31","Hotel","9","26","124","152","10","10","134","162","1.5"
"7","2017","31","Hotel","7","17","326","733","0","0","326","733","10"
"7","2017","31","Hotel","9","37","189","315","44","63","233","378","3.4"
"7","2017","31","Hotel","5","5","231","428","86","129","317","557","2.1428571428571"
"7","2017","31","Otros","6","27","28","56","0","0","28","56","3.960088691796"
"7","2017","31","Hotel","9","37","35","47","1","14","36","61","3.4"
"7","2017","31","Otros","10","27","22","33","64","98","86","131","4.84"
"7","2017","31","Otros","8","3","337","589","22","38","359","627","10"
"7","2017","31","Otros","16","20","20","20","0","0","20","20","3.0769230769231"
"7","2017","31","Otros","9","22","7","13","0","0","7","13","7.6428571428571"
"7","2017","31","Otros","10","27","156","206","4","4","160","210","4.84"
"7","2017","31","Otros","10","23","34","48","0","0","34","48","7"
"7","2017","31","Otros","2","6","484","484","90","90","574","574","1"
"7","2017","31","Otros","4","39","15","35","0","0","15","35","2.2222222222222"
"7","2017","31","Hotel","2","27","126","152","12","15","138","167","1"
"7","2017","31","Hotel","14","31","34","63","109","507","143","570","24"
"7","2017","31","Otros","2","29","136","320","16","46","152","366","3.28"
"7","2017","31","Otros","8","3","308","1540","0","0","308","1540","10"
"7","2017","31","","13","14","26","30","5","5","31","35","1"
"7","2017","31","Hotel","6","10","258","362","23","30","281","392","6.6"
"7","2017","31","Hotel","8","34","203","300","45","64","248","364","2.5714285714286"
"7","2017","31","Hotel","9","22","231","678","0","0","231","678","2.5555555555556"
"7","2017","31","Hotel","2","6","86","167","9","16","95","183","2.2"
"7","2017","31","Hotel","10","27","89","209","178","302","267","511","2.25"
"7","2017","31","Otros","14","27","138","138","0","0","138","138","11.833333333333"
"7","2017","31","Otros","6","12","326","586","5","10","331","596","1.8256578947368"
"7","2017","31","Hotel","6","27","188","454","0","0","188","454","3"
"7","2017","31","Hotel","5","5","12","22","4","16","16","38","2.1428571428571"
"7","2017","31","Hotel","5","5","37","53","6","7","43","60","2.1428571428571"
"7","2017","31","Hotel","13","27","225","240","0","0","225","240","4.2"
"7","2017","31","Hotel","2","27","143","199","7","10","150","209","3.6"
"7","2017","31","Hotel","8","3","65","65","68","68","133","133","4.1111111111111"
"7","2017","31","Otros","11","36","54","198","2","2","56","200","5.1904761904762"
"7","2017","31","Otros","9","30","77","115","0","0","77","115","2.3333333333333"
"7","2017","31","Otros","16","19","24","24","0","0","24","24","10.263157894737"
"7","2017","31","Hotel","14","31","75","94","391","1232","466","1326","17.4"
"7","2017","31","Hotel","2","1","341","391","10","14","351","405","6.4"
"7","2017","31","Hotel","16","40","984","1852","196","313","1180","2165","5.6666666666667"
"7","2017","31","Otros","7","17","430","740","4","4","434","744","17.166666666667"
"7","2017","31","Hotel","13","27","366","430","60","86","426","516","2.75"
"7","2017","31","Hotel","14","31","190","262","507","1022","697","1284","24"
"7","2017","31","Otros","3","4","47","106","6","10","53","116","12.2"
"7","2017","31","Otros","8","34","116","147","244","435","360","582","5.75"
"7","2017","31","Hotel","9","22","60","65","0","0","60","65","2.5555555555556"
"7","2017","31","Hotel","4","21","70","126","2","4","72","130","3"
"7","2017","31","Hotel","6","27","89","151","0","0","89","151","3"
"7","2017","31","Hotel","12","35","65","102","33","39","98","141","1.7272727272727"
"7","2017","31","Hotel","2","29","24","61","41","99","65","160","2"
"7","2017","31","Otros","10","11","46","63","5","8","51","71","11.764705882353"
"7","2017","31","Hotel","6","10","107","226","2","2","109","228","6.6"
"7","2017","31","Hotel","13","14","26","46","0","0","26","46","2"
"7","2017","31","Otros","16","27","14","18","0","0","14","18","13.818181818182"
"7","2017","31","Otros","6","27","23","23","0","0","23","23","3.960088691796"
"7","2017","31","Hotel","16","40","273","273","113","115","386","388","5.6666666666667"
"7","2017","31","Otros","6","10","331","874","0","0","331","874","3.8518518518518"
"7","2017","31","Otros","10","23","38","52","23","37","61","89","7"
"7","2017","31","Hotel","6","28","223","281","4","4","227","285","1"
"7","2017","31","Otros","7","38","350","629","244","458","594","1087","2.75"
"7","2017","31","Hotel","6","12","198","294","2","4","200","298","5"
"7","2017","31","Hotel","13","27","420","687","2","5","422","692","4.2"
"7","2017","31","Otros","4","21","28","54","0","0","28","54","4.8333333333333"
"7","2017","31","Hotel","16","27","97","165","10","10","107","175","5.8571428571429"
"7","2017","31","Hotel","5","5","54","109","16","43","70","152","2.1428571428571"
"7","2017","31","Otros","12","24","63","107","76","142","139","249","9.2"
"7","2017","31","Otros","15","16","113","214","21","24","134","238","9"
"7","2017","31","Hotel","8","27","129","129","0","0","129","129","4.5"
"7","2017","31","Hotel","9","22","2","17","0","0","2","17","2.5555555555556"
"7","2017","31","Hotel","10","11","98","156","7","14","105","170","5.6666666666667"
"7","2017","31","Hotel","8","3","112","250","53","127","165","377","4.1111111111111"
"7","2017","31","Hotel","6","10","494","625","0","0","494","625","6.6"
"7","2017","31","Otros","9","26","24","51","0","0","24","51","3.8888888888889"
"7","2017","31","Hotel","4","39","58","169","5","101","63","270","2.6"
"7","2017","31","Otros","6","27","2","4","0","0","2","4","3.960088691796"
"7","2017","31","Otros","6","12","143","182","0","0","143","182","1.8256578947368"
"7","2017","31","Hotel","6","27","83","171","0","0","83","171","3"
"7","2017","31","Otros","5","9","47","84","10","19","57","103","4.0454545454545"
"7","2017","31","Hotel","2","27","147","147","12","12","159","159","3.6"
"7","2017","28","Hotel","2","29","12","44","181","498","193","542","1"
"7","2017","31","Hotel","4","13","63","101","5","17","68","118","5.4"
"7","2017","31","","11","15","14","280","0","0","14","280","1"
"7","2017","31","Hotel","6","10","346","387","20","32","366","419","6.6"
"7","2017","31","Otros","6","12","11","44","0","0","11","44","1.8256578947368"
"7","2017","31","Otros","10","18","25","25","4","4","29","29","10.25"
"7","2017","31","Otros","9","22","221","340","0","0","221","340","7.6428571428571"
"7","2017","31","","14","27","269","339","11","22","280","361","1"
"7","2017","31","Hotel","16","27","104","142","5","9","109","151","5.8571428571429"
"7","2017","31","Otros","2","29","25","58","32","62","57","120","3.28"
"7","2017","31","Otros","13","33","49","51","0","0","49","51","5.125"
"7","2017","31","Otros","13","33","21","27","0","0","21","27","5.125"
"7","2017","31","Otros","6","10","41","108","0","0","41","108","3.8518518518518"
"7","2017","31","Hotel","10","18","123","180","36","78","159","258","7.75"
"7","2017","31","Hotel","14","31","167","277","66","216","233","493","24"
"7","2017","31","Hotel","4","21","8","8","9","9","17","17","3"
"7","2017","31","Hotel","3","4","34","146","0","0","34","146","2.6"
"7","2017","0","Otros","8","27","0","0","0","0","0","0","1"
"7","2017","31","Otros","6","27","8","18","0","0","8","18","3.960088691796"
"7","2017","31","Hotel","6","25","360","425","0","0","360","425","1"
"7","2017","31","Otros","6","12","199","383","17","17","216","400","1.8256578947368"
"7","2017","31","Hotel","6","27","17","19","0","0","17","19","3"
"7","2017","31","Otros","6","27","2","2","0","0","2","2","3.960088691796"
"7","2017","31","Otros","6","10","125","208","0","0","125","208","3.8518518518518"
"7","2017","31","Otros","6","12","71","115","0","0","71","115","1.8256578947368"
"7","2017","31","Otros","5","5","16","30","0","0","16","30","3.65625"
"7","2017","31","Hotel","12","24","377","498","23","47","400","545","3"
"7","2017","31","Hotel","15","16","94","154","0","0","94","154","7.8"
"7","2017","31","Otros","4","13","24","24","0","0","24","24","3.4"
"7","2017","31","Hotel","2","29","145","526","69","246","214","772","1"
"7","2017","31","Hotel","4","21","13","27","0","0","13","27","3"
"7","2017","31","Hotel","10","27","134","186","62","76","196","262","2.25"
"7","2017","31","Hotel","8","3","204","318","63","91","267","409","4.1111111111111"
"7","2017","31","Hotel","12","27","46","56","19","35","65","91","1"
"7","2017","31","Otros","5","5","86","132","29","54","115","186","3.65625"
"7","2017","31","Otros","13","14","37","50","0","0","37","50","7.3846153846154"
"7","2017","31","Otros","10","11","279","428","0","0","279","428","11.764705882353"
"7","2017","31","Otros","16","40","158","320","5","5","163","325","28.142857142857"
"7","2017","31","Hotel","11","36","345","725","32","63","377","788","1"
"7","2017","31","Otros","8","34","74","107","43","70","117","177","5.75"
"7","2017","31","Hotel","7","17","167","305","10","52","177","357","10"
"7","2017","31","Otros","12","35","174","277","14","23","188","300","3.5"
"7","2017","31","Otros","5","9","28","34","7","12","35","46","4.0454545454545"
"7","2017","31","Hotel","9","22","38","62","0","0","38","62","2.5555555555556"
"7","2017","31","Otros","2","29","33","78","48","101","81","179","3.28"
"7","2017","31","Otros","2","29","61","139","59","134","120","273","3.28"
"7","2017","31","Hotel","10","27","80","238","40","55","120","293","2.25"
"7","2017","31","Hotel","16","19","65","80","12","22","77","102","4"
"7","2017","31","Hotel","16","40","174","286","27","70","201","356","16.333333333333"
"7","2017","31","Hotel","8","27","204","368","50","71","254","439","4.5"
"7","2017","31","Otros","13","14","11","38","0","0","11","38","7.3846153846154"
"7","2017","31","Hotel","7","27","58","70","0","0","58","70","4.1666666666667"
"7","2017","31","Otros","2","6","5","7","0","0","5","7","5"
"7","2017","31","Hotel","7","17","452","918","4","4","456","922","10"
"7","2017","31","Hotel","3","4","143","323","40","89","183","412","2.6"
"7","2017","31","Otros","6","12","14","90","0","0","14","90","1.8256578947368"
"7","2017","31","Otros","6","10","27","34","0","0","27","34","3.8518518518518"
"7","2017","31","Hotel","16","40","32","72","6","14","38","86","16.333333333333"
"7","2017","31","Otros","4","39","47","68","0","0","47","68","2.2222222222222"
"7","2017","31","Otros","13","14","26","52","0","0","26","52","7.3846153846154"
"7","2017","31","Otros","7","38","122","189","4","4","126","193","2.75"
"7","2017","31","Hotel","11","32","176","363","0","0","176","363","1"
"7","2017","31","Otros","11","36","137","297","12","18","149","315","5.1904761904762"
"7","2017","31","Hotel","4","21","99","163","1","1","100","164","3"
"7","2017","31","Otros","3","4","11","43","15","68","26","111","12.2"
"7","2017","31","Otros","5","9","19","26","8","12","27","38","4.0454545454545"
"7","2017","31","Hotel","8","27","58","65","0","0","58","65","4.5"
"7","2017","31","","7","17","187","532","0","0","187","532","1"
"7","2017","31","Otros","16","20","22","66","0","0","22","66","3.0769230769231"
"7","2017","31","Otros","4","21","90","142","0","0","90","142","4.8333333333333"
"7","2017","31","Otros","13","33","36","43","0","0","36","43","5.125"
"7","2017","0","","12","35","0","0","0","0","0","0","1"
"7","2017","31","Hotel","13","33","0","0","2","2","2","2","2"
"7","2017","31","Otros","4","39","20","24","0","0","20","24","2.2222222222222"
"7","2017","31","Otros","10","18","5","13","0","0","5","13","10.25"
"7","2017","31","Otros","6","27","80","152","0","0","80","152","3.960088691796"
"7","2017","31","Hotel","4","39","60","162","0","0","60","162","2.6"
"7","2017","31","Otros","14","31","73","113","331","362","404","475","20.2"
"7","2017","31","Hotel","2","29","120","138","106","235","226","373","2"
"7","2017","31","Hotel","9","26","220","354","5","9","225","363","1.5"
"7","2017","15","Otros","12","35","2","2","3","5","5","7","3.5"
"7","2017","31","Hotel","14","27","100","137","54","69","154","206","8.5"
"7","2017","31","Otros","11","36","22","74","0","0","22","74","5.1904761904762"
"7","2017","31","Otros","16","20","134","351","4","8","138","359","3.0769230769231"
"7","2017","31","Otros","4","39","5","9","0","0","5","9","2.2222222222222"
"7","2017","31","Otros","7","27","177","213","11","44","188","257","4.8333333333333"
"7","2017","31","Otros","6","27","86","167","0","0","86","167","3.960088691796"
"7","2017","31","Otros","5","8","10","310","0","0","10","310","5"
"7","2017","31","Otros","9","37","129","308","10","10","139","318","4.5"
"7","2017","31","Hotel","2","6","53","114","0","0","53","114","5.5"
"7","2017","31","Hotel","10","27","358","700","264","395","622","1095","2.25"
"7","2017","31","Hotel","9","30","107","256","10","20","117","276","1"
"7","2017","31","Otros","4","13","46","177","12","16","58","193","3.4"
"7","2017","31","Hotel","5","5","328","328","13","13","341","341","1"
"7","2017","31","Otros","7","38","176","366","0","0","176","366","2.75"
"7","2017","31","Hotel","13","14","20","22","0","0","20","22","1"
"7","2017","31","Otros","5","9","11","11","0","0","11","11","4.0454545454545"
"7","2017","31","Otros","5","8","8","9","0","0","8","9","5"
"7","2017","31","Otros","10","27","23","460","0","0","23","460","4.84"
"7","2017","31","Hotel","13","14","0","0","0","0","0","0","1"
"7","2017","31","Otros","11","15","34","67","1","1","35","68","2.3571428571429"
"7","2017","31","Hotel","9","22","247","252","0","0","247","252","2.5555555555556"
"7","2017","31","Otros","11","36","100","145","1","4","101","149","5.1904761904762"
"7","2017","31","Hotel","10","18","2476","6049","1060","2604","3536","8653","1"
"7","2017","31","Hotel","6","12","166","351","0","0","166","351","5"
"7","2017","31","","2","29","631","1940","273","759","904","2699","1"
"7","2017","31","Hotel","16","27","3662","3662","43","116","3705","3778","1"
"7","2017","31","","14","31","309","629","482","2642","791","3271","1"
"7","2017","31","Hotel","8","3","22","168","26","338","48","506","4.1111111111111"
"7","2017","31","Otros","13","33","68","118","1","1","69","119","5.125"
"7","2017","31","","14","27","93","120","0","0","93","120","2.6666666666667"
"7","2017","31","Otros","9","22","23","33","0","0","23","33","7.6428571428571"
"7","2017","31","Hotel","10","11","36","36","0","0","36","36","5.6666666666667"
"7","2017","31","Otros","6","12","16","57","0","0","16","57","1.8256578947368"
"7","2017","31","Hotel","8","3","203","327","48","52","251","379","4.1111111111111"
"7","2017","31","Otros","6","12","389","739","0","0","389","739","1.8256578947368"
"7","2017","31","Hotel","8","27","165","165","2","2","167","167","4.5"
"7","2017","31","Hotel","6","28","213","241","19","23","232","264","2.4"
"7","2017","31","Otros","6","25","37","162","0","0","37","162","2.3846153846154"
"7","2017","31","Otros","6","25","78","102","0","0","78","102","2.3846153846154"
"7","2017","31","Hotel","11","36","445","1203","0","0","445","1203","1"
"7","2017","31","Otros","2","6","35","93","200","643","235","736","5"
"7","2017","31","Hotel","14","31","76","117","137","486","213","603","24"
"7","2017","31","Otros","4","21","17","57","0","0","17","57","4.8333333333333"
"7","2017","31","Otros","7","38","15","17","0","0","15","17","2.75"
"7","2017","31","Otros","13","14","26","28","0","0","26","28","7.3846153846154"
"7","2017","31","Otros","2","29","46","68","35","45","81","113","3.28"
"7","2017","31","Otros","3","4","120","120","23","23","143","143","12.2"
"7","2017","31","Hotel","3","4","472","1079","24","41","496","1120","3"
"7","2017","31","Otros","7","27","295","422","5","5","300","427","1"
"7","2017","31","Otros","7","17","138","184","0","0","138","184","3"
"7","2017","31","Hotel","12","27","238","476","36","36","274","512","1"
"7","2017","31","Otros","5","5","23","29","8","13","31","42","3.65625"
"7","2017","31","Hotel","6","10","337","487","12","16","349","503","6.6"
"7","2017","31","Otros","10","18","0","0","15","57","15","57","10.25"
"7","2017","31","Otros","8","27","51","89","0","0","51","89","9.4"
"7","2017","31","Otros","8","3","143","359","10","51","153","410","10"
"7","2017","31","Hotel","16","27","86","131","0","0","86","131","5.8571428571429"
"7","2017","31","Otros","6","10","25","69","0","0","25","69","3.8518518518518"
"7","2017","31","Hotel","2","6","35","60","1","1","36","61","5.5"
"7","2017","31","Hotel","8","3","20","42","2","6","22","48","4.1111111111111"
"7","2017","31","Otros","10","11","42","53","8","8","50","61","11.764705882353"
"7","2017","31","Otros","6","27","7","217","0","0","7","217","3.960088691796"
"7","2017","31","Otros","15","16","14","22","0","0","14","22","9"
"7","2017","31","Otros","5","5","1","1","0","0","1","1","3.65625"
"7","2017","31","Otros","10","27","138","331","50","63","188","394","4.84"
"7","2017","31","Hotel","7","38","114","226","0","0","114","226","1"
"7","2017","31","Hotel","13","27","3","12","0","0","3","12","4.2"
"7","2017","31","Hotel","16","20","140","140","0","0","140","140","1"
"7","2017","31","Otros","10","27","29","43","0","0","29","43","4.84"
"7","2017","31","Hotel","3","7","90","116","42","55","132","171","1"
"7","2017","31","Otros","2","29","118","190","21","28","139","218","3.28"
"7","2017","31","Otros","10","18","4","12","0","0","4","12","10.25"
"7","2017","31","Otros","9","22","122","385","0","0","122","385","7.6428571428571"
"7","2017","31","Otros","15","27","127","137","4","4","131","141","1.4222222222222"
"7","2017","31","Otros","11","36","2","6","0","0","2","6","5.1904761904762"
"7","2017","31","Otros","5","5","17","32","4","7","21","39","3.65625"
"7","2017","31","Otros","2","29","60","107","41","87","101","194","3.28"
"7","2017","31","Hotel","9","22","226","226","18","18","244","244","2.5555555555556"
"7","2017","31","Otros","11","32","16","16","0","0","16","16","2.2857142857143"
"7","2017","31","Hotel","10","27","241","375","256","415","497","790","1"
"7","2017","31","Otros","16","27","101","176","4","20","105","196","2"
"7","2017","31","Hotel","16","20","12","20","0","0","12","20","1"
"7","2017","31","Otros","11","15","26","56","0","0","26","56","2.3571428571429"
"7","2017","31","Otros","7","17","71","309","8","45","79","354","3"
"7","2017","31","Otros","5","8","7","7","0","0","7","7","5"
"7","2017","31","Hotel","13","33","82","129","2","2","84","131","2"
"7","2017","31","Otros","5","9","13","19","8","9","21","28","4.0454545454545"
"7","2017","31","Otros","10","27","68","128","32","36","100","164","4.84"
"7","2017","31","Otros","9","22","43","104","0","0","43","104","7.6428571428571"
"7","2017","31","Otros","16","40","45","80","3","6","48","86","28.142857142857"
"7","2017","31","Hotel","16","40","60","60","10","10","70","70","1"
"7","2017","31","Otros","15","16","18","79","4","20","22","99","9"
"7","2017","31","Hotel","8","2","29","42","5","5","34","47","3"
"7","2017","31","Otros","8","3","73","112","0","0","73","112","10"
"7","2017","31","Otros","7","17","47","55","0","0","47","55","17.166666666667"
"7","2017","31","Otros","16","20","94","219","0","0","94","219","3.0769230769231"
"7","2017","31","Otros","6","27","47","99","0","0","47","99","3.960088691796"
"7","2017","31","Otros","12","35","15","22","2","2","17","24","3.5"
"7","2017","31","Otros","6","28","120","422","22","41","142","463","4.65"
"7","2017","31","Otros","6","28","277","732","14","20","291","752","4.65"
"7","2017","31","Hotel","8","34","93","165","110","154","203","319","2.5714285714286"
"7","2017","31","Hotel","16","20","2135","2178","32","240","2167","2418","1"
"7","2017","31","Hotel","2","6","98","177","0","0","98","177","2.2"
"7","2017","31","Hotel","7","27","56","56","2","2","58","58","4.1666666666667"
"7","2017","31","Hotel","10","23","15","450","0","0","15","450","4"
"7","2017","31","Hotel","9","26","10","13","2","7","12","20","1.5"
"7","2017","31","Otros","8","27","37","48","5","5","42","53","9.4"
"7","2017","31","Otros","10","27","40","50","3","5","43","55","4.84"
"7","2017","31","Otros","11","15","10","20","0","0","10","20","2.3571428571429"
"7","2017","31","Otros","16","20","31","45","0","0","31","45","3.0769230769231"
"7","2017","31","Otros","11","32","52","68","0","0","52","68","1"
"7","2017","31","Otros","16","27","50","50","5","5","55","55","13.818181818182"
"7","2017","31","Otros","9","37","181","261","0","0","181","261","4.5"
"7","2017","31","Hotel","2","29","15","53","24","93","39","146","2"
"7","2017","31","Hotel","2","1","60","384","0","0","60","384","6.4"
"7","2017","31","Otros","5","8","10","15","1","1","11","16","5"
"7","2017","31","Otros","9","37","59","93","25","32","84","125","4.5"
"7","2017","31","Otros","7","38","220","513","0","0","220","513","2.75"
"7","2017","31","Otros","11","32","116","160","0","0","116","160","1"
"7","2017","31","Otros","4","39","42","70","6","29","48","99","2.2222222222222"
"7","2017","31","Hotel","11","36","62","130","27","56","89","186","2.375"
"7","2017","31","Otros","10","23","35","69","12","38","47","107","7"
"7","2017","31","Hotel","15","16","983","2502","145","501","1128","3003","2"
"7","2017","31","Otros","2","29","64","149","119","225","183","374","3.28"
"7","2017","31","Hotel","6","12","1128","1594","37","53","1165","1647","1"
"7","2017","31","Hotel","11","15","100","489","0","0","100","489","1"
"7","2017","31","Otros","4","21","327","597","13","19","340","616","1"
"7","2017","31","Otros","16","19","60","60","0","0","60","60","10.263157894737"
"7","2017","31","","9","37","276","377","2","2","278","379","1"
"7","2017","31","Otros","10","27","215","401","113","216","328","617","4.84"
"7","2017","31","Otros","11","15","105","105","0","0","105","105","2.3571428571429"
"7","2017","31","Hotel","2","29","48","144","59","225","107","369","2"
"7","2017","31","Hotel","10","27","204","225","136","145","340","370","1"
"7","2017","31","Hotel","11","36","126","561","15","30","141","591","2.375"
"7","2017","31","Hotel","9","37","87","116","29","50","116","166","3.4"
"7","2017","31","Otros","14","27","12","24","2","4","14","28","11.833333333333"
"7","2017","31","Otros","7","38","66","141","0","0","66","141","1"
"7","2017","31","Hotel","2","1","30","250","0","0","30","250","6.4"
"7","2017","31","Otros","2","29","21","58","49","181","70","239","3.28"
"7","2017","31","Hotel","6","27","29","55","0","0","29","55","3"
"7","2017","31","Otros","5","9","12","44","0","0","12","44","4.0454545454545"
"7","2017","31","Hotel","2","1","189","253","0","0","189","253","6.4"
"7","2017","31","Hotel","3","7","24","116","23","49","47","165","1"
"7","2017","31","Otros","7","38","150","150","125","125","275","275","2.75"
"7","2017","31","Otros","7","17","20","214","0","0","20","214","17.166666666667"
"7","2017","31","Otros","7","38","12","28","0","0","12","28","2.75"
"7","2017","31","Otros","4","21","15","23","2","2","17","25","4.8333333333333"
"7","2017","31","Otros","2","1","30","30","5","5","35","35","5.5"
"7","2017","31","Otros","12","35","7","11","4","4","11","15","3.5"
"7","2017","31","Otros","12","35","8","14","5","8","13","22","3.5"
"7","2017","31","Otros","4","21","51","66","4","4","55","70","4.8333333333333"
"7","2017","31","Otros","12","24","17","30","22","66","39","96","9.2"
"7","2017","31","Otros","16","19","6","8","0","0","6","8","10.263157894737"
"7","2017","31","Otros","10","11","124","168","0","0","124","168","11.764705882353"
"7","2017","31","Otros","16","19","28","36","2","2","30","38","10.263157894737"
"7","2017","31","Hotel","2","27","23","23","0","0","23","23","1"
"7","2017","31","Otros","6","28","15","18","0","0","15","18","4.65"
"7","2017","31","Otros","10","18","195","353","11","52","206","405","10.25"
"7","2017","31","Otros","14","27","29","63","0","0","29","63","11.833333333333"
"7","2017","31","Hotel","11","32","4","5","3","6","7","11","1"
"7","2017","31","Otros","8","27","1","1","0","0","1","1","9.4"
"7","2017","31","Hotel","12","35","65","112","16","37","81","149","1.7272727272727"
"7","2017","31","Otros","13","14","14","14","0","0","14","14","7.3846153846154"
"7","2017","31","Otros","11","36","55","115","0","0","55","115","5.1904761904762"
"7","2017","31","Otros","16","20","21","25","0","0","21","25","3.0769230769231"
"7","2017","31","Hotel","14","31","86","306","482","2344","568","2650","7.8"
"7","2017","31","Otros","2","27","147","219","2","42","149","261","3.2"
"7","2017","31","","16","40","285","1004","0","0","285","1004","3.0555555555556"
"7","2017","31","Hotel","11","36","77","89","5","17","82","106","2.375"
"7","2017","31","Hotel","9","22","29","33","0","0","29","33","2.5555555555556"
"7","2017","31","Otros","2","29","36","76","20","42","56","118","3.28"
"7","2017","31","Hotel","10","27","33","42","170","204","203","246","2.25"
"7","2017","31","Otros","10","27","15","61","0","0","15","61","4.84"
"7","2017","31","Hotel","16","19","28","56","0","0","28","56","4"
"7","2017","21","Otros","2","6","16","16","6","6","22","22","5"
"7","2017","31","Otros","7","27","321","782","0","0","321","782","4.8333333333333"
"7","2017","31","Hotel","2","6","116","893","0","0","116","893","5.5"
"7","2017","31","Hotel","6","28","5","5","10","10","15","15","2.4"
"7","2017","31","Otros","6","10","387","1246","35","87","422","1333","3.8518518518518"
"7","2017","31","Hotel","6","27","33","44","0","0","33","44","3"
"7","2017","31","Otros","5","5","19","36","5","8","24","44","3.65625"
"7","2017","31","Otros","12","24","68","246","67","83","135","329","9.2"
"7","2017","31","Hotel","8","2","119","820","9","30","128","850","3"
"7","2017","31","Hotel","11","32","12","50","4","7","16","57","1"
"7","2017","31","Otros","10","18","5","10","2","6","7","16","10.25"
"7","2017","31","Hotel","9","37","2","2","2","2","4","4","3.4"
"7","2017","31","Otros","5","9","8","13","2","2","10","15","4.0454545454545"
"7","2017","31","Otros","12","24","0","0","11","13","11","13","9.2"
"7","2017","31","Otros","9","22","1","1","0","0","1","1","7.6428571428571"
"7","2017","31","Otros","2","29","16","40","28","96","44","136","3.28"
"7","2017","31","Otros","10","23","3","63","0","0","3","63","7"
"7","2017","31","Otros","10","27","48","190","3","27","51","217","4.84"
"7","2017","31","Otros","10","11","19","19","0","0","19","19","11.764705882353"
"7","2017","14","Otros","8","3","102","309","0","0","102","309","10"
"7","2017","31","Otros","14","31","162","297","252","562","414","859","20.2"
"7","2017","31","Otros","2","29","142","366","170","512","312","878","3.28"
"7","2017","0","Otros","6","25","0","0","0","0","0","0","1"
"7","2017","31","Hotel","15","16","29","83","0","0","29","83","7.8"
"7","2017","31","Hotel","15","27","171","313","10","22","181","335","1"
"7","2017","31","Otros","10","27","7","23","1","4","8","27","4.84"
"7","2017","31","Otros","10","23","38","38","0","0","38","38","7"
"7","2017","31","Otros","6","27","11","19","0","0","11","19","3.960088691796"
"7","2017","31","Otros","16","40","149","233","19","32","168","265","28.142857142857"
"7","2017","31","Otros","11","36","142","184","0","0","142","184","5.1904761904762"
"7","2017","31","Otros","8","34","38","204","28","35","66","239","5.75"
"7","2017","31","Otros","6","12","28","106","0","0","28","106","1.8256578947368"
"7","2017","31","Otros","6","10","253","657","0","0","253","657","3.8518518518518"
"7","2017","31","Hotel","4","21","208","418","8","8","216","426","3"
"7","2017","31","Hotel","11","36","98","293","13","24","111","317","2.375"
"7","2017","31","Otros","5","8","66","75","25","25","91","100","5"
"7","2017","31","Hotel","7","17","125","173","0","0","125","173","10"
"7","2017","26","Hotel","11","36","393","508","30","30","423","538","1"
"7","2017","31","Otros","9","30","11","37","2","50","13","87","2.3333333333333"
"7","2017","31","Hotel","12","35","53","97","31","48","84","145","1.7272727272727"
"7","2017","31","Otros","2","1","123","274","18","47","141","321","5.5"
"7","2017","31","Hotel","6","25","58","76","0","0","58","76","1"
"7","2017","31","Otros","5","5","7","14","4","10","11","24","3.65625"
"7","2017","31","Otros","2","29","36","101","143","324","179","425","3.28"
"7","2017","31","Hotel","2","6","24","29","12","22","36","51","5.5"
"7","2017","31","Otros","7","17","13","20","0","0","13","20","17.166666666667"
"7","2017","31","Hotel","8","2","82","84","45","45","127","129","3"
"7","2017","31","Hotel","13","14","9","10","0","0","9","10","1"
"7","2017","31","Otros","7","38","63","133","4","8","67","141","2.75"
"7","2017","31","Hotel","14","31","24","36","46","127","70","163","24"
"7","2017","31","Hotel","5","5","20","31","8","32","28","63","2.1428571428571"
"7","2017","31","Otros","2","27","0","0","4","4","4","4","3.2"
"7","2017","31","Otros","5","8","2","2","0","0","2","2","5"
"7","2017","31","Otros","3","4","9","15","10","11","19","26","12.2"
"7","2017","31","Otros","13","14","3","3","0","0","3","3","7.3846153846154"
"7","2017","31","Otros","9","37","25","59","0","0","25","59","4.5"
"7","2017","31","Hotel","10","23","769","1016","28","43","797","1059","1"
"7","2017","31","Otros","11","32","21","22","3","6","24","28","2.2857142857143"
"7","2017","31","Otros","11","15","31","65","0","0","31","65","2.3571428571429"
"7","2017","31","Otros","8","3","161","480","0","0","161","480","10"
"7","2017","31","Otros","16","20","54","128","0","0","54","128","3.0769230769231"
"7","2017","31","Otros","8","3","29","53","0","0","29","53","10"
"7","2017","31","Otros","16","27","8","8","0","0","8","8","2"
"7","2017","31","Hotel","16","19","14","15","0","0","14","15","4"
"7","2017","31","Hotel","16","27","41","78","0","0","41","78","5.8571428571429"
"7","2017","31","Otros","9","26","18","37","0","0","18","37","3.8888888888889"
"7","2017","31","Otros","5","5","5","8","5","10","10","18","3.65625"
"7","2017","31","Otros","14","27","25","78","0","0","25","78","11.833333333333"
"7","2017","31","Hotel","5","5","1","1","0","0","1","1","2.1428571428571"
"7","2017","31","Hotel","12","24","98","295","87","205","185","500","3"
"7","2017","31","Otros","16","27","12","35","0","0","12","35","13.818181818182"
"7","2017","31","Hotel","14","31","10","25","284","799","294","824","1"
"7","2017","31","Otros","8","3","60","185","11","18","71","203","1"
"7","2017","31","Otros","13","27","117","161","4","4","121","165","12.2"
"7","2017","31","Hotel","16","40","34","62","13","23","47","85","16.333333333333"
"7","2017","31","Otros","11","36","44","98","0","0","44","98","1"
"7","2017","31","Otros","10","27","79","122","14","14","93","136","4.84"
"7","2017","31","Otros","9","22","27","63","0","0","27","63","7.6428571428571"
"7","2017","31","Hotel","5","5","26","37","0","0","26","37","2.1428571428571"
"7","2017","31","Otros","2","29","64","238","42","132","106","370","3.28"
"7","2017","31","Otros","2","29","2","3","4","4","6","7","3.28"
"7","2017","31","Hotel","13","14","5","5","0","0","5","5","1"
"7","2017","31","Otros","6","25","1","3","0","0","1","3","2.3846153846154"
"7","2017","31","Otros","2","1","1","2","0","0","1","2","5.5"
"7","2017","31","Hotel","12","27","30","32","0","0","30","32","1"
"7","2017","31","Hotel","13","27","24","24","0","0","24","24","4.2"
"7","2017","31","Otros","6","12","101","196","0","0","101","196","1.8256578947368"
"7","2017","31","Otros","6","27","23","58","0","0","23","58","3.960088691796"
"7","2017","31","Otros","6","25","6","6","0","0","6","6","2.3846153846154"
"7","2017","31","Hotel","6","28","19","52","0","0","19","52","2.5833333333333"
"7","2017","31","Otros","5","5","23","44","12","39","35","83","3.65625"
"7","2017","31","Otros","5","9","5","8","0","0","5","8","4.0454545454545"
"7","2017","31","Otros","5","8","5","7","0","0","5","7","5"
"7","2017","31","Hotel","2","29","294","999","55","184","349","1183","1"
"7","2017","31","Otros","5","5","59","105","25","47","84","152","3.65625"
"7","2017","31","Hotel","9","26","9","10","9","12","18","22","1.5"
"7","2017","31","Otros","9","30","4","4","0","0","4","4","2.3333333333333"
"7","2017","31","Otros","11","15","4","10","0","0","4","10","2.3571428571429"
"7","2017","31","Hotel","16","27","2","4","6","8","8","12","5.8571428571429"
"7","2017","31","Otros","9","30","3","3","0","0","3","3","2.3333333333333"
"7","2017","31","Otros","2","29","31","82","24","59","55","141","3.28"
"7","2017","31","Otros","7","38","76","127","46","50","122","177","2.75"
"7","2017","31","Otros","4","21","40","164","2","6","42","170","4.8333333333333"
"7","2017","31","Otros","9","22","14","20","0","0","14","20","7.6428571428571"
"7","2017","31","Otros","9","22","154","284","0","0","154","284","7.6428571428571"
"7","2017","5","Otros","13","27","7","11","0","0","7","11","12.2"
"7","2017","31","Hotel","11","36","2164","2244","38","98","2202","2342","1"
"7","2017","31","Otros","13","33","20","30","0","0","20","30","5.125"
"7","2017","31","Otros","11","36","134","410","102","285","236","695","5.1904761904762"
"7","2017","31","Otros","12","35","1","1","0","0","1","1","3.5"
"7","2017","31","Otros","12","35","7","11","4","4","11","15","3.5"
"7","2017","31","Otros","10","11","33","53","0","0","33","53","11.764705882353"
"7","2017","31","Otros","12","24","3","41","20","40","23","81","9.2"
"7","2017","31","Otros","16","20","43","177","0","0","43","177","3.0769230769231"
"7","2017","31","Hotel","7","27","46","57","0","0","46","57","1"
"7","2017","31","Otros","6","12","22","25","0","0","22","25","1.8256578947368"
"7","2017","31","Otros","11","32","39","74","5","18","44","92","2.2857142857143"
"7","2017","31","Otros","6","28","73","73","0","0","73","73","4.65"
"7","2017","31","Otros","8","34","1","1","0","0","1","1","5.75"
"7","2017","31","Otros","16","27","10","10","0","0","10","10","13.818181818182"
"7","2017","31","Otros","10","11","7","7","0","0","7","7","11.764705882353"
"7","2017","31","Otros","6","10","121","340","2","6","123","346","3.8518518518518"
"7","2017","31","Otros","8","3","98","271","6","10","104","281","10"
"7","2017","31","Hotel","16","20","47","152","0","0","47","152","1"
"7","2017","31","Hotel","11","32","21","32","1","1","22","33","1"
"7","2017","31","Otros","8","27","6","12","8","8","14","20","9.4"
"7","2017","31","Otros","12","27","77","321","5","5","82","326","3.4285714285714"
"7","2017","31","Otros","6","10","165","382","8","40","173","422","3.8518518518518"
"7","2017","31","Otros","6","10","34","74","0","0","34","74","3.8518518518518"
"7","2017","31","Otros","5","8","8","13","0","0","8","13","5"
"7","2017","31","Otros","5","8","2","2","12","12","14","14","5"
"7","2017","31","Hotel","9","26","53","72","3","18","56","90","1.5"
"7","2017","31","Hotel","13","14","22","29","0","0","22","29","1"
"7","2017","31","Otros","10","18","80","231","20","96","100","327","10.25"
"7","2017","31","Otros","8","2","52","60","74","78","126","138","6.4285714285714"
"7","2017","31","Otros","7","27","16","20","0","0","16","20","4.8333333333333"
"7","2017","31","Otros","2","29","8","31","15","32","23","63","3.28"
"7","2017","31","Otros","11","32","53","100","2","2","55","102","2.2857142857143"
"7","2017","31","Otros","9","30","8","12","0","0","8","12","2.3333333333333"
"7","2017","31","Otros","2","29","22","86","4","16","26","102","3.28"
"7","2017","31","Otros","5","5","1","1","0","0","1","1","3.65625"
"7","2017","31","Otros","11","15","21","37","0","0","21","37","2.3571428571429"
"7","2017","31","Otros","10","23","7","23","0","0","7","23","7"
"7","2017","31","Otros","11","36","97","161","0","0","97","161","5.1904761904762"
"7","2017","31","Hotel","3","7","31","62","56","164","87","226","1"
"7","2017","31","Otros","10","27","5","15","0","0","5","15","4.84"
"7","2017","31","Otros","2","27","18","18","0","0","18","18","3.2"
"7","2017","31","Otros","12","35","0","0","1","1","1","1","3.5"
"7","2017","31","Otros","10","27","5","5","0","0","5","5","4.84"
"7","2017","31","Otros","16","40","28","58","147","355","175","413","28.142857142857"
"7","2017","31","Hotel","8","3","344","618","107","168","451","786","4.1111111111111"
"7","2017","31","Otros","9","22","44","54","0","0","44","54","7.6428571428571"
"7","2017","31","Otros","13","14","62","145","0","0","62","145","7.3846153846154"
"7","2017","31","Otros","5","9","8","13","2","2","10","15","4.0454545454545"
"7","2017","31","Otros","10","18","56","124","8","24","64","148","10.25"
"7","2017","31","Otros","6","25","252","485","0","0","252","485","2.3846153846154"
"7","2017","31","Otros","9","22","98","266","0","0","98","266","7.6428571428571"
"7","2017","31","Otros","10","27","40","85","26","26","66","111","4.84"
"7","2017","31","Otros","16","20","46","66","0","0","46","66","3.0769230769231"
"7","2017","31","Hotel","7","17","187","307","2","2","189","309","10"
"7","2017","31","Otros","15","27","50","160","0","0","50","160","1.4222222222222"
"7","2017","31","Otros","12","35","0","0","3","3","3","3","3.5"
"7","2017","31","Otros","12","35","2","8","25","32","27","40","3.5"
"7","2017","31","Otros","3","7","15","31","0","0","15","31","2"
"7","2017","31","Otros","10","11","49","64","0","0","49","64","11.764705882353"
"7","2017","31","Otros","12","24","4","5","3","3","7","8","9.2"
"7","2017","31","Otros","10","23","39","39","0","0","39","39","7"
"7","2017","31","Otros","7","27","4","10","0","0","4","10","4.8333333333333"
"7","2017","31","","10","18","2","2","0","0","2","2","1"
"7","2017","31","Otros","16","27","3","3","6","6","9","9","13.818181818182"
"7","2017","31","Hotel","2","29","0","0","9","24","9","24","1"
"7","2017","31","Otros","14","27","16","44","12","24","28","68","11.833333333333"
"7","2017","31","Otros","11","32","88","130","0","0","88","130","2.2857142857143"
"7","2017","31","Otros","16","19","0","0","0","0","0","0","1"
"7","2017","31","Otros","16","27","8","10","0","0","8","10","13.818181818182"
"7","2017","31","Otros","8","3","52","237","0","0","52","237","10"
"7","2017","31","Otros","16","27","40","71","0","0","40","71","13.818181818182"
"7","2017","31","Otros","16","20","81","193","0","0","81","193","3.0769230769231"
"7","2017","31","Otros","16","40","251","569","22","54","273","623","28.142857142857"
"7","2017","31","Hotel","11","36","68","112","14","20","82","132","2.375"
"7","2017","31","Otros","6","10","16","16","0","0","16","16","3.8518518518518"
"7","2017","31","Otros","7","38","136","403","4","10","140","413","2.75"
"7","2017","31","Otros","13","14","12","34","0","0","12","34","7.3846153846154"
"7","2017","31","Otros","9","30","29","36","0","0","29","36","2.3333333333333"
"7","2017","31","Otros","13","27","165","425","0","0","165","425","12.2"
"7","2017","31","Otros","10","27","4","6","3","3","7","9","4.84"
"7","2017","31","Otros","6","25","5","16","14","26","19","42","2.3846153846154"
"7","2017","31","Otros","9","26","74","74","0","0","74","74","3.8888888888889"
"7","2017","31","Otros","10","18","19","75","6","24","25","99","10.25"
"7","2017","31","Otros","2","29","22","85","0","0","22","85","3.28"
"7","2017","31","Otros","6","25","6","15","0","0","6","15","2.3846153846154"
"7","2017","31","Otros","5","9","7","8","0","0","7","8","4.0454545454545"
"7","2017","31","Otros","5","9","8","13","2","2","10","15","4.0454545454545"
"7","2017","31","Hotel","9","37","51","97","4","8","55","105","3.4"
"7","2017","31","Hotel","7","38","148","312","2","4","150","316","1"
"7","2017","31","Otros","7","27","47","55","0","0","47","55","4.8333333333333"
"7","2017","31","Otros","5","9","8","13","2","2","10","15","4.0454545454545"
"7","2017","31","Otros","10","27","22","144","0","0","22","144","4.84"
"7","2017","31","Otros","7","27","34","34","0","0","34","34","4.8333333333333"
"7","2017","31","Otros","16","40","52","79","18","44","70","123","28.142857142857"
"7","2017","31","Otros","10","23","22","22","2","2","24","24","7"
"7","2017","31","Otros","15","16","88","332","17","53","105","385","9"
"7","2017","24","Otros","3","7","8","16","77","189","85","205","2"
"7","2017","31","Otros","7","17","44","125","0","0","44","125","17.166666666667"
"7","2017","31","Otros","8","27","53","57","6","6","59","63","9.4"
"7","2017","31","Otros","9","22","69","127","3","3","72","130","7.6428571428571"
"7","2017","31","Otros","16","19","5","10","0","0","5","10","10.263157894737"
"7","2017","31","","15","27","1","1","0","0","1","1","1"
"7","2017","31","Hotel","10","11","28","28","8","8","36","36","5.6666666666667"
"7","2017","31","Otros","2","27","9","11","8","8","17","19","3.2"
"7","2017","31","Otros","8","2","103","171","16","27","119","198","6.4285714285714"
"7","2017","31","Otros","5","5","19","36","5","8","24","44","3.65625"
"7","2017","31","Otros","12","35","1","1","0","0","1","1","3.5"
"7","2017","31","Otros","8","3","19","31","10","23","29","54","10"
"7","2017","31","Otros","12","24","25","67","33","74","58","141","9.2"
"7","2017","31","Otros","11","32","51","159","0","0","51","159","2.2857142857143"
"7","2017","31","Otros","10","27","88","137","34","93","122","230","4.84"
"7","2017","31","Otros","11","15","20","47","0","0","20","47","2.3571428571429"
"7","2017","31","Otros","5","8","13","13","0","0","13","13","5"
"7","2017","31","Otros","14","27","21","21","4","4","25","25","11.833333333333"
"7","2017","31","Otros","13","27","192","229","0","0","192","229","12.2"
"7","2017","31","Hotel","10","18","42","42","109","109","151","151","3.2"
"7","2017","31","Otros","10","27","11","11","6","6","17","17","4.84"
"7","2017","31","Otros","11","32","24","32","0","0","24","32","1"
"7","2017","31","Otros","9","37","46","97","3","3","49","100","4.5"
"7","2017","31","Otros","12","35","9","19","41","76","50","95","3.5"
"7","2017","31","Otros","8","34","112","178","57","85","169","263","5.75"
"7","2017","31","Hotel","16","40","18","39","22","51","40","90","16.333333333333"
"7","2017","31","Hotel","10","11","27","83","0","0","27","83","5.6666666666667"
"7","2017","31","Otros","7","27","2","6","0","0","2","6","4.8333333333333"
"7","2017","31","Hotel","7","38","4","4","0","0","4","4","1"
"7","2017","31","Otros","6","27","3","9","0","0","3","9","3.960088691796"
"7","2017","31","Otros","6","10","109","312","7","13","116","325","3.8518518518518"
"7","2017","15","Otros","6","25","40","62","0","0","40","62","1"
"7","2017","31","Otros","6","25","17","19","0","0","17","19","2.3846153846154"
"7","2017","31","Otros","6","27","48","64","0","0","48","64","3.960088691796"
"7","2017","31","Otros","6","27","78","275","0","0","78","275","3.960088691796"
"7","2017","31","Otros","5","5","5","9","0","0","5","9","3.65625"
"7","2017","31","Otros","5","5","1","1","0","0","1","1","3.65625"
"7","2017","31","Otros","3","4","70","163","12","16","82","179","12.2"
"7","2017","31","Otros","10","23","16","43","0","0","16","43","7"
"7","2017","31","Otros","8","3","3","9","0","0","3","9","10"
"7","2017","31","Otros","5","5","16","30","8","8","24","38","3.65625"
"7","2017","31","Otros","5","8","20","24","0","0","20","24","5"
"7","2017","31","Otros","6","10","162","432","0","0","162","432","3.8518518518518"
"7","2017","31","Otros","16","19","24","78","0","0","24","78","10.263157894737"
"7","2017","31","Otros","11","15","18","35","21","23","39","58","2.3571428571429"
"7","2017","31","Otros","7","38","96","114","0","0","96","114","2.75"
"7","2017","31","Otros","11","32","228","424","0","0","228","424","2.2857142857143"
"7","2017","31","Otros","8","2","113","231","0","0","113","231","6.4285714285714"
"7","2017","31","Otros","10","27","28","61","10","10","38","71","4.84"
"7","2017","31","Otros","6","27","19","36","0","0","19","36","3.960088691796"
"7","2017","31","Otros","11","32","48","94","2","2","50","96","2.2857142857143"
"7","2017","31","Otros","8","34","15","15","29","37","44","52","5.75"
"7","2017","31","Otros","11","32","25","43","0","0","25","43","2.2857142857143"
"7","2017","31","Otros","10","11","8","23","0","0","8","23","11.764705882353"
"7","2017","31","Otros","11","32","9","25","0","0","9","25","2.2857142857143"
"7","2017","31","Otros","14","31","0","0","10","13","10","13","20.2"
"7","2017","31","Hotel","14","31","179","320","617","2825","796","3145","17.4"
"7","2017","31","Otros","11","36","306","581","12","18","318","599","5.1904761904762"
"7","2017","31","Hotel","15","16","974","2384","200","489","1174","2873","2"
"7","2017","31","Otros","15","27","11","39","0","0","11","39","1.4222222222222"
"7","2017","31","Otros","5","5","9","12","5","15","14","27","3.65625"
"7","2017","31","Otros","8","34","5","5","6","6","11","11","5.75"
"7","2017","31","Otros","7","27","26","38","0","0","26","38","4.8333333333333"
"7","2017","31","Otros","12","35","7","11","4","4","11","15","3.5"
"7","2017","31","Otros","5","5","34","69","5","5","39","74","3.65625"
"7","2017","31","Otros","10","11","2","2","0","0","2","2","11.764705882353"
"7","2017","31","Otros","10","11","1","1","0","0","1","1","11.764705882353"
"7","2017","31","Otros","9","30","15","300","0","0","15","300","2.3333333333333"
"7","2017","31","Otros","8","2","149","507","2","6","151","513","6.4285714285714"
"7","2017","31","Otros","10","27","42","48","24","27","66","75","4.84"
"7","2017","31","Otros","5","9","8","13","2","2","10","15","4.0454545454545"
"7","2017","31","Otros","6","27","8","8","0","0","8","8","3.960088691796"
"7","2017","31","Otros","6","10","189","542","9","39","198","581","3.8518518518518"
"7","2017","31","Otros","6","10","157","358","17","52","174","410","3.8518518518518"
"7","2017","31","Otros","6","27","26","26","0","0","26","26","3.960088691796"
"7","2017","21","Otros","6","12","7","28","0","0","7","28","1.8256578947368"
"7","2017","31","Otros","6","10","116","442","0","0","116","442","3.8518518518518"
"7","2017","20","Otros","6","10","78","196","0","0","78","196","3.8518518518518"
"7","2017","31","Otros","6","27","3","3","0","0","3","3","3.960088691796"
"7","2017","31","Otros","6","12","27","27","0","0","27","27","1.8256578947368"
"7","2017","31","Otros","6","10","38","84","0","0","38","84","3.8518518518518"
"7","2017","31","Hotel","6","25","84","150","0","0","84","150","1"
"7","2017","3","Otros","6","27","3","3","0","0","3","3","3.960088691796"
"7","2017","31","Otros","5","9","17","24","0","0","17","24","4.0454545454545"
"7","2017","31","Otros","5","5","9","88","0","0","9","88","3.65625"
"7","2017","31","Otros","5","5","9","11","1","1","10","12","3.65625"
"7","2017","31","Otros","5","5","53","86","12","14","65","100","3.65625"
"7","2017","31","Otros","11","36","71","151","0","0","71","151","5.1904761904762"
"7","2017","31","Hotel","6","10","799","3118","665","1404","1464","4522","1"
"7","2017","31","Otros","5","9","8","13","2","2","10","15","4.0454545454545"
"7","2017","31","Otros","5","8","3","6","0","0","3","6","5"
"7","2017","0","Hotel","15","27","0","0","0","0","0","0","1"
"7","2017","31","Hotel","14","31","2","32","181","2698","183","2730","1"
"7","2017","31","Hotel","3","4","371","2205","7","26","378","2231","3"
"7","2017","31","Otros","3","7","40","40","6","6","46","46","1"
"7","2017","31","Otros","7","38","104","171","2","4","106","175","2.75"
"7","2017","31","Hotel","10","27","14","22","14","14","28","36","1"
"7","2017","31","Hotel","12","35","1","1","3","3","4","4","1.7272727272727"
"7","2017","31","Hotel","10","27","12","12","0","0","12","12","2.25"
"7","2017","31","Hotel","7","17","673","1157","44","73","717","1230","4"
"7","2017","31","Hotel","16","19","2","5","0","0","2","5","4"
"7","2017","15","Hotel","2","6","511","511","0","0","511","511","2.2"
"7","2017","1","Otros","5","5","10","10","0","0","10","10","3.65625"
"7","2017","31","Otros","12","24","90","167","84","84","174","251","9.2"
"7","2017","31","Otros","5","8","18","18","0","0","18","18","5"
"7","2017","31","Otros","4","13","105","162","9","9","114","171","1"
"7","2017","31","Otros","10","11","129","129","0","0","129","129","11.764705882353"
"7","2017","31","Otros","12","35","0","0","7","13","7","13","3.5"
"7","2017","31","Otros","10","23","117","124","1","1","118","125","7"
"7","2017","31","Otros","11","36","481","802","70","134","551","936","5.1904761904762"
"7","2017","31","Otros","12","35","7","11","4","4","11","15","3.5"
"7","2017","31","Otros","11","36","48","151","0","0","48","151","5.1904761904762"
"7","2017","31","Otros","8","2","103","452","31","135","134","587","6.4285714285714"
"7","2017","31","Otros","9","30","10","20","0","0","10","20","2.3333333333333"
"7","2017","31","Otros","11","36","102","193","4","4","106","197","5.1904761904762"
"7","2017","31","Otros","6","10","18","18","0","0","18","18","3.8518518518518"
"7","2017","31","Otros","10","18","25","58","0","0","25","58","10.25"
"7","2017","31","Otros","7","27","19","87","0","0","19","87","4.8333333333333"
"7","2017","31","Otros","16","20","27","84","0","0","27","84","1"
"7","2017","31","Otros","9","22","19","33","0","0","19","33","7.6428571428571"
"7","2017","31","Otros","5","5","127","216","0","0","127","216","3.65625"
"7","2017","31","Otros","12","35","7","11","4","4","11","15","3.5"
"7","2017","31","Otros","10","11","28","54","0","0","28","54","11.764705882353"
"7","2017","31","Otros","10","11","2","2","0","0","2","2","11.764705882353"
"7","2017","31","Otros","5","9","51","141","0","0","51","141","4.0454545454545"
"7","2017","31","Otros","5","5","5","10","3","12","8","22","3.65625"
"7","2017","31","Otros","12","35","22","35","56","113","78","148","3.5"
"7","2017","31","Otros","7","38","119","247","6","12","125","259","2.75"
"7","2017","31","Hotel","12","35","1","1","0","0","1","1","1.7272727272727"
"7","2017","31","Otros","13","14","97","119","0","0","97","119","1"
"7","2017","30","Otros","5","5","5","8","0","0","5","8","3.65625"
"7","2017","31","Hotel","14","31","93","1388","442","6633","535","8021","1"
"7","2017","31","Hotel","14","31","48","721","332","5048","380","5769","1"
"7","2017","31","Hotel","9","26","11","26","0","0","11","26","1.5"
"7","2017","31","Hotel","16","19","13","23","0","0","13","23","1"
"7","2017","31","Otros","16","19","43","43","0","0","43","43","10.263157894737"
"7","2017","31","Otros","9","30","32","44","0","0","32","44","2.3333333333333"
"7","2017","31","Otros","16","19","61","117","0","0","61","117","10.263157894737"
"7","2017","31","Otros","16","19","75","183","0","0","75","183","10.263157894737"
"7","2017","31","Otros","9","26","3","4","0","0","3","4","3.8888888888889"
"7","2017","31","Otros","16","40","2","2","0","0","2","2","28.142857142857"
"7","2017","31","Hotel","16","27","18","65","0","0","18","65","5.8571428571429"
"7","2017","31","Otros","16","19","14","14","0","0","14","14","10.263157894737"
"7","2017","31","Otros","16","19","34","74","0","0","34","74","10.263157894737"
"7","2017","31","","9","30","10","12","50","50","60","62","1"
"7","2017","31","Otros","16","19","25","31","0","0","25","31","10.263157894737"
"7","2017","31","Otros","10","11","1","12","0","0","1","12","11.764705882353"
"7","2017","31","Otros","11","36","9","9","0","0","9","9","5.1904761904762"
"7","2017","31","Otros","16","19","15","27","0","0","15","27","10.263157894737"
"7","2017","31","Otros","16","19","192","325","0","0","192","325","1.3333333333333"
"7","2017","31","Otros","16","19","2","8","0","0","2","8","10.263157894737"
"7","2017","31","Otros","10","18","12","35","20","48","32","83","10.25"
"7","2017","31","Otros","16","19","26","55","0","0","26","55","10.263157894737"
"7","2017","31","Otros","16","19","1","1","0","0","1","1","1.3333333333333"
"7","2017","31","","9","26","233","872","0","0","233","872","1"
"7","2017","31","Otros","16","19","8","13","0","0","8","13","10.263157894737"
"7","2017","31","Otros","16","19","42","55","0","0","42","55","10.263157894737"
"7","2017","31","Hotel","8","2","444","1388","328","1704","772","3092","1"
"7","2017","31","Otros","6","10","106","160","0","0","106","160","3.8518518518518"
"7","2017","31","Otros","6","12","41","46","0","0","41","46","1.8256578947368"
"7","2017","31","Hotel","16","19","42","222","10","44","52","266","1"
"7","2017","30","Otros","3","7","16","16","29","58","45","74","2"
"7","2017","31","Hotel","2","6","1055","2975","452","1399","1507","4374","1"
"7","2017","31","Hotel","3","4","591","815","163","263","754","1078","2.6"
"7","2017","31","Hotel","16","40","2238","3580","638","1029","2876","4609","1"
"7","2017","31","Otros","16","27","56","89","0","0","56","89","13.818181818182"
"7","2017","31","Hotel","6","28","179","268","24","36","203","304","2.4"
"7","2017","31","Hotel","8","34","477","541","189","320","666","861","1"
"7","2017","31","Otros","9","30","8","8","0","0","8","8","2.3333333333333"
"7","2017","31","Hotel","10","18","80","80","278","278","358","358","1"
"7","2017","31","Hotel","9","30","112","228","0","0","112","228","1"
"7","2017","31","Hotel","15","27","15","15","0","0","15","15","1"
"7","2017","31","Hotel","9","22","107","607","0","0","107","607","2.5555555555556"
"7","2017","31","Hotel","6","10","265","998","22","59","287","1057","1"
"7","2017","31","","11","15","35","138","0","0","35","138","1"
"7","2017","31","Otros","6","12","61","63","0","0","61","63","1.8256578947368"
"7","2017","31","Hotel","15","27","30","930","0","0","30","930","1"
"7","2017","31","Otros","15","27","171","275","0","0","171","275","1.4222222222222"
"7","2017","31","Otros","15","27","18","28","0","0","18","28","1.4222222222222"
"7","2017","31","Otros","2","1","21","21","8","8","29","29","1"
"7","2017","31","Otros","12","24","9","35","1","1","10","36","9.2"
"7","2017","31","Otros","5","5","23","44","12","35","35","79","3.65625"
"7","2017","31","Hotel","7","27","207","218","12","12","219","230","1"
"7","2017","31","Otros","16","20","4","8","0","0","4","8","3.0769230769231"
"7","2017","0","","10","11","0","0","0","0","0","0","1"
"7","2017","31","Hotel","16","40","21","21","6","6","27","27","16.333333333333"
"7","2017","31","Otros","12","35","10","14","5","8","15","22","3.5"
"7","2017","31","Hotel","6","27","16","23","2","2","18","25","3"
"7","2017","31","Otros","5","5","5","7","1","1","6","8","3.65625"
"7","2017","31","Hotel","6","27","31","31","0","0","31","31","3"
"7","2017","31","Otros","6","25","22","22","0","0","22","22","2.3846153846154"
"7","2017","0","Hotel","15","27","0","0","0","0","0","0","1"
"7","2017","31","Otros","5","9","8","23","9","16","17","39","4.0454545454545"
"7","2017","31","Hotel","15","27","100","245","0","0","100","245","1"
"7","2017","31","Hotel","5","9","8","82","0","0","8","82","1"
"7","2017","31","Hotel","8","34","92","195","53","100","145","295","2.5714285714286"
"7","2017","0","Hotel","15","27","0","0","0","0","0","0","1"
"7","2017","31","Hotel","6","27","328","628","0","0","328","628","3"
"7","2017","0","Otros","6","27","0","0","0","0","0","0","1"
"7","2017","31","Otros","12","27","1","1","54","54","55","55","3.4285714285714"
"7","2017","31","Hotel","2","27","268","684","103","256","371","940","1"
"7","2017","31","Hotel","2","6","44","44","0","0","44","44","1"
"7","2017","31","Otros","2","6","35","35","0","0","35","35","1"
"7","2017","31","Hotel","4","39","156","156","0","0","156","156","1"
"7","2017","31","Hotel","6","10","248","337","31","37","279","374","1"
"7","2017","31","Otros","5","8","4","5","0","0","4","5","5"
"7","2017","31","Hotel","13","33","649","808","6","27","655","835","1"
"7","2017","31","Hotel","13","33","71","142","18","35","89","177","1"
"7","2017","31","Otros","11","32","231","596","9","14","240","610","2.2857142857143"
"7","2017","31","Hotel","9","26","353","978","299","483","652","1461","1"
"7","2017","31","Hotel","16","20","68","91","10","17","78","108","1"
"7","2017","31","Otros","16","20","50","113","1","1","51","114","3.0769230769231"
"7","2017","31","","16","40","1371","3419","8","24","1379","3443","1"
"7","2017","31","Hotel","15","16","1721","3491","191","492","1912","3983","1"
"7","2017","31","Hotel","16","27","0","0","0","0","0","0","1"
"7","2017","31","Hotel","5","9","5","8","1","2","6","10","1"
"7","2017","31","Otros","7","38","105","185","0","0","105","185","2.75"
"7","2017","31","Otros","2","6","1711","1711","0","0","1711","1711","1"
"7","2017","31","Otros","2","6","21","105","0","0","21","105","1"
"7","2017","31","Hotel","15","27","257","926","32","34","289","960","1"
"7","2017","31","Otros","7","38","64","97","0","0","64","97","2.75"
"7","2017","31","Otros","2","1","12","54","6","12","18","66","1"
"7","2017","31","Otros","8","3","98","271","6","10","104","281","10"
"7","2017","31","Otros","11","36","22","66","0","0","22","66","5.1904761904762"
"7","2017","31","Otros","16","20","20","38","0","0","20","38","3.0769230769231"
"7","2017","31","Otros","8","3","243","521","0","0","243","521","1"
"7","2017","31","Otros","4","39","81","135","2","8","83","143","2.2222222222222"
"7","2017","31","Otros","5","5","117","319","0","0","117","319","3.65625"
"7","2017","31","Otros","12","27","4","15","7","7","11","22","3.4285714285714"
"7","2017","31","Otros","7","27","25","45","0","0","25","45","1"
"7","2017","31","Hotel","2","6","52","115","13","20","65","135","1"
"7","2017","31","Hotel","14","27","154","535","55","100","209","635","1"
"7","2017","31","Hotel","16","19","833","1735","0","0","833","1735","1"
"7","2017","31","","2","1","60","840","0","0","60","840","1"
"7","2017","31","Hotel","2","27","105","321","4","10","109","331","1"
"7","2017","31","Otros","16","20","77","152","0","0","77","152","1"
"7","2017","0","Otros","13","14","0","0","0","0","0","0","1"
"7","2017","31","Hotel","11","36","126","251","1","1","127","252","2.375"
"7","2017","31","Otros","13","14","6","186","0","0","6","186","7.3846153846154"
"7","2017","31","Otros","12","27","21","61","0","0","21","61","3.4285714285714"
"7","2017","31","Hotel","2","6","155","277","0","0","155","277","2.2"
"7","2017","31","Otros","2","6","364","1473","0","0","364","1473","1"
"7","2017","31","Otros","10","27","2","56","0","0","2","56","4.84"
"7","2017","31","Otros","12","27","10","21","12","12","22","33","3.4285714285714"
"7","2017","31","Otros","13","14","87","121","0","0","87","121","7.3846153846154"
"7","2017","31","Otros","6","12","114","205","16","29","130","234","1.8256578947368"
"7","2017","31","Otros","2","6","2293","2865","0","0","2293","2865","1"
"7","2017","31","Hotel","12","35","53","97","31","48","84","145","1.7272727272727"
"7","2017","31","Otros","5","5","9","17","0","0","9","17","3.65625"
"7","2017","31","Otros","9","30","12","240","0","0","12","240","2.3333333333333"
"7","2017","31","Hotel","8","2","6","6","17","42","23","48","1"
"7","2017","31","Otros","9","30","5","10","0","0","5","10","2.3333333333333"
"7","2017","31","Hotel","15","27","78","78","2","2","80","80","1"
"7","2017","31","Hotel","3","7","18","18","2","2","20","20","1"
"7","2017","31","Otros","6","12","419","660","0","0","419","660","1.8256578947368"
"7","2017","31","Otros","12","27","20","71","4","6","24","77","3.4285714285714"
"7","2017","31","Otros","2","6","6","12","0","0","6","12","5"
"7","2017","31","Otros","6","27","2","3","0","0","2","3","3.960088691796"
"7","2017","31","Hotel","10","11","144","198","1","2","145","200","1"
"7","2017","31","Otros","2","1","14","148","0","0","14","148","1"
"7","2017","31","Otros","11","36","22","22","0","0","22","22","5.1904761904762"
"7","2017","31","Hotel","11","32","0","0","0","0","0","0","1"
"7","2017","31","Otros","2","27","7","140","0","0","7","140","1"
"7","2017","31","Otros","12","27","8","16","0","0","8","16","3.4285714285714"
"7","2017","31","Hotel","8","2","56","98","0","0","56","98","3"
"7","2017","31","Hotel","16","20","30","30","0","0","30","30","1"
"7","2017","31","Otros","12","35","24","54","14","32","38","86","3.5"
"7","2017","31","Otros","13","14","6","6","0","0","6","6","1"
"7","2017","31","Otros","2","27","90","90","0","0","90","90","3.2"
"7","2017","31","Hotel","6","27","15","15","0","0","15","15","3"
"7","2017","31","Hotel","8","3","151","345","18","36","169","381","4.1111111111111"
"7","2017","28","Hotel","15","27","41","123","0","0","41","123","1"
"7","2017","31","Otros","8","3","86","232","5","9","91","241","10"
"7","2017","0","Hotel","16","20","0","0","0","0","0","0","1"
"7","2017","31","Hotel","6","28","39","52","1","9","40","61","2.4"
"7","2017","31","Otros","2","1","31","83","4","8","35","91","5.5"
"7","2017","31","Hotel","11","36","114","175","66","144","180","319","2.375"
"7","2017","31","Otros","4","13","68","106","0","0","68","106","1"
"7","2017","31","Otros","2","6","181","1141","0","0","181","1141","1"
"7","2017","31","Otros","8","34","44","81","48","80","92","161","5.75"
"7","2017","15","Hotel","11","15","0","0","0","0","0","0","1"
"7","2017","31","Otros","15","27","13","13","0","0","13","13","1.4222222222222"
"7","2017","31","Hotel","13","14","108","204","0","0","108","204","1"
"7","2017","31","Hotel","13","14","194","304","4","4","198","308","1"
"7","2017","31","Hotel","9","30","26","37","5","11","31","48","1"
"7","2017","31","Hotel","4","13","310","686","17","52","327","738","5.4"
"7","2017","31","Otros","6","27","52","88","0","0","52","88","3.960088691796"
"7","2017","21","Hotel","15","27","18","42","0","0","18","42","1"
"7","2017","31","Hotel","2","29","16","66","58","235","74","301","2"
"7","2017","31","Hotel","13","33","19","30","0","0","19","30","2"
"7","2017","31","Hotel","12","35","53","97","31","48","84","145","1.7272727272727"
"7","2017","31","Hotel","13","14","273","347","4","4","277","351","1"
"7","2017","31","Otros","6","25","30","60","0","0","30","60","2.3846153846154"
"7","2017","31","Hotel","8","2","18","34","0","0","18","34","3"
"7","2017","31","Otros","4","39","12","12","0","0","12","12","2.2222222222222"
"7","2017","31","Otros","6","12","150","173","14","42","164","215","1.8256578947368"
"7","2017","31","Otros","13","33","45","65","43","68","88","133","5.125"
"7","2017","31","Hotel","4","13","18","72","0","0","18","72","5.4"
"7","2017","31","Hotel","7","27","66","402","0","0","66","402","4.1666666666667"
"7","2017","31","Hotel","4","13","666","1595","41","115","707","1710","1"
"7","2017","0","","5","8","0","0","0","0","0","0","1"
"7","2017","31","Otros","8","2","234","547","23","44","257","591","6.4285714285714"
"7","2017","31","Otros","2","6","8","8","29","29","37","37","1"
"7","2017","31","","6","10","30","390","0","0","30","390","1"
"7","2017","31","Hotel","2","29","60","87","51","87","111","174","2"
"7","2017","31","","14","31","169","280","438","1837","607","2117","1"
"7","2017","31","Hotel","16","27","5550","16504","0","0","5550","16504","1"
"7","2017","31","Hotel","12","35","29","64","17","34","46","98","1.7272727272727"
"7","2017","31","","12","35","3","9","17","51","20","60","1"
"7","2017","31","","9","26","186","204","0","0","186","204","1"
"7","2017","31","Otros","11","32","161","268","0","0","161","268","2.2857142857143"
"7","2017","31","Otros","12","24","15","20","42","67","57","87","9.2"
"7","2017","31","Hotel","6","25","37","90","0","0","37","90","1"
"7","2017","31","Otros","11","32","4","5","2","2","6","7","2.2857142857143"
"7","2017","31","Hotel","16","19","114","217","2","2","116","219","4"
"7","2017","31","Otros","13","33","47","66","16","28","63","94","5.125"
"7","2017","31","Otros","16","27","14","40","1","5","15","45","13.818181818182"
"7","2017","31","Otros","6","12","60","72","0","0","60","72","1.8256578947368"
"7","2017","31","Otros","2","29","22","57","4","28","26","85","3.28"
"7","2017","31","Hotel","14","27","282","332","232","260","514","592","1"
"7","2017","31","Otros","2","1","154","2156","0","0","154","2156","1"
"7","2017","31","Otros","11","32","21","31","0","0","21","31","2.2857142857143"
"7","2017","31","Otros","2","27","35","76","2","2","37","78","1"
"7","2017","31","Hotel","2","29","49","184","3","9","52","193","1"
"7","2017","30","Hotel","4","13","8","116","0","0","8","116","3.2"
"7","2017","31","Hotel","4","21","26","42","0","0","26","42","3"
"7","2017","31","Otros","7","27","155","224","0","0","155","224","4.8333333333333"
"7","2017","29","","3","4","48","107","10","14","58","121","1"
"7","2017","31","Hotel","6","27","57","83","3","3","60","86","3"
"7","2017","31","Otros","16","19","4","8","0","0","4","8","10.263157894737"
"7","2017","31","Otros","11","32","9","9","0","0","9","9","2.2857142857143"
"7","2017","31","Otros","3","7","51","51","88","180","139","231","2"
"7","2017","31","Otros","5","5","10","18","0","0","10","18","3.65625"
"7","2017","24","Otros","15","27","1533","2490","0","0","1533","2490","1.4222222222222"
"7","2017","31","Otros","6","25","9","19","0","0","9","19","2.3846153846154"
"7","2017","0","","10","27","0","0","0","0","0","0","1"
"7","2017","31","Otros","2","29","18","33","77","145","95","178","3.28"
"7","2017","31","Otros","12","35","7","11","4","4","11","15","3.5"
"7","2017","31","Otros","16","19","16","33","0","0","16","33","10.263157894737"
"7","2017","31","Otros","9","26","78","78","0","0","78","78","3.8888888888889"
"7","2017","31","Hotel","13","33","54","54","0","0","54","54","2"
"7","2017","31","Otros","11","32","5","7","0","0","5","7","2.2857142857143"
"7","2017","31","Otros","9","22","67","132","3","3","70","135","7.6428571428571"
"7","2017","31","Otros","6","27","2","62","0","0","2","62","3.960088691796"
"7","2017","31","Otros","15","27","189","309","0","0","189","309","1.4222222222222"
"7","2017","31","Otros","11","32","76","95","2","2","78","97","2.2857142857143"
"7","2017","31","Otros","11","15","57","58","12","12","69","70","2.3571428571429"
"7","2017","31","Otros","9","37","3","6","0","0","3","6","4.5"
"7","2017","31","Otros","5","9","14","17","5","10","19","27","4.0454545454545"
"7","2017","31","Hotel","10","27","61","75","0","0","61","75","2.25"
"7","2017","31","Otros","6","28","37","256","0","0","37","256","4.65"
"7","2017","31","Otros","4","13","39","68","16","17","55","85","3.4"
"7","2017","31","Otros","2","1","1","2","0","0","1","2","1"
"7","2017","31","Otros","2","29","78","168","43","135","121","303","3.28"
"7","2017","31","Hotel","8","3","66","126","12","12","78","138","4.1111111111111"
"7","2017","31","Otros","16","19","54","200","0","0","54","200","1.3333333333333"
"7","2017","31","Otros","12","35","6","9","3","3","9","12","3.5"
"7","2017","31","Hotel","12","35","39","83","24","76","63","159","1.7272727272727"
"7","2017","31","Otros","12","35","10","14","4","5","14","19","3.5"
"7","2017","31","Otros","2","29","36","48","38","61","74","109","3.28"
"7","2017","31","Hotel","7","27","177","264","4","21","181","285","1"
"7","2017","31","Hotel","9","22","36","36","1","1","37","37","2.5555555555556"
"7","2017","31","Hotel","12","35","35","53","26","68","61","121","1.7272727272727"
"7","2017","31","Otros","15","16","172","355","15","38","187","393","2"
"7","2017","31","Hotel","15","27","45","90","0","0","45","90","1"
"7","2017","31","Otros","4","13","42","44","0","0","42","44","3.4"
"7","2017","31","Hotel","8","34","91","177","38","97","129","274","2.5714285714286"
"7","2017","31","Hotel","16","20","0","0","0","0","0","0","1"
"7","2017","31","Hotel","6","28","184","290","5","85","189","375","2.4"
"7","2017","31","Hotel","15","27","170","346","11","11","181","357","1"
"7","2017","31","Otros","12","35","31","66","62","132","93","198","3.5"
"7","2017","31","Otros","11","15","73","177","0","0","73","177","2.3571428571429"
"7","2017","31","Otros","11","15","41","239","0","0","41","239","2.3571428571429"
"7","2017","31","Otros","11","36","81","142","40","65","121","207","5.1904761904762"
"7","2017","31","Hotel","11","36","44","67","3","8","47","75","2.375"
"7","2017","31","Hotel","6","12","94","171","0","0","94","171","5"
"7","2017","31","Otros","8","3","55","135","26","34","81","169","10"
"7","2017","31","Otros","10","27","59","120","51","61","110","181","4.84"
"7","2017","31","Otros","8","3","8","72","15","26","23","98","10"
"7","2017","31","Otros","6","25","22","43","0","0","22","43","2.3846153846154"
"7","2017","31","Hotel","2","27","118","225","1","1","119","226","1"
"7","2017","31","Hotel","10","18","0","0","95","259","95","259","3.2"
"7","2017","31","Otros","11","32","74","114","15","28","89","142","1"
"7","2017","31","Hotel","6","10","1033","1305","548","707","1581","2012","1"
"7","2017","31","Otros","11","32","110","139","6","6","116","145","2.2857142857143"
"7","2017","31","Otros","2","27","5","8","0","0","5","8","1"
"7","2017","31","","12","24","34","135","60","239","94","374","1"
"7","2017","31","Hotel","16","27","593","693","0","0","593","693","5.8571428571429"
"7","2017","31","Hotel","7","38","24","225","0","0","24","225","1"
"7","2017","31","Hotel","6","12","1856","2079","24","51","1880","2130","1"
"8","2017","31","Hotel","14","31","1972","3310","8655","10925","10627","14235","1"
"8","2017","31","Hotel","14","31","892","2065","3355","9188","4247","11253","1"
"8","2017","31","Hotel","14","31","338","428","1321","3899","1659","4327","1"
"8","2017","31","Hotel","11","32","54","104","2","5","56","109","1"
"8","2017","31","Hotel","14","27","3897","4718","799","966","4696","5684","1"
"8","2017","31","Otros","11","32","19","41","0","0","19","41","2.2857142857143"
"8","2017","31","Hotel","14","31","274","400","3503","4636","3777","5036","5.4"
"8","2017","31","Hotel","15","16","1086","3382","103","185","1189","3567","1"
"8","2017","31","Hotel","14","31","943","1688","1344","5338","2287","7026","5.4"
"8","2017","31","Hotel","12","24","1283","2091","730","929","2013","3020","1"
"8","2017","31","Hotel","16","40","808","1195","372","1130","1180","2325","1"
"8","2017","31","Hotel","6","12","1406","1821","45","81","1451","1902","1"
"8","2017","31","Hotel","10","23","657","923","100","146","757","1069","1"
"8","2017","31","Hotel","14","31","1897","4101","387","841","2284","4942","5.4"
"8","2017","31","Hotel","3","4","828","1805","267","2150","1095","3955","1"
"8","2017","31","","11","32","442","735","50","93","492","828","1"
"8","2017","31","Hotel","6","12","909","1786","23","50","932","1836","1"
"8","2017","31","Hotel","6","12","2292","3024","304","398","2596","3422","1"
"8","2017","31","Hotel","9","26","3213","6414","72","144","3285","6558","1"
"8","2017","31","Hotel","2","1","916","2502","30","173","946","2675","1"
"8","2017","31","Hotel","9","26","1015","1369","126","334","1141","1703","1"
"8","2017","31","Hotel","6","12","1065","1783","55","138","1120","1921","1"
"8","2017","31","Hotel","14","31","69","88","4400","9293","4469","9381","5.4"
"8","2017","31","Hotel","11","32","118","228","0","0","118","228","1"
"8","2017","31","Hotel","2","6","1478","2141","112","305","1590","2446","1"
"8","2017","31","Hotel","16","40","1334","2510","546","851","1880","3361","1"
"8","2017","31","Hotel","14","27","1484","2825","639","1620","2123","4445","1"
"8","2017","31","Otros","11","36","78","94","0","0","78","94","1"
"8","2017","31","Hotel","10","23","1096","1670","448","785","1544","2455","1"
"8","2017","31","Hotel","14","31","350","898","639","3720","989","4618","7.8"
"8","2017","31","Hotel","7","17","645","1281","135","297","780","1578","1"
"8","2017","31","Hotel","2","1","2440","2904","365","411","2805","3315","2"
"8","2017","31","Hotel","2","1","1876","2625","301","597","2177","3222","2"
"8","2017","31","Hotel","4","13","1139","2095","353","566","1492","2661","1"
"8","2017","31","Hotel","2","1","2378","2617","345","378","2723","2995","2"
"8","2017","31","Hotel","10","27","1744","4034","607","1208","2351","5242","1"
"8","2017","31","Hotel","14","27","732","1093","1122","1760","1854","2853","1"
"8","2017","31","Hotel","14","27","1966","2570","1200","2911","3166","5481","1"
"8","2017","31","Hotel","6","12","1575","2419","74","178","1649","2597","1"
"8","2017","31","Hotel","6","12","1725","2080","386","462","2111","2542","1"
"8","2017","31","Hotel","13","27","2033","4071","2","4","2035","4075","1"
"8","2017","31","Hotel","14","31","377","598","2385","3434","2762","4032","7.8"
"8","2017","31","Hotel","6","12","1393","2439","286","500","1679","2939","1"
"8","2017","31","Hotel","16","27","2416","4577","134","261","2550","4838","1"
"8","2017","31","","10","27","10","13","2","4","12","17","1"
"8","2017","31","Hotel","10","18","868","1485","276","570","1144","2055","1"
"8","2017","31","Hotel","9","37","2069","3316","141","235","2210","3551","1"
"8","2017","31","Hotel","16","27","1152","3084","0","0","1152","3084","1"
"8","2017","31","Hotel","15","16","870","1635","95","231","965","1866","2"
"8","2017","31","Hotel","2","1","1446","2261","298","463","1744","2724","2"
"8","2017","31","Hotel","3","4","957","1610","145","306","1102","1916","1"
"8","2017","31","Hotel","16","40","1042","2247","690","901","1732","3148","1"
"8","2017","31","Hotel","7","17","3621","4285","183","208","3804","4493","1"
"8","2017","31","Hotel","12","24","906","1714","513","920","1419","2634","1"
"8","2017","31","Hotel","12","35","492","831","223","435","715","1266","1"
"8","2017","31","Hotel","2","6","286","730","15","37","301","767","1"
"8","2017","31","Hotel","13","33","1616","1616","83","83","1699","1699","1"
"8","2017","31","Hotel","10","27","1403","2135","755","1030","2158","3165","1"
"8","2017","31","Hotel","10","23","1370","2138","281","437","1651","2575","1"
"8","2017","31","Hotel","11","36","1067","1481","170","418","1237","1899","1"
"8","2017","31","Hotel","8","34","1650","2513","71","142","1721","2655","1"
"8","2017","31","Hotel","2","6","1365","2094","210","287","1575","2381","1"
"8","2017","31","Hotel","14","31","809","1182","1350","2085","2159","3267","7.8"
"8","2017","31","Hotel","11","36","2169","3140","178","307","2347","3447","1"
"8","2017","31","","10","27","1569","2004","250","1087","1819","3091","1"
"8","2017","31","Hotel","14","31","1722","3766","2488","7760","4210","11526","5.4"
"8","2017","31","Hotel","4","13","2741","2752","4","6","2745","2758","1"
"8","2017","31","Hotel","6","28","1258","1451","58","89","1316","1540","1"
"8","2017","31","Otros","14","31","68","135","467","669","535","804","2.8"
"8","2017","31","Otros","16","27","72","72","0","0","72","72","2"
"8","2017","31","Hotel","2","1","1107","1780","62","159","1169","1939","2"
"8","2017","31","Hotel","10","18","812","1187","242","355","1054","1542","1"
"8","2017","31","Hotel","7","17","1145","1577","33","37","1178","1614","1"
"8","2017","31","Hotel","12","24","544","1546","375","1307","919","2853","1"
"8","2017","31","Hotel","10","18","1069","1214","190","406","1259","1620","1"
"8","2017","31","Hotel","2","1","1946","2322","31","54","1977","2376","1"
"8","2017","31","Hotel","10","18","645","1359","218","454","863","1813","1"
"8","2017","31","Hotel","6","28","1790","2256","160","193","1950","2449","1"
"8","2017","31","Hotel","5","5","554","1204","186","357","740","1561","1"
"8","2017","31","Hotel","4","13","681","1378","50","155","731","1533","1"
"8","2017","31","Hotel","10","18","508","872","312","534","820","1406","1"
"8","2017","31","Hotel","16","40","324","996","51","71","375","1067","1"
"8","2017","31","Hotel","8","3","1857","4100","776","1794","2633","5894","1"
"8","2017","31","Hotel","15","16","1204","1514","154","211","1358","1725","2"
"8","2017","31","Hotel","14","31","101","176","527","2262","628","2438","7.8"
"8","2017","31","Hotel","13","33","472","903","618","1150","1090","2053","1"
"8","2017","31","Hotel","15","16","1341","2076","161","260","1502","2336","2"
"8","2017","31","Otros","4","21","405","901","0","0","405","901","1"
"8","2017","31","Hotel","6","10","954","1987","122","519","1076","2506","1"
"8","2017","31","Hotel","16","19","138","178","6","8","144","186","1"
"8","2017","31","Hotel","16","27","692","1800","5","10","697","1810","1"
"8","2017","31","Hotel","10","11","1449","2903","81","120","1530","3023","1"
"8","2017","31","Otros","10","23","377","943","2","4","379","947","1"
"8","2017","0","Hotel","12","35","0","0","0","0","0","0","1"
"8","2017","31","Hotel","11","36","560","1075","70","108","630","1183","1"
"8","2017","31","Hotel","14","31","73","365","264","1914","337","2279","17.4"
"8","2017","31","Hotel","10","18","775","1669","404","939","1179","2608","3.2"
"8","2017","31","Hotel","4","13","856","1366","0","0","856","1366","1"
"8","2017","31","Hotel","6","12","323","504","21","37","344","541","5"
"8","2017","31","Hotel","6","10","1104","1429","47","90","1151","1519","1"
"8","2017","31","Otros","5","5","162","262","59","94","221","356","3.65625"
"8","2017","31","Hotel","12","24","823","1091","531","644","1354","1735","1"
"8","2017","31","Hotel","8","3","928","1706","235","490","1163","2196","1"
"8","2017","31","Hotel","13","27","614","939","0","0","614","939","2.75"
"8","2017","31","Hotel","15","16","593","1519","32","98","625","1617","4"
"8","2017","31","Otros","15","16","159","521","27","94","186","615","2"
"8","2017","31","Otros","16","20","215","333","0","0","215","333","1"
"8","2017","31","Hotel","3","4","381","617","102","131","483","748","1"
"8","2017","31","Hotel","11","36","91","111","0","0","91","111","1"
"8","2017","31","Hotel","2","6","251","1495","87","119","338","1614","1"
"8","2017","31","Hotel","8","34","836","1378","171","282","1007","1660","1"
"8","2017","31","Hotel","4","13","15","28","0","0","15","28","3.2"
"8","2017","31","Hotel","13","27","436","780","3","3","439","783","2.75"
"8","2017","31","Hotel","2","29","235","450","435","946","670","1396","1"
"8","2017","31","Otros","11","36","224","472","0","0","224","472","1"
"8","2017","31","","10","11","10","10","0","0","10","10","1"
"8","2017","31","Hotel","4","13","941","1617","52","229","993","1846","1"
"8","2017","31","Hotel","16","40","2359","3542","397","598","2756","4140","5.6666666666667"
"8","2017","31","Hotel","10","23","1046","1721","290","459","1336","2180","2.8"
"8","2017","31","Hotel","8","34","503","947","230","541","733","1488","1"
"8","2017","31","Hotel","5","5","271","600","30","100","301","700","1"
"8","2017","31","Hotel","3","4","119","248","46","82","165","330","3"
"8","2017","31","Hotel","9","26","44","139","3","15","47","154","1"
"8","2017","31","Hotel","8","34","782","1252","293","500","1075","1752","1"
"8","2017","31","Hotel","7","17","232","442","56","79","288","521","4"
"8","2017","31","Hotel","4","13","250","616","53","123","303","739","3.2"
"8","2017","31","Hotel","12","35","2","5","93","324","95","329","1"
"8","2017","31","Hotel","16","40","704","1334","346","785","1050","2119","1"
"8","2017","31","Hotel","9","26","306","593","50","154","356","747","1"
"8","2017","31","","6","27","153","360","12","43","165","403","1"
"8","2017","31","Hotel","9","26","57","223","0","0","57","223","1"
"8","2017","31","Hotel","4","13","221","423","40","153","261","576","3.2"
"8","2017","31","Hotel","6","28","242","298","18","18","260","316","1"
"8","2017","31","","2","29","47","113","618","1957","665","2070","1"
"8","2017","31","Hotel","14","31","26","72","138","556","164","628","1"
"8","2017","31","Hotel","13","33","1468","1990","48","91","1516","2081","1"
"8","2017","31","Hotel","8","3","229","491","115","254","344","745","1"
"8","2017","31","Hotel","14","27","657","657","957","1199","1614","1856","1"
"8","2017","31","Hotel","16","40","251","551","0","0","251","551","5.6666666666667"
"8","2017","31","Hotel","12","24","409","605","425","734","834","1339","1"
"8","2017","31","Hotel","10","18","930","1722","132","286","1062","2008","3.2"
"8","2017","31","Otros","15","16","56","56","7","7","63","63","9"
"8","2017","31","Hotel","6","10","625","717","6","8","631","725","1"
"8","2017","31","Hotel","10","11","725","1150","42","100","767","1250","1"
"8","2017","31","Otros","6","10","66","1300","0","0","66","1300","3.8518518518518"
"8","2017","31","Otros","10","23","89","183","0","0","89","183","1"
"8","2017","31","Hotel","10","23","370","578","174","284","544","862","2.8"
"8","2017","31","Hotel","6","12","310","440","4","14","314","454","5"
"8","2017","31","Hotel","6","27","95","149","0","0","95","149","3"
"8","2017","31","Hotel","10","23","630","1082","321","601","951","1683","2.8"
"8","2017","31","","4","39","86","132","0","0","86","132","1"
"8","2017","31","Hotel","8","34","432","615","495","791","927","1406","1"
"8","2017","31","Hotel","8","34","526","769","246","399","772","1168","1"
"8","2017","31","Otros","4","39","33","103","0","0","33","103","2.2222222222222"
"8","2017","31","Otros","13","14","101","197","0","0","101","197","1"
"8","2017","31","Hotel","10","23","176","238","15","15","191","253","2.8"
"8","2017","31","Otros","13","14","318","658","0","0","318","658","1"
"8","2017","31","Hotel","12","24","512","728","272","584","784","1312","1"
"8","2017","31","","6","25","71","142","0","0","71","142","1"
"8","2017","31","Hotel","15","27","441","809","6","6","447","815","1"
"8","2017","0","Hotel","12","35","0","0","0","0","0","0","1"
"8","2017","31","Hotel","16","40","360","720","0","0","360","720","1"
"8","2017","31","Hotel","16","27","418","1026","1724","7376","2142","8402","1"
"8","2017","31","Hotel","9","30","89","168","0","0","89","168","1"
"8","2017","31","Hotel","4","13","315","660","89","176","404","836","3.2"
"8","2017","31","Hotel","2","29","176","504","159","589","335","1093","1"
"8","2017","31","Hotel","16","20","491","782","34","51","525","833","1"
"8","2017","31","Hotel","5","5","401","585","74","144","475","729","1"
"8","2017","31","Hotel","13","33","674","1066","78","146","752","1212","1"
"8","2017","31","Otros","16","19","75","124","0","0","75","124","1.3333333333333"
"8","2017","31","Hotel","12","24","189","560","241","555","430","1115","1"
"8","2017","31","","8","2","476","841","31","72","507","913","1"
"8","2017","0","Hotel","12","35","0","0","0","0","0","0","1"
"8","2017","31","Hotel","16","27","15","17","394","478","409","495","2.5"
"8","2017","31","Otros","16","27","490","1025","5","16","495","1041","2"
"8","2017","31","Hotel","8","34","430","665","165","290","595","955","1"
"8","2017","31","Otros","8","3","60","186","0","0","60","186","1"
"8","2017","31","Hotel","7","27","250","366","75","132","325","498","1"
"8","2017","31","Hotel","4","39","339","748","6","13","345","761","1"
"8","2017","31","Hotel","15","16","115","227","17","45","132","272","4"
"8","2017","31","Hotel","4","39","96","153","3","6","99","159","1"
"8","2017","31","Hotel","4","39","333","533","11","12","344","545","1"
"8","2017","31","Hotel","15","16","117","209","77","125","194","334","4"
"8","2017","31","Hotel","14","31","184","387","103","295","287","682","17.4"
"8","2017","31","Hotel","8","34","434","1019","132","161","566","1180","1"
"8","2017","31","Hotel","6","28","192","272","11","11","203","283","1"
"8","2017","31","Hotel","7","17","971","1395","19","35","990","1430","4"
"8","2017","31","Otros","7","27","10","11","0","0","10","11","1"
"8","2017","31","Hotel","11","36","771","914","27","60","798","974","1"
"8","2017","31","Otros","4","21","667","1103","60","64","727","1167","1"
"8","2017","31","Otros","15","16","122","136","48","53","170","189","2"
"8","2017","31","Otros","7","17","236","481","19","24","255","505","3"
"8","2017","31","Hotel","7","38","95","120","10","16","105","136","1"
"8","2017","31","Hotel","16","27","538","723","142","154","680","877","2.5"
"8","2017","31","Hotel","2","6","62","114","2","2","64","116","2.2"
"8","2017","31","Hotel","11","36","345","639","45","77","390","716","1"
"8","2017","31","Hotel","6","28","52","59","2","2","54","61","1"
"8","2017","31","Hotel","6","12","47","73","0","0","47","73","5"
"8","2017","31","Otros","9","22","48","68","2","2","50","70","1"
"8","2017","31","","13","14","188","237","0","0","188","237","2"
"8","2017","31","Hotel","2","29","102","132","418","650","520","782","1"
"8","2017","31","Hotel","2","29","18","38","47","258","65","296","1"
"8","2017","31","Otros","4","13","405","439","12","12","417","451","1"
"8","2017","31","Hotel","15","16","88","207","37","79","125","286","4"
"8","2017","31","Hotel","2","1","96","182","0","0","96","182","6.4"
"8","2017","31","Otros","7","27","36","42","0","0","36","42","1"
"8","2017","31","Otros","13","33","19","19","0","0","19","19","5.125"
"8","2017","31","","4","21","529","612","2","2","531","614","1"
"8","2017","31","Hotel","6","10","314","314","4","4","318","318","1"
"8","2017","31","Hotel","11","36","111","242","0","0","111","242","1"
"8","2017","31","Otros","14","31","100","450","150","300","250","750","2.8"
"8","2017","31","Hotel","7","27","164","249","0","0","164","249","1"
"8","2017","31","Otros","6","10","23","185","5","47","28","232","3.8518518518518"
"8","2017","31","Hotel","4","39","315","351","16","27","331","378","2.6"
"8","2017","31","Otros","8","2","38","106","18","59","56","165","6.4285714285714"
"8","2017","31","Otros","11","36","70","153","20","33","90","186","5.1904761904762"
"8","2017","31","Hotel","13","33","309","309","0","0","309","309","1"
"8","2017","31","","3","4","98","171","78","104","176","275","1"
"8","2017","31","Hotel","7","17","296","429","49","137","345","566","4"
"8","2017","31","Hotel","8","2","233","305","3","4","236","309","1"
"8","2017","31","Otros","15","16","194","243","29","41","223","284","2"
"8","2017","31","Hotel","10","11","287","387","1","1","288","388","1"
"8","2017","31","Hotel","16","19","249","546","0","0","249","546","1"
"8","2017","31","Hotel","10","23","158","258","57","76","215","334","4"
"8","2017","31","","7","38","276","452","34","51","310","503","1"
"8","2017","31","Hotel","7","27","126","252","0","0","126","252","1"
"8","2017","31","Hotel","11","36","414","775","82","180","496","955","1"
"8","2017","31","Hotel","16","40","140","252","18","38","158","290","16.333333333333"
"8","2017","0","Hotel","16","19","0","0","0","0","0","0","1"
"8","2017","0","Hotel","16","19","0","0","0","0","0","0","1"
"8","2017","0","Hotel","16","20","0","0","0","0","0","0","1"
"8","2017","31","Hotel","10","11","222","314","7","11","229","325","1"
"8","2017","31","Otros","7","27","66","139","0","0","66","139","4.8333333333333"
"8","2017","31","Otros","7","27","29","91","0","0","29","91","1"
"8","2017","31","Hotel","7","27","38","49","0","0","38","49","4.1666666666667"
"8","2017","31","Otros","13","14","34","69","0","0","34","69","1"
"8","2017","31","Otros","11","15","47","57","0","0","47","57","2.3571428571429"
"8","2017","31","Otros","10","27","34","63","6","22","40","85","4.84"
"8","2017","31","Otros","14","31","126","126","2623","2623","2749","2749","2.8"
"8","2017","31","Otros","11","36","24","51","2","3","26","54","5.1904761904762"
"8","2017","31","Hotel","16","19","62","78","0","0","62","78","1"
"8","2017","31","","14","27","294","312","0","0","294","312","2.6666666666667"
"8","2017","31","Hotel","16","40","53","148","2","2","55","150","5.6666666666667"
"8","2017","31","Hotel","10","27","13","34","0","0","13","34","2.25"
"8","2017","31","Otros","2","29","87","184","170","518","257","702","3.28"
"8","2017","31","Hotel","13","27","548","548","16","16","564","564","1"
"8","2017","31","Otros","9","22","5","5","0","0","5","5","1"
"8","2017","31","Hotel","2","27","90","98","10","16","100","114","1"
"8","2017","31","Hotel","8","34","464","637","292","365","756","1002","1"
"8","2017","31","Hotel","7","27","310","563","4","9","314","572","1"
"8","2017","31","Hotel","15","16","240","497","40","86","280","583","4"
"8","2017","31","Hotel","16","20","47","60","6","6","53","66","1"
"8","2017","31","Otros","4","13","62","184","2","46","64","230","1"
"8","2017","31","Hotel","2","1","209","482","5","33","214","515","6.4"
"8","2017","31","Otros","11","32","5","9","0","0","5","9","2.2857142857143"
"8","2017","31","Hotel","2","29","17","118","157","1074","174","1192","1"
"8","2017","31","Hotel","16","27","179","189","68","86","247","275","2.5"
"8","2017","31","Hotel","10","18","224","833","0","0","224","833","3.2"
"8","2017","31","Otros","11","36","336","478","35","37","371","515","1"
"8","2017","31","Otros","13","14","30","55","0","0","30","55","1"
"8","2017","31","Hotel","7","27","124","185","0","0","124","185","1"
"8","2017","31","Otros","7","17","208","706","24","188","232","894","3"
"8","2017","31","Otros","14","31","241","398","268","724","509","1122","2.8"
"8","2017","31","Hotel","2","29","96","283","424","1289","520","1572","1"
"8","2017","30","Hotel","8","3","229","607","103","185","332","792","1"
"8","2017","31","Hotel","8","34","271","467","49","113","320","580","2.5714285714286"
"8","2017","31","Hotel","8","34","287","347","98","249","385","596","2.5714285714286"
"8","2017","31","Hotel","12","35","110","125","74","99","184","224","1"
"8","2017","31","Hotel","11","32","118","307","7","14","125","321","1"
"8","2017","31","Hotel","13","33","204","342","8","16","212","358","2"
"8","2017","31","Hotel","10","23","200","295","22","48","222","343","2.8"
"8","2017","31","Hotel","12","35","67","211","9","10","76","221","1"
"8","2017","31","","16","40","283","429","35","46","318","475","3.0555555555556"
"8","2017","31","Otros","16","19","97","257","0","0","97","257","1.3333333333333"
"8","2017","31","Otros","16","20","38","140","0","0","38","140","1"
"8","2017","31","Hotel","6","12","144","387","2","10","146","397","5"
"8","2017","31","Hotel","16","19","145","185","0","0","145","185","4"
"8","2017","31","Hotel","12","24","129","438","139","274","268","712","1"
"8","2017","31","Hotel","12","24","236","551","71","101","307","652","3"
"8","2017","31","Hotel","8","3","22","32","0","0","22","32","1"
"8","2017","31","Hotel","5","9","0","0","0","0","0","0","1"
"8","2017","31","Hotel","16","27","220","383","4","20","224","403","2.5"
"8","2017","31","Otros","10","23","35","35","0","0","35","35","7"
"8","2017","31","Otros","13","14","93","136","0","0","93","136","7.3846153846154"
"8","2017","31","Otros","2","6","44","102","9","24","53","126","1"
"8","2017","17","Hotel","15","16","3","3","73","84","76","87","7.8"
"8","2017","31","Hotel","8","3","180","618","0","0","180","618","1"
"8","2017","31","Hotel","8","34","624","1228","128","239","752","1467","1"
"8","2017","31","Hotel","8","3","28","35","24","41","52","76","1"
"8","2017","31","","2","29","83","176","16","35","99","211","1"
"8","2017","31","Hotel","2","1","265","407","45","97","310","504","6.4"
"8","2017","31","Hotel","7","17","128","242","0","0","128","242","4"
"8","2017","31","Otros","7","17","227","620","0","0","227","620","3"
"8","2017","31","Hotel","16","40","96","154","67","145","163","299","5.6666666666667"
"8","2017","31","Hotel","12","24","199","480","67","98","266","578","1"
"8","2017","31","Hotel","14","31","186","433","333","1350","519","1783","17.4"
"8","2017","0","Hotel","9","26","0","0","0","0","0","0","1"
"8","2017","31","Hotel","6","12","43","57","3","3","46","60","5"
"8","2017","31","Otros","5","9","3","3","8","8","11","11","4.0454545454545"
"8","2017","31","Otros","5","9","5","5","0","0","5","5","4.0454545454545"
"8","2017","31","Otros","15","27","44","56","0","0","44","56","1.4222222222222"
"8","2017","31","Hotel","8","34","2","2","3","3","5","5","2.5714285714286"
"8","2017","31","Hotel","10","18","357","664","104","175","461","839","7.75"
"8","2017","31","Hotel","15","16","315","666","56","118","371","784","7.8"
"8","2017","31","Hotel","2","29","104","308","210","720","314","1028","1"
"8","2017","31","Hotel","4","39","227","406","14","17","241","423","2.6"
"8","2017","31","Otros","4","39","135","211","1","1","136","212","2.2222222222222"
"8","2017","31","Hotel","4","13","237","464","43","89","280","553","5.4"
"8","2017","31","Otros","10","23","70","100","3","3","73","103","7"
"8","2017","31","Otros","14","31","127","197","399","1103","526","1300","20.2"
"8","2017","31","Hotel","3","4","46","72","24","39","70","111","2.6"
"8","2017","31","Hotel","10","23","63","178","13","28","76","206","4"
"8","2017","31","Otros","9","22","296","550","0","0","296","550","1"
"8","2017","31","Hotel","12","24","159","382","88","148","247","530","3"
"8","2017","31","Hotel","13","14","14","14","0","0","14","14","1"
"8","2017","31","Hotel","12","35","94","154","28","33","122","187","1.7272727272727"
"8","2017","31","Hotel","6","28","366","572","0","0","366","572","1"
"8","2017","31","","6","28","64","275","0","0","64","275","1"
"8","2017","31","Hotel","12","24","259","559","131","360","390","919","3"
"8","2017","31","Otros","5","9","12","18","4","4","16","22","4.0454545454545"
"8","2017","31","Hotel","16","20","33","39","0","0","33","39","1"
"8","2017","31","Hotel","4","21","397","671","24","26","421","697","3"
"8","2017","31","Otros","10","11","14","23","0","0","14","23","11.764705882353"
"8","2017","31","Otros","13","14","17","24","0","0","17","24","7.3846153846154"
"8","2017","31","Otros","16","27","31","51","0","0","31","51","13.818181818182"
"8","2017","31","Hotel","9","26","240","240","0","0","240","240","1"
"8","2017","31","Hotel","16","27","461","569","446","686","907","1255","2.5"
"8","2017","31","Hotel","3","4","1228","1968","334","487","1562","2455","3"
"8","2017","31","Otros","16","27","14","50","0","0","14","50","2"
"8","2017","31","Otros","16","19","432","574","4","4","436","578","1.3333333333333"
"8","2017","31","Hotel","6","12","465","672","0","0","465","672","5"
"8","2017","31","Hotel","2","1","208","508","1","2","209","510","6.4"
"8","2017","31","Hotel","10","11","339","560","5","5","344","565","1"
"8","2017","31","Otros","10","23","77","77","4","4","81","81","1"
"8","2017","31","Otros","10","27","507","561","38","48","545","609","4.84"
"8","2017","31","Hotel","16","27","171","234","7","15","178","249","2.5"
"8","2017","31","Hotel","6","28","144","186","12","29","156","215","1"
"8","2017","31","Hotel","4","13","135","404","13","21","148","425","5.4"
"8","2017","31","Hotel","14","27","634","819","39","74","673","893","8.5"
"8","2017","31","Hotel","10","27","140","205","217","293","357","498","1"
"8","2017","31","Hotel","13","27","68","102","27","39","95","141","4.2"
"8","2017","31","Hotel","3","4","552","876","4","10","556","886","3"
"8","2017","31","Otros","4","13","68","122","6","10","74","132","3.4"
"8","2017","31","Otros","11","15","19","36","0","0","19","36","2.3571428571429"
"8","2017","31","Otros","6","10","182","908","186","372","368","1280","3.8518518518518"
"8","2017","31","Otros","2","1","56","64","7","8","63","72","1"
"8","2017","31","","6","12","34","83","2","4","36","87","1"
"8","2017","31","Otros","10","23","266","798","0","0","266","798","1"
"8","2017","31","Hotel","16","19","64","189","0","0","64","189","4"
"8","2017","31","Hotel","10","11","2","2","0","0","2","2","5.6666666666667"
"8","2017","31","Hotel","10","23","62","62","1","1","63","63","4"
"8","2017","31","Otros","14","31","61","144","243","618","304","762","2.8"
"8","2017","31","Otros","13","27","5","5","0","0","5","5","12.2"
"8","2017","31","Hotel","2","1","241","697","0","0","241","697","6.4"
"8","2017","31","Hotel","16","19","34","68","0","0","34","68","4"
"8","2017","31","Otros","12","35","14","17","0","0","14","17","3.5"
"8","2017","31","Otros","15","16","94","167","15","23","109","190","2"
"8","2017","31","Otros","9","22","235","470","0","0","235","470","1"
"8","2017","31","Hotel","10","27","333","602","545","658","878","1260","1"
"8","2017","31","Hotel","2","27","112","152","0","0","112","152","3.6"
"8","2017","31","Hotel","16","20","53","143","22","52","75","195","1"
"8","2017","31","Hotel","10","18","185","323","43","67","228","390","7.75"
"8","2017","31","Hotel","6","12","340","349","0","0","340","349","5"
"8","2017","31","Hotel","2","27","85","286","3","22","88","308","3.6"
"8","2017","31","Hotel","15","16","138","251","12","23","150","274","7.8"
"8","2017","31","Hotel","10","23","99","99","16","16","115","115","4"
"8","2017","31","Hotel","11","32","39","42","2","2","41","44","1"
"8","2017","31","Hotel","14","27","124","375","28","85","152","460","8.5"
"8","2017","31","Otros","10","11","32","73","0","0","32","73","11.764705882353"
"8","2017","31","Hotel","2","27","82","183","12","17","94","200","3.6"
"8","2017","31","Otros","13","14","144","288","2","6","146","294","7.3846153846154"
"8","2017","31","Hotel","2","1","121","183","18","18","139","201","6.4"
"8","2017","31","Otros","7","17","219","604","0","0","219","604","17.166666666667"
"8","2017","31","Otros","10","23","38","212","0","0","38","212","7"
"8","2017","31","Hotel","13","27","153","153","4","4","157","157","2.75"
"8","2017","31","Otros","10","18","2","2","10","10","12","12","10.25"
"8","2017","31","Otros","5","9","8","15","0","0","8","15","4.0454545454545"
"8","2017","31","Hotel","4","39","91","95","0","0","91","95","2.6"
"8","2017","31","Otros","16","27","80","343","4","4","84","347","13.818181818182"
"8","2017","31","Hotel","14","27","39","73","94","280","133","353","8.5"
"8","2017","31","Hotel","10","11","71","107","8","17","79","124","5.6666666666667"
"8","2017","31","Hotel","10","18","212","428","62","131","274","559","7.75"
"8","2017","31","Otros","14","31","142","145","75","95","217","240","20.2"
"8","2017","31","Otros","11","32","9","17","0","0","9","17","2.2857142857143"
"8","2017","31","Otros","5","5","80","80","0","0","80","80","3.65625"
"8","2017","31","Otros","6","25","42","57","0","0","42","57","2.3846153846154"
"8","2017","31","Hotel","3","4","58","155","2","4","60","159","2.6"
"8","2017","31","Otros","7","27","69","112","2","2","71","114","4.8333333333333"
"8","2017","31","Otros","2","29","78","180","82","175","160","355","3.28"
"8","2017","31","Hotel","2","29","87","127","106","176","193","303","1"
"8","2017","31","Otros","4","21","167","331","6","8","173","339","1"
"8","2017","31","Hotel","7","27","247","494","0","0","247","494","4.1666666666667"
"8","2017","31","Otros","5","5","21","82","12","35","33","117","3.65625"
"8","2017","31","Otros","11","36","24","40","2","4","26","44","5.1904761904762"
"8","2017","31","Hotel","7","27","390","390","0","0","390","390","4.1666666666667"
"8","2017","0","Hotel","16","20","0","0","0","0","0","0","1"
"8","2017","31","Hotel","12","24","161","230","102","144","263","374","3"
"8","2017","31","Hotel","9","26","76","105","8","8","84","113","1.5"
"8","2017","31","Hotel","7","17","272","514","2","10","274","524","10"
"8","2017","31","Hotel","9","37","258","428","25","55","283","483","3.4"
"8","2017","31","Hotel","5","5","293","573","80","104","373","677","2.1428571428571"
"8","2017","31","Otros","6","27","60","120","0","0","60","120","3.960088691796"
"8","2017","31","Hotel","9","37","77","82","0","0","77","82","3.4"
"8","2017","31","Otros","10","27","31","84","69","106","100","190","4.84"
"8","2017","31","Otros","8","3","209","307","4","12","213","319","10"
"8","2017","31","Otros","16","20","23","25","0","0","23","25","3.0769230769231"
"8","2017","31","Otros","9","22","7","9","0","0","7","9","7.6428571428571"
"8","2017","31","Otros","10","27","179","235","9","9","188","244","4.84"
"8","2017","31","Otros","10","23","29","45","0","0","29","45","7"
"8","2017","31","Otros","2","6","591","591","215","215","806","806","1"
"8","2017","31","Otros","4","39","32","32","0","0","32","32","2.2222222222222"
"8","2017","31","Hotel","2","27","57","64","9","10","66","74","1"
"8","2017","31","Hotel","14","31","61","93","125","495","186","588","24"
"8","2017","31","Otros","2","29","181","376","134","202","315","578","3.28"
"8","2017","31","Otros","8","3","264","1320","3","21","267","1341","10"
"8","2017","31","","13","14","16","24","4","4","20","28","1"
"8","2017","31","Hotel","6","10","151","210","11","15","162","225","6.6"
"8","2017","31","Hotel","8","34","172","370","15","26","187","396","2.5714285714286"
"8","2017","31","Hotel","9","22","49","88","0","0","49","88","2.5555555555556"
"8","2017","31","Hotel","2","6","156","400","32","56","188","456","2.2"
"8","2017","31","Hotel","10","27","129","286","150","223","279","509","2.25"
"8","2017","31","Otros","14","27","117","117","0","0","117","117","11.833333333333"
"8","2017","31","Otros","6","12","371","550","17","31","388","581","1.8256578947368"
"8","2017","31","Hotel","6","27","129","197","0","0","129","197","3"
"8","2017","31","Hotel","5","5","16","30","0","0","16","30","2.1428571428571"
"8","2017","30","Hotel","5","5","93","128","4","8","97","136","2.1428571428571"
"8","2017","31","Hotel","13","27","380","450","0","0","380","450","4.2"
"8","2017","31","Hotel","2","27","171","219","4","12","175","231","3.6"
"8","2017","31","Hotel","8","3","49","49","44","44","93","93","4.1111111111111"
"8","2017","31","Otros","11","36","20","65","0","0","20","65","5.1904761904762"
"8","2017","31","Otros","9","30","115","246","0","0","115","246","2.3333333333333"
"8","2017","31","Otros","16","19","10","13","0","0","10","13","10.263157894737"
"8","2017","31","Hotel","14","31","40","66","299","1056","339","1122","17.4"
"8","2017","31","Hotel","2","1","313","374","11","15","324","389","6.4"
"8","2017","31","Hotel","16","40","857","1411","345","452","1202","1863","5.6666666666667"
"8","2017","31","Otros","7","17","374","754","4","4","378","758","17.166666666667"
"8","2017","31","Hotel","13","27","314","378","109","147","423","525","2.75"
"8","2017","31","Hotel","14","31","130","166","529","846","659","1012","24"
"8","2017","31","Otros","3","4","18","71","27","36","45","107","12.2"
"8","2017","31","Otros","8","34","232","273","160","226","392","499","5.75"
"8","2017","31","Hotel","9","22","86","109","0","0","86","109","2.5555555555556"
"8","2017","31","Hotel","4","21","66","135","0","0","66","135","3"
"8","2017","31","Hotel","6","27","82","132","0","0","82","132","3"
"8","2017","31","Hotel","12","35","67","118","20","28","87","146","1.7272727272727"
"8","2017","31","Hotel","2","29","29","61","38","105","67","166","2"
"8","2017","31","Otros","10","11","53","67","0","0","53","67","11.764705882353"
"8","2017","31","Hotel","6","10","77","157","0","0","77","157","6.6"
"8","2017","31","Hotel","13","14","51","74","1","1","52","75","2"
"8","2017","2","Otros","16","27","2","2","0","0","2","2","13.818181818182"
"8","2017","31","Otros","6","27","20","20","0","0","20","20","3.960088691796"
"8","2017","31","Hotel","16","40","224","230","112","125","336","355","5.6666666666667"
"8","2017","31","Otros","6","10","240","475","18","68","258","543","3.8518518518518"
"8","2017","31","Otros","10","23","31","40","8","8","39","48","7"
"8","2017","31","Hotel","6","28","195","231","6","6","201","237","1"
"8","2017","31","Otros","7","38","372","724","51","113","423","837","2.75"
"8","2017","31","Hotel","6","12","186","259","3","62","189","321","5"
"8","2017","31","Hotel","13","27","265","390","0","0","265","390","4.2"
"8","2017","31","Otros","4","21","58","99","0","0","58","99","4.8333333333333"
"8","2017","31","Hotel","16","27","57","179","2","2","59","181","5.8571428571429"
"8","2017","31","Hotel","5","5","41","45","14","15","55","60","2.1428571428571"
"8","2017","31","Otros","12","24","61","159","40","45","101","204","9.2"
"8","2017","31","Otros","15","16","85","126","8","14","93","140","9"
"8","2017","31","Hotel","8","27","85","85","4","4","89","89","4.5"
"8","2017","31","Hotel","9","22","75","123","0","0","75","123","2.5555555555556"
"8","2017","31","Hotel","10","11","60","115","7","11","67","126","5.6666666666667"
"8","2017","31","Hotel","8","3","45","76","16","32","61","108","4.1111111111111"
"8","2017","31","Hotel","6","10","483","632","0","0","483","632","6.6"
"8","2017","31","Otros","9","26","21","51","0","0","21","51","3.8888888888889"
"8","2017","31","Hotel","4","39","112","328","11","69","123","397","2.6"
"8","2017","31","Otros","6","27","1","1","0","0","1","1","3.960088691796"
"8","2017","31","Otros","6","12","180","246","0","0","180","246","1.8256578947368"
"8","2017","31","Hotel","6","27","75","147","1","6","76","153","3"
"8","2017","31","Otros","5","9","68","96","13","18","81","114","4.0454545454545"
"8","2017","31","Hotel","2","27","153","153","24","24","177","177","3.6"
"8","2017","31","Hotel","2","29","46","138","182","546","228","684","1"
"8","2017","31","Hotel","4","13","159","523","4","4","163","527","5.4"
"8","2017","31","","11","15","13","25","0","0","13","25","1"
"8","2017","31","Hotel","6","10","323","361","23","27","346","388","6.6"
"8","2017","31","Otros","6","12","18","70","0","0","18","70","1.8256578947368"
"8","2017","31","Otros","10","18","32","33","2","2","34","35","10.25"
"8","2017","31","Otros","9","22","86","131","0","0","86","131","7.6428571428571"
"8","2017","31","","14","27","203","346","0","0","203","346","1"
"8","2017","31","Hotel","16","27","94","238","1","1","95","239","5.8571428571429"
"8","2017","31","Otros","2","29","23","49","29","64","52","113","3.28"
"8","2017","31","Otros","13","33","50","51","0","0","50","51","5.125"
"8","2017","31","Otros","13","33","23","34","4","5","27","39","5.125"
"8","2017","31","Otros","6","10","100","283","0","0","100","283","3.8518518518518"
"8","2017","31","Hotel","10","18","41","81","15","28","56","109","7.75"
"8","2017","31","Hotel","14","31","134","243","74","172","208","415","24"
"8","2017","31","Hotel","4","21","11","11","6","6","17","17","3"
"8","2017","31","Hotel","3","4","25","89","9","22","34","111","2.6"
"8","2017","31","Otros","8","27","0","0","0","0","0","0","1"
"8","2017","31","Otros","6","27","10","19","0","0","10","19","3.960088691796"
"8","2017","31","Hotel","6","25","174","302","0","0","174","302","1"
"8","2017","31","Otros","6","12","217","381","6","10","223","391","1.8256578947368"
"8","2017","31","Hotel","6","27","21","31","0","0","21","31","3"
"8","2017","31","Otros","6","27","1","2","0","0","1","2","3.960088691796"
"8","2017","31","Otros","6","10","45","180","0","0","45","180","3.8518518518518"
"8","2017","31","Otros","6","12","30","48","0","0","30","48","1.8256578947368"
"8","2017","31","Otros","5","5","15","31","0","0","15","31","3.65625"
"8","2017","31","Hotel","12","24","285","346","1","2","286","348","3"
"8","2017","31","Hotel","15","16","75","130","2","2","77","132","7.8"
"8","2017","31","Otros","4","13","49","131","3","5","52","136","3.4"
"8","2017","31","Hotel","2","29","172","485","40","113","212","598","1"
"8","2017","31","Hotel","4","21","45","100","12","28","57","128","3"
"8","2017","31","Hotel","10","27","151","207","407","467","558","674","2.25"
"8","2017","31","Hotel","8","3","191","272","28","35","219","307","4.1111111111111"
"8","2017","31","Hotel","12","27","79","110","33","40","112","150","1"
"8","2017","31","Otros","5","5","99","173","42","109","141","282","3.65625"
"8","2017","31","Otros","13","14","19","23","0","0","19","23","7.3846153846154"
"8","2017","31","Otros","10","11","147","413","0","0","147","413","11.764705882353"
"8","2017","31","Otros","16","40","120","261","15","15","135","276","28.142857142857"
"8","2017","31","Hotel","11","36","306","557","18","20","324","577","1"
"8","2017","31","Otros","8","34","63","97","53","75","116","172","5.75"
"8","2017","31","Hotel","7","17","146","244","12","14","158","258","10"
"8","2017","31","Otros","12","35","199","428","6","8","205","436","3.5"
"8","2017","31","Otros","5","9","6","8","1","1","7","9","4.0454545454545"
"8","2017","31","Hotel","9","22","20","22","0","0","20","22","2.5555555555556"
"8","2017","31","Otros","2","29","75","135","86","193","161","328","3.28"
"8","2017","31","Otros","2","29","100","210","146","532","246","742","3.28"
"8","2017","31","Hotel","10","27","64","134","84","97","148","231","2.25"
"8","2017","31","Hotel","16","19","81","92","16","22","97","114","4"
"8","2017","31","Hotel","16","40","170","224","26","52","196","276","16.333333333333"
"8","2017","31","Hotel","8","27","244","402","12","26","256","428","4.5"
"8","2017","31","Otros","13","14","31","49","0","0","31","49","7.3846153846154"
"8","2017","31","Hotel","7","27","36","47","0","0","36","47","4.1666666666667"
"8","2017","31","Otros","2","6","1","1","0","0","1","1","5"
"8","2017","31","Hotel","7","17","364","748","9","17","373","765","10"
"8","2017","31","Hotel","3","4","133","307","73","132","206","439","2.6"
"8","2017","31","Otros","6","12","15","55","0","0","15","55","1.8256578947368"
"8","2017","12","Otros","6","10","9","9","0","0","9","9","3.8518518518518"
"8","2017","31","Hotel","16","40","24","46","10","20","34","66","16.333333333333"
"8","2017","31","Otros","4","39","138","237","10","18","148","255","2.2222222222222"
"8","2017","31","Otros","13","14","12","24","0","0","12","24","7.3846153846154"
"8","2017","31","Otros","7","38","111","167","6","14","117","181","2.75"
"8","2017","31","Hotel","11","32","109","191","0","0","109","191","1"
"8","2017","31","Otros","11","36","116","252","10","15","126","267","5.1904761904762"
"8","2017","31","Hotel","4","21","51","91","1","1","52","92","3"
"8","2017","31","Otros","3","4","2","4","4","12","6","16","12.2"
"8","2017","31","Otros","5","9","41","49","8","16","49","65","4.0454545454545"
"8","2017","31","Hotel","8","27","73","144","3","3","76","147","4.5"
"8","2017","31","","7","17","197","285","0","0","197","285","1"
"8","2017","31","Otros","16","20","28","82","0","0","28","82","3.0769230769231"
"8","2017","31","Otros","4","21","41","82","0","0","41","82","4.8333333333333"
"8","2017","31","Otros","13","33","56","80","4","4","60","84","5.125"
"8","2017","0","","12","35","0","0","0","0","0","0","1"
"8","2017","31","Hotel","13","33","1","1","0","0","1","1","2"
"8","2017","31","Otros","4","39","66","156","0","0","66","156","2.2222222222222"
"8","2017","31","Otros","10","18","12","35","0","0","12","35","10.25"
"8","2017","31","Otros","6","27","84","114","0","0","84","114","3.960088691796"
"8","2017","31","Hotel","4","39","75","175","0","0","75","175","2.6"
"8","2017","31","Otros","14","31","56","169","119","228","175","397","20.2"
"8","2017","31","Hotel","2","29","76","195","200","391","276","586","2"
"8","2017","31","Hotel","9","26","236","383","13","41","249","424","1.5"
"8","2017","31","Otros","12","35","2","2","2","2","4","4","3.5"
"8","2017","31","Hotel","14","27","98","137","47","57","145","194","8.5"
"8","2017","31","Otros","11","36","8","19","1","3","9","22","5.1904761904762"
"8","2017","31","Otros","16","20","126","260","10","12","136","272","3.0769230769231"
"8","2017","31","Otros","4","39","4","9","0","0","4","9","2.2222222222222"
"8","2017","31","Otros","7","27","122","134","0","0","122","134","4.8333333333333"
"8","2017","31","Otros","6","27","66","111","0","0","66","111","3.960088691796"
"8","2017","31","Otros","5","8","10","310","0","0","10","310","5"
"8","2017","31","Otros","9","37","169","268","6","6","175","274","4.5"
"8","2017","31","Hotel","2","6","41","91","0","0","41","91","5.5"
"8","2017","31","Hotel","10","27","354","643","247","340","601","983","2.25"
"8","2017","31","Hotel","9","30","142","244","5","6","147","250","1"
"8","2017","31","Otros","4","13","27","91","16","33","43","124","3.4"
"8","2017","31","Hotel","5","5","345","345","0","0","345","345","1"
"8","2017","31","Otros","7","38","91","190","0","0","91","190","2.75"
"8","2017","31","Hotel","13","14","16","17","0","0","16","17","1"
"8","2017","31","Otros","5","9","15","21","0","0","15","21","4.0454545454545"
"8","2017","31","Otros","5","8","1","2","0","0","1","2","5"
"8","2017","31","Otros","10","27","37","444","0","0","37","444","4.84"
"8","2017","31","Hotel","13","14","0","0","0","0","0","0","1"
"8","2017","31","Otros","11","15","21","37","0","0","21","37","2.3571428571429"
"8","2017","31","Hotel","9","22","176","178","0","0","176","178","2.5555555555556"
"8","2017","31","Otros","11","36","70","84","4","4","74","88","5.1904761904762"
"8","2017","31","Hotel","10","18","2182","4072","1175","2685","3357","6757","1"
"8","2017","31","Hotel","6","12","174","320","0","0","174","320","5"
"8","2017","31","","2","29","458","1221","324","824","782","2045","1"
"8","2017","31","Hotel","16","27","1189","2399","24","62","1213","2461","1"
"8","2017","31","","14","31","370","754","572","2299","942","3053","1"
"8","2017","31","Hotel","8","3","6","8","2","2","8","10","4.1111111111111"
"8","2017","31","Otros","13","33","16","26","0","0","16","26","5.125"
"8","2017","31","","14","27","129","130","0","0","129","130","2.6666666666667"
"8","2017","31","Otros","9","22","27","31","0","0","27","31","7.6428571428571"
"8","2017","31","Hotel","10","11","19","19","0","0","19","19","5.6666666666667"
"8","2017","31","Otros","6","12","27","236","0","0","27","236","1.8256578947368"
"8","2017","18","Hotel","8","3","37","38","4","4","41","42","4.1111111111111"
"8","2017","31","Otros","6","12","213","298","0","0","213","298","1.8256578947368"
"8","2017","31","Hotel","8","27","235","235","1","1","236","236","4.5"
"8","2017","31","Hotel","6","28","99","120","1","1","100","121","2.4"
"8","2017","31","Otros","6","25","21","91","0","0","21","91","2.3846153846154"
"8","2017","31","Otros","6","25","91","116","0","0","91","116","2.3846153846154"
"8","2017","31","Hotel","11","36","618","1410","0","0","618","1410","1"
"8","2017","31","Otros","2","6","26","56","175","438","201","494","5"
"8","2017","31","Hotel","14","31","73","109","145","424","218","533","24"
"8","2017","31","Otros","4","21","38","57","0","0","38","57","4.8333333333333"
"8","2017","31","Otros","7","38","27","42","2","2","29","44","2.75"
"8","2017","31","Otros","13","14","13","14","0","0","13","14","7.3846153846154"
"8","2017","31","Otros","2","29","33","41","27","44","60","85","3.28"
"8","2017","31","Otros","3","4","89","89","17","17","106","106","12.2"
"8","2017","31","Hotel","3","4","462","964","15","26","477","990","3"
"8","2017","31","Otros","7","27","156","200","12","12","168","212","1"
"8","2017","31","Otros","7","17","85","90","0","0","85","90","3"
"8","2017","31","Hotel","12","27","255","367","91","93","346","460","1"
"8","2017","31","Otros","5","5","34","37","2","2","36","39","3.65625"
"8","2017","31","Hotel","6","10","384","535","0","0","384","535","6.6"
"8","2017","31","Otros","10","18","9","17","23","38","32","55","10.25"
"8","2017","31","Otros","8","27","58","84","0","0","58","84","9.4"
"8","2017","31","Otros","8","3","22","28","6","12","28","40","10"
"8","2017","31","Hotel","16","27","50","93","3","6","53","99","5.8571428571429"
"8","2017","31","Otros","6","10","39","166","0","0","39","166","3.8518518518518"
"8","2017","31","Hotel","2","6","44","80","2","2","46","82","5.5"
"8","2017","31","Hotel","8","3","2","2","0","0","2","2","4.1111111111111"
"8","2017","31","Otros","10","11","21","43","7","11","28","54","11.764705882353"
"8","2017","31","Otros","6","27","84","86","0","0","84","86","3.960088691796"
"8","2017","31","Otros","15","16","1","1","0","0","1","1","9"
"8","2017","31","Otros","5","5","1","1","0","0","1","1","3.65625"
"8","2017","31","Otros","10","27","68","110","39","55","107","165","4.84"
"8","2017","31","Hotel","7","38","52","131","2","2","54","133","1"
"8","2017","31","Hotel","13","27","5","5","0","0","5","5","4.2"
"8","2017","31","Hotel","16","20","78","95","0","0","78","95","1"
"8","2017","31","Otros","10","27","25","29","0","0","25","29","4.84"
"8","2017","31","Hotel","3","7","55","85","20","33","75","118","1"
"8","2017","31","Otros","2","29","44","56","33","41","77","97","3.28"
"8","2017","31","Otros","10","18","9","72","0","0","9","72","10.25"
"8","2017","31","Otros","9","22","84","133","0","0","84","133","7.6428571428571"
"8","2017","31","Otros","15","27","46","46","2","2","48","48","1.4222222222222"
"8","2017","31","Otros","11","36","2","2","0","0","2","2","5.1904761904762"
"8","2017","31","Otros","5","5","25","41","5","11","30","52","3.65625"
"8","2017","31","Otros","2","29","42","67","46","95","88","162","3.28"
"8","2017","31","Hotel","9","22","142","142","15","15","157","157","2.5555555555556"
"8","2017","31","Otros","11","32","6","11","0","0","6","11","2.2857142857143"
"8","2017","31","Hotel","10","27","256","409","179","237","435","646","1"
"8","2017","31","Otros","16","27","84","110","0","0","84","110","2"
"8","2017","31","Hotel","16","20","22","36","0","0","22","36","1"
"8","2017","31","Otros","11","15","21","61","0","0","21","61","2.3571428571429"
"8","2017","31","Otros","7","17","115","513","0","0","115","513","3"
"8","2017","24","Otros","5","8","2","3","1","1","3","4","5"
"8","2017","31","Hotel","13","33","86","106","0","0","86","106","2"
"8","2017","31","Otros","5","9","14","17","9","11","23","28","4.0454545454545"
"8","2017","31","Otros","10","27","76","220","24","29","100","249","4.84"
"8","2017","31","Otros","9","22","24","120","0","0","24","120","7.6428571428571"
"8","2017","31","Otros","16","40","21","48","0","0","21","48","28.142857142857"
"8","2017","31","Hotel","16","40","53","53","6","6","59","59","1"
"8","2017","24","Otros","15","16","16","43","2","12","18","55","9"
"8","2017","31","Hotel","8","2","12","13","0","0","12","13","3"
"8","2017","31","Otros","8","3","6","8","0","0","6","8","10"
"8","2017","31","Otros","7","17","34","41","0","0","34","41","17.166666666667"
"8","2017","31","Otros","16","20","52","112","0","0","52","112","3.0769230769231"
"8","2017","31","Otros","6","27","26","43","0","0","26","43","3.960088691796"
"8","2017","31","Otros","12","35","20","26","11","34","31","60","3.5"
"8","2017","31","Otros","6","28","99","360","7","18","106","378","4.65"
"8","2017","31","Otros","6","28","253","573","13","13","266","586","4.65"
"8","2017","31","Hotel","8","34","168","297","55","84","223","381","2.5714285714286"
"8","2017","31","Hotel","16","20","1228","2496","10","31","1238","2527","1"
"8","2017","31","Hotel","2","6","37","72","0","0","37","72","2.2"
"8","2017","31","Hotel","7","27","57","57","2","2","59","59","4.1666666666667"
"8","2017","31","Hotel","10","23","27","757","0","0","27","757","4"
"8","2017","31","Hotel","9","26","33","45","0","0","33","45","1.5"
"8","2017","31","Otros","8","27","10","10","0","0","10","10","9.4"
"8","2017","31","Otros","10","27","14","14","3","3","17","17","4.84"
"8","2017","31","Otros","11","15","10","20","0","0","10","20","2.3571428571429"
"8","2017","31","Otros","16","20","7","7","0","0","7","7","3.0769230769231"
"8","2017","31","Otros","11","32","53","63","0","0","53","63","1"
"8","2017","31","Otros","16","27","37","37","4","4","41","41","13.818181818182"
"8","2017","31","Otros","9","37","84","86","0","0","84","86","4.5"
"8","2017","31","Hotel","2","29","3","5","31","68","34","73","2"
"8","2017","31","Hotel","2","1","77","131","0","0","77","131","6.4"
"8","2017","31","Otros","5","8","10","16","2","2","12","18","5"
"8","2017","31","Otros","9","37","72","118","15","34","87","152","4.5"
"8","2017","31","Otros","7","38","143","208","0","0","143","208","2.75"
"8","2017","31","Otros","11","32","34","73","2","2","36","75","1"
"8","2017","31","Otros","4","39","131","162","0","0","131","162","2.2222222222222"
"8","2017","31","Hotel","11","36","54","121","24","52","78","173","2.375"
"8","2017","31","Otros","10","23","29","62","6","16","35","78","7"
"8","2017","31","Hotel","15","16","842","1865","141","269","983","2134","2"
"8","2017","31","Otros","2","29","42","95","97","198","139","293","3.28"
"8","2017","31","Hotel","6","12","741","886","6","8","747","894","1"
"8","2017","31","Hotel","11","15","40","120","0","0","40","120","1"
"8","2017","31","Otros","4","21","320","455","14","30","334","485","1"
"8","2017","31","Otros","16","19","60","60","0","0","60","60","10.263157894737"
"8","2017","31","","9","37","299","380","2","2","301","382","1"
"8","2017","31","Otros","10","27","113","165","119","148","232","313","4.84"
"8","2017","31","Otros","11","15","58","58","0","0","58","58","2.3571428571429"
"8","2017","31","Hotel","2","29","60","180","74","222","134","402","2"
"8","2017","31","Hotel","10","27","337","349","108","131","445","480","1"
"8","2017","31","Hotel","11","36","61","167","20","47","81","214","2.375"
"8","2017","31","Hotel","9","37","121","150","14","22","135","172","3.4"
"8","2017","13","Otros","14","27","4","8","2","2","6","10","11.833333333333"
"8","2017","31","Otros","7","38","149","186","4","8","153","194","1"
"8","2017","31","Hotel","2","1","39","237","0","0","39","237","6.4"
"8","2017","31","Otros","2","29","23","72","63","212","86","284","3.28"
"8","2017","31","Hotel","6","27","17","27","0","0","17","27","3"
"8","2017","31","Otros","5","9","17","52","0","0","17","52","4.0454545454545"
"8","2017","31","Hotel","2","1","186","237","0","0","186","237","6.4"
"8","2017","31","Hotel","3","7","30","123","96","116","126","239","1"
"8","2017","31","Otros","7","38","106","106","97","97","203","203","2.75"
"8","2017","31","Otros","7","17","15","300","0","0","15","300","17.166666666667"
"8","2017","31","Otros","7","38","22","40","0","0","22","40","2.75"
"8","2017","31","Otros","4","21","22","26","0","0","22","26","4.8333333333333"
"8","2017","31","Otros","2","1","66","66","1","1","67","67","5.5"
"8","2017","31","Otros","12","35","12","21","5","8","17","29","3.5"
"8","2017","31","Otros","12","35","12","21","5","8","17","29","3.5"
"8","2017","31","Otros","4","21","50","64","6","7","56","71","4.8333333333333"
"8","2017","31","Otros","12","24","15","100","12","50","27","150","9.2"
"8","2017","31","Otros","16","19","2","2","0","0","2","2","10.263157894737"
"8","2017","31","Otros","10","11","50","51","0","0","50","51","11.764705882353"
"8","2017","31","Otros","16","19","22","30","0","0","22","30","10.263157894737"
"8","2017","31","Hotel","2","27","16","16","0","0","16","16","1"
"8","2017","31","Otros","6","28","18","18","0","0","18","18","4.65"
"8","2017","31","Otros","10","18","160","304","10","20","170","324","10.25"
"8","2017","31","Otros","14","27","66","232","0","0","66","232","11.833333333333"
"8","2017","31","Hotel","11","32","2","6","0","0","2","6","1"
"8","2017","31","Otros","8","27","17","65","0","0","17","65","9.4"
"8","2017","31","Hotel","12","35","65","118","22","49","87","167","1.7272727272727"
"8","2017","31","Otros","13","14","12","12","0","0","12","12","7.3846153846154"
"8","2017","31","Otros","11","36","28","66","0","0","28","66","5.1904761904762"
"8","2017","31","Otros","16","20","14","20","0","0","14","20","3.0769230769231"
"8","2017","31","Hotel","14","31","84","270","732","3774","816","4044","7.8"
"8","2017","31","Otros","2","27","159","239","12","40","171","279","3.2"
"8","2017","31","","16","40","183","369","0","0","183","369","3.0555555555556"
"8","2017","31","Hotel","11","36","105","136","10","16","115","152","2.375"
"8","2017","31","Hotel","9","22","16","20","0","0","16","20","2.5555555555556"
"8","2017","31","Otros","2","29","29","41","30","45","59","86","3.28"
"8","2017","31","Hotel","10","27","5","7","47","49","52","56","2.25"
"8","2017","31","Otros","10","27","13","49","0","0","13","49","4.84"
"8","2017","31","Hotel","16","19","9","9","0","0","9","9","4"
"8","2017","22","Otros","2","6","23","23","0","0","23","23","5"
"8","2017","31","Otros","7","27","156","218","0","0","156","218","4.8333333333333"
"8","2017","31","Hotel","2","6","127","989","0","0","127","989","5.5"
"8","2017","31","Hotel","6","28","1","1","2","2","3","3","2.4"
"8","2017","31","Otros","6","10","272","833","21","65","293","898","3.8518518518518"
"8","2017","31","Hotel","6","27","26","37","1","1","27","38","3"
"8","2017","31","Otros","5","5","25","41","5","11","30","52","3.65625"
"8","2017","31","Otros","12","24","69","132","56","75","125","207","9.2"
"8","2017","31","Hotel","8","2","99","380","35","119","134","499","3"
"8","2017","31","Hotel","11","32","11","77","0","0","11","77","1"
"8","2017","31","Otros","10","18","4","12","18","38","22","50","10.25"
"8","2017","31","Hotel","9","37","22","24","0","0","22","24","3.4"
"8","2017","31","Otros","5","9","12","16","4","4","16","20","4.0454545454545"
"8","2017","31","Otros","12","24","4","7","2","2","6","9","9.2"
"8","2017","31","Otros","9","22","1","1","0","0","1","1","7.6428571428571"
"8","2017","31","Otros","2","29","25","61","20","63","45","124","3.28"
"8","2017","31","Otros","10","23","7","147","0","0","7","147","7"
"8","2017","31","Otros","10","27","59","141","8","32","67","173","4.84"
"8","2017","31","Otros","10","11","25","25","0","0","25","25","11.764705882353"
"8","2017","31","Otros","8","3","23","62","0","0","23","62","10"
"8","2017","31","Otros","14","31","77","171","159","398","236","569","20.2"
"8","2017","31","Otros","2","29","174","436","160","406","334","842","3.28"
"8","2017","0","Otros","6","25","0","0","0","0","0","0","1"
"8","2017","31","Hotel","15","16","31","57","0","0","31","57","7.8"
"8","2017","31","Hotel","15","27","63","73","2","2","65","75","1"
"8","2017","31","Otros","10","27","2","4","3","6","5","10","4.84"
"8","2017","31","Otros","10","23","38","38","0","0","38","38","7"
"8","2017","31","Otros","6","27","6","6","0","0","6","6","3.960088691796"
"8","2017","31","Otros","16","40","115","235","9","17","124","252","28.142857142857"
"8","2017","31","Otros","11","36","64","77","2","2","66","79","5.1904761904762"
"8","2017","31","Otros","8","34","28","51","13","18","41","69","5.75"
"8","2017","31","Otros","6","12","12","150","0","0","12","150","1.8256578947368"
"8","2017","31","Otros","6","10","213","347","0","0","213","347","3.8518518518518"
"8","2017","31","Hotel","4","21","195","300","23","23","218","323","3"
"8","2017","31","Hotel","11","36","82","261","12","22","94","283","2.375"
"8","2017","31","Otros","5","8","66","85","17","17","83","102","5"
"8","2017","31","Hotel","7","17","124","159","0","0","124","159","10"
"8","2017","27","Hotel","11","36","321","399","9","9","330","408","1"
"8","2017","31","Otros","9","30","6","6","0","0","6","6","2.3333333333333"
"8","2017","31","Hotel","12","35","55","90","36","58","91","148","1.7272727272727"
"8","2017","31","Otros","2","1","97","234","8","8","105","242","5.5"
"8","2017","31","Hotel","6","25","65","76","0","0","65","76","1"
"8","2017","31","Otros","5","5","0","0","12","224","12","224","3.65625"
"8","2017","31","Otros","2","29","19","48","87","253","106","301","3.28"
"8","2017","31","Hotel","2","6","17","18","13","13","30","31","5.5"
"8","2017","31","Otros","7","17","15","45","0","0","15","45","17.166666666667"
"8","2017","31","Hotel","8","2","66","66","15","15","81","81","3"
"8","2017","31","Hotel","13","14","6","10","0","0","6","10","1"
"8","2017","31","Otros","7","38","26","66","6","8","32","74","2.75"
"8","2017","31","Hotel","14","31","9","14","43","126","52","140","24"
"8","2017","31","Hotel","5","5","41","71","4","12","45","83","2.1428571428571"
"8","2017","31","Otros","2","27","1","1","3","3","4","4","3.2"
"8","2017","12","Otros","5","8","12","20","0","0","12","20","5"
"8","2017","31","Otros","3","4","6","22","0","0","6","22","12.2"
"8","2017","31","Otros","13","14","7","17","0","0","7","17","7.3846153846154"
"8","2017","31","Otros","9","37","56","60","0","0","56","60","4.5"
"8","2017","31","Hotel","10","23","567","732","20","31","587","763","1"
"8","2017","31","Otros","11","32","16","16","0","0","16","16","2.2857142857143"
"8","2017","31","Otros","11","15","19","38","0","0","19","38","2.3571428571429"
"8","2017","31","Otros","8","3","16","16","0","0","16","16","10"
"8","2017","31","Otros","16","20","31","49","0","0","31","49","3.0769230769231"
"8","2017","31","Otros","8","3","11","27","0","0","11","27","10"
"8","2017","31","Otros","16","27","12","12","0","0","12","12","2"
"8","2017","31","Hotel","16","19","11","16","0","0","11","16","4"
"8","2017","31","Hotel","16","27","58","130","0","0","58","130","5.8571428571429"
"8","2017","31","Otros","9","26","20","30","1","2","21","32","3.8888888888889"
"8","2017","31","Otros","5","5","12","16","0","0","12","16","3.65625"
"8","2017","31","Otros","14","27","3","30","2","2","5","32","11.833333333333"
"8","2017","31","Hotel","5","5","1","1","0","0","1","1","2.1428571428571"
"8","2017","31","Hotel","12","24","90","162","125","243","215","405","3"
"8","2017","31","Otros","16","27","5","12","0","0","5","12","13.818181818182"
"8","2017","31","Hotel","14","31","20","24","252","661","272","685","1"
"8","2017","31","Otros","8","3","6","26","2","4","8","30","1"
"8","2017","31","Otros","13","27","100","131","2","9","102","140","12.2"
"8","2017","31","Hotel","16","40","26","40","28","55","54","95","16.333333333333"
"8","2017","31","Otros","11","36","40","162","0","0","40","162","1"
"8","2017","31","Otros","10","27","22","26","5","5","27","31","4.84"
"8","2017","31","Otros","9","22","7","17","0","0","7","17","7.6428571428571"
"8","2017","31","Hotel","5","5","31","37","2","4","33","41","2.1428571428571"
"8","2017","31","Otros","2","29","47","91","74","220","121","311","3.28"
"8","2017","31","Otros","2","29","6","7","0","0","6","7","3.28"
"8","2017","31","Hotel","13","14","12","12","0","0","12","12","1"
"8","2017","31","Otros","6","25","4","10","0","0","4","10","2.3846153846154"
"8","2017","31","Otros","2","1","27","40","5","5","32","45","5.5"
"8","2017","31","Hotel","12","27","240","342","2","2","242","344","1"
"8","2017","31","Hotel","13","27","26","26","0","0","26","26","4.2"
"8","2017","31","Otros","6","12","128","283","2","4","130","287","1.8256578947368"
"8","2017","31","Otros","6","27","1","1","0","0","1","1","3.960088691796"
"8","2017","31","Otros","6","25","6","6","0","0","6","6","2.3846153846154"
"8","2017","31","Hotel","6","28","21","60","0","0","21","60","2.5833333333333"
"8","2017","31","Otros","5","5","25","41","5","12","30","53","3.65625"
"8","2017","31","Otros","5","9","8","12","0","0","8","12","4.0454545454545"
"8","2017","31","Otros","5","8","13","13","4","4","17","17","5"
"8","2017","31","Hotel","2","29","140","358","40","121","180","479","1"
"8","2017","31","Otros","5","5","72","151","13","31","85","182","3.65625"
"8","2017","31","Hotel","9","26","8","10","8","11","16","21","1.5"
"8","2017","31","Otros","9","30","22","27","0","0","22","27","2.3333333333333"
"8","2017","31","Otros","11","15","8","25","0","0","8","25","2.3571428571429"
"8","2017","31","Hotel","16","27","2","4","3","3","5","7","5.8571428571429"
"8","2017","31","Otros","9","30","2","4","0","0","2","4","2.3333333333333"
"8","2017","31","Otros","2","29","19","54","19","54","38","108","3.28"
"8","2017","31","Otros","7","38","37","60","12","22","49","82","2.75"
"8","2017","31","Otros","4","21","28","68","0","0","28","68","4.8333333333333"
"8","2017","31","Otros","9","22","16","18","0","0","16","18","7.6428571428571"
"8","2017","31","Otros","9","22","148","222","0","0","148","222","7.6428571428571"
"8","2017","1","Otros","13","27","2","2","0","0","2","2","12.2"
"8","2017","31","Hotel","11","36","1512","1597","85","126","1597","1723","1"
"8","2017","31","Otros","13","33","7","9","0","0","7","9","5.125"
"8","2017","31","Otros","11","36","104","256","48","101","152","357","5.1904761904762"
"8","2017","2","Otros","12","35","2","4","0","0","2","4","3.5"
"8","2017","31","Otros","12","35","12","21","5","8","17","29","3.5"
"8","2017","31","Otros","10","11","7","24","0","0","7","24","11.764705882353"
"8","2017","31","Otros","12","24","4","8","15","30","19","38","9.2"
"8","2017","31","Otros","16","20","20","45","0","0","20","45","3.0769230769231"
"8","2017","31","Hotel","7","27","61","67","4","4","65","71","1"
"8","2017","31","Otros","6","12","17","20","0","0","17","20","1.8256578947368"
"8","2017","31","Otros","11","32","18","42","5","12","23","54","2.2857142857143"
"8","2017","31","Otros","6","28","106","124","0","0","106","124","4.65"
"8","2017","31","Otros","8","34","1","1","0","0","1","1","5.75"
"8","2017","31","Otros","16","27","76","78","0","0","76","78","13.818181818182"
"8","2017","31","Otros","10","11","1","1","0","0","1","1","11.764705882353"
"8","2017","31","Otros","6","10","55","146","8","32","63","178","3.8518518518518"
"8","2017","31","Otros","8","3","43","115","3","6","46","121","10"
"8","2017","31","Hotel","16","20","129","147","0","0","129","147","1"
"8","2017","31","Hotel","11","32","10","13","0","0","10","13","1"
"8","2017","31","Otros","8","27","7","13","3","3","10","16","9.4"
"8","2017","31","Otros","12","27","77","321","5","5","82","326","3.4285714285714"
"8","2017","31","Otros","6","10","72","198","13","65","85","263","3.8518518518518"
"8","2017","31","Otros","6","10","28","49","0","0","28","49","3.8518518518518"
"8","2017","31","Otros","5","8","7","15","0","0","7","15","5"
"8","2017","31","Otros","5","8","1","1","2","2","3","3","5"
"8","2017","31","Hotel","9","26","30","48","7","45","37","93","1.5"
"8","2017","31","Hotel","13","14","15","23","0","0","15","23","1"
"8","2017","31","Otros","10","18","29","53","13","24","42","77","10.25"
"8","2017","31","Otros","8","2","40","46","34","34","74","80","6.4285714285714"
"8","2017","31","Otros","7","27","5","10","0","0","5","10","4.8333333333333"
"8","2017","31","Otros","2","29","7","15","10","33","17","48","3.28"
"8","2017","31","Otros","11","32","30","57","2","2","32","59","2.2857142857143"
"8","2017","31","Otros","9","30","3","6","0","0","3","6","2.3333333333333"
"8","2017","31","Otros","2","29","19","60","8","26","27","86","3.28"
"8","2017","31","Otros","5","5","1","1","0","0","1","1","3.65625"
"8","2017","31","Otros","11","15","10","18","0","0","10","18","2.3571428571429"
"8","2017","31","Otros","10","23","13","30","0","0","13","30","7"
"8","2017","31","Otros","11","36","64","105","8","8","72","113","5.1904761904762"
"8","2017","31","Hotel","3","7","31","62","95","175","126","237","1"
"8","2017","31","Otros","10","27","2","2","0","0","2","2","4.84"
"8","2017","31","Otros","2","27","8","8","0","0","8","8","3.2"
"8","2017","31","Otros","12","35","0","0","15","15","15","15","3.5"
"8","2017","31","Otros","10","27","50","65","2","2","52","67","4.84"
"8","2017","31","Otros","16","40","15","34","117","299","132","333","28.142857142857"
"8","2017","31","Hotel","8","3","260","385","116","185","376","570","4.1111111111111"
"8","2017","31","Otros","9","22","22","22","0","0","22","22","7.6428571428571"
"8","2017","31","Otros","13","14","48","92","0","0","48","92","7.3846153846154"
"8","2017","31","Otros","5","9","12","16","4","4","16","20","4.0454545454545"
"8","2017","31","Otros","10","18","10","38","20","33","30","71","10.25"
"8","2017","31","Otros","6","25","19","27","0","0","19","27","2.3846153846154"
"8","2017","31","Otros","9","22","38","80","0","0","38","80","7.6428571428571"
"8","2017","31","Otros","10","27","29","130","5","5","34","135","4.84"
"8","2017","31","Otros","16","20","34","50","0","0","34","50","3.0769230769231"
"8","2017","31","Hotel","7","17","141","252","0","0","141","252","10"
"8","2017","31","Otros","15","27","29","58","0","0","29","58","1.4222222222222"
"8","2017","31","Otros","12","35","0","0","3","3","3","3","3.5"
"8","2017","31","Otros","12","35","6","6","9","24","15","30","3.5"
"8","2017","31","Otros","3","7","7","34","0","0","7","34","2"
"8","2017","31","Otros","10","11","30","56","0","0","30","56","11.764705882353"
"8","2017","31","Otros","12","24","4","5","0","0","4","5","9.2"
"8","2017","31","Otros","10","23","19","27","0","0","19","27","7"
"8","2017","31","Otros","7","27","4","10","0","0","4","10","4.8333333333333"
"8","2017","31","","10","18","5","11","0","0","5","11","1"
"8","2017","31","Otros","16","27","2","2","2","2","4","4","13.818181818182"
"8","2017","31","Hotel","2","29","3","10","19","53","22","63","1"
"8","2017","31","Otros","14","27","4","20","0","0","4","20","11.833333333333"
"8","2017","31","Otros","11","32","50","53","0","0","50","53","2.2857142857143"
"8","2017","31","Otros","16","19","4","8","0","0","4","8","1"
"8","2017","31","Otros","16","27","7","10","0","0","7","10","13.818181818182"
"8","2017","31","Otros","8","3","15","72","10","38","25","110","10"
"8","2017","31","Otros","16","27","13","23","0","0","13","23","13.818181818182"
"8","2017","31","Otros","16","20","53","134","0","0","53","134","3.0769230769231"
"8","2017","31","Otros","16","40","129","231","16","42","145","273","28.142857142857"
"8","2017","31","Hotel","11","36","27","59","0","0","27","59","2.375"
"8","2017","31","Otros","6","10","43","66","0","0","43","66","3.8518518518518"
"8","2017","31","Otros","7","38","282","369","2","8","284","377","2.75"
"8","2017","31","Otros","13","14","23","58","0","0","23","58","7.3846153846154"
"8","2017","31","Otros","9","30","48","60","1","1","49","61","2.3333333333333"
"8","2017","31","Otros","13","27","25","94","0","0","25","94","12.2"
"8","2017","31","Otros","10","27","3","3","2","2","5","5","4.84"
"8","2017","31","Otros","6","25","16","16","0","0","16","16","2.3846153846154"
"8","2017","31","Otros","9","26","113","113","0","0","113","113","3.8888888888889"
"8","2017","31","Otros","10","18","17","24","8","24","25","48","10.25"
"8","2017","31","Otros","2","29","26","95","0","0","26","95","3.28"
"8","2017","31","Otros","6","25","4","12","0","0","4","12","2.3846153846154"
"8","2017","31","Otros","5","9","1","1","0","0","1","1","4.0454545454545"
"8","2017","31","Otros","5","9","12","16","4","4","16","20","4.0454545454545"
"8","2017","31","Hotel","9","37","49","106","5","32","54","138","3.4"
"8","2017","31","Hotel","7","38","95","192","2","4","97","196","1"
"8","2017","31","Otros","7","27","49","59","0","0","49","59","4.8333333333333"
"8","2017","31","Otros","5","9","12","16","4","4","16","20","4.0454545454545"
"8","2017","31","Otros","10","27","3","3","0","0","3","3","4.84"
"8","2017","31","Otros","7","27","45","50","0","0","45","50","4.8333333333333"
"8","2017","31","Otros","16","40","31","46","10","22","41","68","28.142857142857"
"8","2017","31","Otros","10","23","74","74","1","1","75","75","7"
"8","2017","31","Otros","15","16","91","174","9","10","100","184","9"
"8","2017","31","Otros","3","7","5","10","94","223","99","233","2"
"8","2017","31","Otros","7","17","37","76","0","0","37","76","17.166666666667"
"8","2017","31","Otros","8","27","34","93","4","4","38","97","9.4"
"8","2017","31","Otros","9","22","60","101","0","0","60","101","7.6428571428571"
"8","2017","31","Otros","16","19","6","9","0","0","6","9","10.263157894737"
"8","2017","0","","15","27","0","0","0","0","0","0","1"
"8","2017","31","Hotel","10","11","23","23","7","7","30","30","5.6666666666667"
"8","2017","31","Otros","2","27","3","3","0","0","3","3","3.2"
"8","2017","31","Otros","8","2","53","64","22","30","75","94","6.4285714285714"
"8","2017","31","Otros","5","5","25","41","5","11","30","52","3.65625"
"8","2017","31","Otros","12","35","1","1","0","0","1","1","3.5"
"8","2017","31","Otros","8","3","0","0","4","4","4","4","10"
"8","2017","31","Otros","12","24","22","59","28","65","50","124","9.2"
"8","2017","31","Otros","11","32","21","114","0","0","21","114","2.2857142857143"
"8","2017","31","Otros","10","27","21","48","17","29","38","77","4.84"
"8","2017","31","Otros","11","15","3","5","0","0","3","5","2.3571428571429"
"8","2017","31","Otros","5","8","3","3","0","0","3","3","5"
"8","2017","31","Otros","14","27","9","9","1","1","10","10","11.833333333333"
"8","2017","31","Otros","13","27","155","198","0","0","155","198","12.2"
"8","2017","31","Hotel","10","18","41","41","113","113","154","154","3.2"
"8","2017","31","Otros","10","27","8","8","3","3","11","11","4.84"
"8","2017","31","Otros","11","32","13","20","0","0","13","20","1"
"8","2017","31","Otros","9","37","36","146","0","0","36","146","4.5"
"8","2017","31","Otros","12","35","23","29","44","86","67","115","3.5"
"8","2017","31","Otros","8","34","112","182","58","81","170","263","5.75"
"8","2017","31","Hotel","16","40","22","57","23","60","45","117","16.333333333333"
"8","2017","31","Hotel","10","11","16","36","7","18","23","54","5.6666666666667"
"8","2017","31","Otros","7","27","11","14","0","0","11","14","4.8333333333333"
"8","2017","31","Hotel","7","38","10","20","0","0","10","20","1"
"8","2017","31","Otros","6","27","2","3","0","0","2","3","3.960088691796"
"8","2017","31","Otros","6","10","71","146","2","2","73","148","3.8518518518518"
"8","2017","15","Otros","6","25","45","61","0","0","45","61","1"
"8","2017","31","Otros","6","25","6","6","0","0","6","6","2.3846153846154"
"8","2017","31","Otros","6","27","28","28","0","0","28","28","3.960088691796"
"8","2017","31","Otros","6","27","67","199","0","0","67","199","3.960088691796"
"8","2017","31","Otros","5","5","9","13","0","0","9","13","3.65625"
"8","2017","31","Otros","5","5","5","5","0","0","5","5","3.65625"
"8","2017","31","Otros","3","4","10","10","2","2","12","12","12.2"
"8","2017","31","Otros","10","23","4","4","0","0","4","4","7"
"8","2017","31","Otros","8","3","2","2","0","0","2","2","10"
"8","2017","31","Otros","5","5","11","26","13","24","24","50","3.65625"
"8","2017","31","Otros","5","8","8","10","0","0","8","10","5"
"8","2017","31","Otros","6","10","51","90","0","0","51","90","3.8518518518518"
"8","2017","31","Otros","16","19","6","12","0","0","6","12","10.263157894737"
"8","2017","31","Otros","11","15","28","59","4","10","32","69","2.3571428571429"
"8","2017","31","Otros","7","38","21","30","0","0","21","30","2.75"
"8","2017","31","Otros","11","32","102","207","10","15","112","222","2.2857142857143"
"8","2017","31","Otros","8","2","50","98","0","0","50","98","6.4285714285714"
"8","2017","31","Otros","10","27","20","28","5","10","25","38","4.84"
"8","2017","31","Otros","6","27","14","18","0","0","14","18","3.960088691796"
"8","2017","31","Otros","11","32","30","57","2","2","32","59","2.2857142857143"
"8","2017","31","Otros","8","34","17","19","21","21","38","40","5.75"
"8","2017","31","Otros","11","32","11","17","0","0","11","17","2.2857142857143"
"8","2017","31","Otros","10","11","9","19","0","0","9","19","11.764705882353"
"8","2017","31","Otros","11","32","10","26","0","0","10","26","2.2857142857143"
"8","2017","31","Otros","14","31","0","0","13","26","13","26","20.2"
"8","2017","31","Hotel","14","31","198","337","582","2382","780","2719","17.4"
"8","2017","31","Otros","11","36","38","91","0","0","38","91","5.1904761904762"
"8","2017","31","Hotel","15","16","1021","2287","208","469","1229","2756","2"
"8","2017","31","Otros","15","27","0","0","2","4","2","4","1.4222222222222"
"8","2017","31","Otros","5","5","5","12","0","0","5","12","3.65625"
"8","2017","31","Otros","8","34","6","9","6","6","12","15","5.75"
"8","2017","31","Otros","7","27","19","27","0","0","19","27","4.8333333333333"
"8","2017","31","Otros","12","35","12","21","5","8","17","29","3.5"
"8","2017","31","Otros","5","5","23","48","0","0","23","48","3.65625"
"8","2017","31","Otros","10","11","2","3","0","0","2","3","11.764705882353"
"8","2017","31","Otros","10","11","3","3","0","0","3","3","11.764705882353"
"8","2017","31","Otros","9","30","4","80","0","0","4","80","2.3333333333333"
"8","2017","31","Otros","8","2","51","173","5","8","56","181","6.4285714285714"
"8","2017","31","Otros","10","27","59","73","8","8","67","81","4.84"
"8","2017","31","Otros","5","9","12","16","4","4","16","20","4.0454545454545"
"8","2017","31","Otros","6","27","11","16","0","0","11","16","3.960088691796"
"8","2017","31","Otros","6","10","109","261","14","59","123","320","3.8518518518518"
"8","2017","31","Otros","6","10","90","151","6","10","96","161","3.8518518518518"
"8","2017","31","Otros","6","27","12","20","0","0","12","20","3.960088691796"
"8","2017","31","Otros","6","12","5","52","0","0","5","52","1.8256578947368"
"8","2017","31","Otros","6","10","84","190","0","0","84","190","3.8518518518518"
"8","2017","10","Otros","6","10","29","45","0","0","29","45","3.8518518518518"
"8","2017","31","Otros","6","27","5","5","0","0","5","5","3.960088691796"
"8","2017","31","Otros","6","12","23","25","0","0","23","25","1.8256578947368"
"8","2017","31","Otros","6","10","49","93","0","0","49","93","3.8518518518518"
"8","2017","31","Hotel","6","25","52","89","0","0","52","89","1"
"8","2017","1","Otros","6","27","1","1","0","0","1","1","3.960088691796"
"8","2017","31","Otros","5","9","22","36","7","7","29","43","4.0454545454545"
"8","2017","31","Otros","5","5","12","45","4","9","16","54","3.65625"
"8","2017","31","Otros","5","5","9","17","0","0","9","17","3.65625"
"8","2017","31","Otros","5","5","40","69","14","29","54","98","3.65625"
"8","2017","31","Otros","11","36","39","69","0","0","39","69","5.1904761904762"
"8","2017","31","Hotel","6","10","1277","3019","535","1022","1812","4041","1"
"8","2017","31","Otros","5","9","12","16","4","4","16","20","4.0454545454545"
"8","2017","31","Otros","5","8","10","100","0","0","10","100","5"
"8","2017","0","Hotel","15","27","0","0","0","0","0","0","1"
"8","2017","31","Hotel","14","31","1","2","144","2164","145","2166","1"
"8","2017","31","Hotel","3","4","332","2229","8","40","340","2269","3"
"8","2017","31","Otros","3","7","19","19","31","31","50","50","1"
"8","2017","31","Otros","7","38","73","118","0","0","73","118","2.75"
"8","2017","31","Hotel","10","27","12","16","0","0","12","16","1"
"8","2017","31","Hotel","12","35","1","1","7","7","8","8","1.7272727272727"
"8","2017","31","Hotel","10","27","6","6","0","0","6","6","2.25"
"8","2017","31","Hotel","7","17","752","1215","56","117","808","1332","4"
"8","2017","31","Hotel","16","19","13","20","3","4","16","24","4"
"8","2017","15","Hotel","2","6","226","226","0","0","226","226","2.2"
"8","2017","31","Otros","5","5","80","206","0","0","80","206","3.65625"
"8","2017","31","Otros","12","24","81","145","63","65","144","210","9.2"
"8","2017","31","Otros","5","8","8","12","13","19","21","31","5"
"8","2017","31","Otros","4","13","90","115","12","12","102","127","1"
"8","2017","31","Otros","10","11","100","100","0","0","100","100","11.764705882353"
"8","2017","31","Otros","12","35","4","8","2","4","6","12","3.5"
"8","2017","31","Otros","10","23","88","90","4","4","92","94","7"
"8","2017","31","Otros","11","36","508","974","61","128","569","1102","5.1904761904762"
"8","2017","31","Otros","12","35","12","21","5","8","17","29","3.5"
"8","2017","31","Otros","11","36","58","100","0","0","58","100","5.1904761904762"
"8","2017","31","Otros","8","2","70","83","30","35","100","118","6.4285714285714"
"8","2017","31","Otros","9","30","6","18","0","0","6","18","2.3333333333333"
"8","2017","31","Otros","11","36","32","168","8","12","40","180","5.1904761904762"
"8","2017","31","Otros","6","10","26","26","0","0","26","26","3.8518518518518"
"8","2017","31","Otros","10","18","21","29","7","15","28","44","10.25"
"8","2017","31","Otros","7","27","13","76","3","3","16","79","4.8333333333333"
"8","2017","31","Otros","16","20","5","25","0","0","5","25","1"
"8","2017","31","Otros","9","22","16","32","0","0","16","32","7.6428571428571"
"8","2017","31","Otros","5","5","208","255","12","19","220","274","3.65625"
"8","2017","31","Otros","12","35","12","21","5","8","17","29","3.5"
"8","2017","31","Otros","10","11","1","1","0","0","1","1","11.764705882353"
"8","2017","31","Otros","10","11","2","2","0","0","2","2","11.764705882353"
"8","2017","26","Otros","5","9","41","88","2","2","43","90","4.0454545454545"
"8","2017","31","Otros","5","5","10","19","3","8","13","27","3.65625"
"8","2017","31","Otros","12","35","29","55","43","113","72","168","3.5"
"8","2017","29","Otros","7","38","103","199","31","63","134","262","2.75"
"8","2017","31","Hotel","12","35","1","1","0","0","1","1","1.7272727272727"
"8","2017","31","Otros","13","14","14","16","0","0","14","16","1"
"8","2017","31","Otros","5","5","7","13","0","0","7","13","3.65625"
"8","2017","31","Hotel","14","31","26","390","438","6562","464","6952","1"
"8","2017","31","Hotel","14","31","11","165","357","5359","368","5524","1"
"8","2017","31","Hotel","9","26","5","11","0","0","5","11","1.5"
"8","2017","31","Hotel","16","19","22","36","0","0","22","36","1"
"8","2017","31","Otros","16","19","49","107","3","34","52","141","10.263157894737"
"8","2017","31","Otros","9","30","29","33","1","1","30","34","2.3333333333333"
"8","2017","31","Otros","16","19","41","68","0","0","41","68","10.263157894737"
"8","2017","31","Otros","16","19","49","163","0","0","49","163","10.263157894737"
"8","2017","31","Otros","9","26","3","4","0","0","3","4","3.8888888888889"
"8","2017","31","Otros","16","40","2","2","0","0","2","2","28.142857142857"
"8","2017","31","Hotel","16","27","7","12","0","0","7","12","5.8571428571429"
"8","2017","31","Otros","16","19","10","10","0","0","10","10","10.263157894737"
"8","2017","31","Otros","16","19","10","16","0","0","10","16","10.263157894737"
"8","2017","31","","9","30","59","89","2","6","61","95","1"
"8","2017","31","Otros","16","19","6","10","0","0","6","10","10.263157894737"
"8","2017","31","Otros","10","11","1","1","0","0","1","1","11.764705882353"
"8","2017","31","Otros","11","36","17","17","0","0","17","17","5.1904761904762"
"8","2017","31","Otros","16","19","10","16","0","0","10","16","10.263157894737"
"8","2017","31","Otros","16","19","95","136","0","0","95","136","1.3333333333333"
"8","2017","31","Otros","16","19","10","24","0","0","10","24","10.263157894737"
"8","2017","31","Otros","10","18","13","33","9","19","22","52","10.25"
"8","2017","31","Otros","16","19","17","33","0","0","17","33","10.263157894737"
"8","2017","31","Otros","16","19","1","1","0","0","1","1","1.3333333333333"
"8","2017","31","","9","26","208","896","0","0","208","896","1"
"8","2017","31","Otros","16","19","4","8","0","0","4","8","10.263157894737"
"8","2017","31","Otros","16","19","43","52","0","0","43","52","10.263157894737"
"8","2017","31","Hotel","8","2","409","1356","336","1548","745","2904","1"
"8","2017","31","Otros","6","10","26","60","0","0","26","60","3.8518518518518"
"8","2017","31","Otros","6","12","26","28","0","0","26","28","1.8256578947368"
"8","2017","31","Hotel","16","19","51","160","19","91","70","251","1"
"8","2017","31","Otros","3","7","20","20","58","58","78","78","2"
"8","2017","31","Hotel","2","6","1101","3034","294","897","1395","3931","1"
"8","2017","31","Hotel","3","4","710","899","84","156","794","1055","2.6"
"8","2017","31","Hotel","16","40","1857","2821","741","1140","2598","3961","1"
"8","2017","31","Otros","16","27","76","98","0","0","76","98","13.818181818182"
"8","2017","31","Hotel","6","28","146","236","14","21","160","257","2.4"
"8","2017","31","Hotel","8","34","432","557","146","257","578","814","1"
"8","2017","31","Otros","9","30","11","11","0","0","11","11","2.3333333333333"
"8","2017","31","Hotel","10","18","68","68","141","141","209","209","1"
"8","2017","31","Hotel","9","30","118","252","0","0","118","252","1"
"8","2017","31","Hotel","15","27","6","6","0","0","6","6","1"
"8","2017","31","Hotel","9","22","109","430","0","0","109","430","2.5555555555556"
"8","2017","31","Hotel","6","10","213","488","54","292","267","780","1"
"8","2017","31","","11","15","9","10","0","0","9","10","1"
"8","2017","31","Otros","6","12","22","31","0","0","22","31","1.8256578947368"
"8","2017","31","Hotel","15","27","30","930","0","0","30","930","1"
"8","2017","31","Otros","15","27","134","250","0","0","134","250","1.4222222222222"
"8","2017","31","Otros","15","27","14","33","0","0","14","33","1.4222222222222"
"8","2017","31","Otros","2","1","22","22","11","11","33","33","1"
"8","2017","31","Otros","12","24","10","19","1","1","11","20","9.2"
"8","2017","31","Otros","5","5","0","0","2","6","2","6","3.65625"
"8","2017","31","Hotel","7","27","159","189","17","17","176","206","1"
"8","2017","31","Otros","16","20","5","10","0","0","5","10","3.0769230769231"
"8","2017","0","","10","11","0","0","0","0","0","0","1"
"8","2017","31","Hotel","16","40","29","29","4","4","33","33","16.333333333333"
"8","2017","31","Otros","12","35","15","23","5","9","20","32","3.5"
"8","2017","31","Hotel","6","27","2","2","0","0","2","2","3"
"8","2017","31","Otros","5","5","11","28","2","2","13","30","3.65625"
"8","2017","31","Hotel","6","27","26","28","0","0","26","28","3"
"8","2017","31","Otros","6","25","21","21","0","0","21","21","2.3846153846154"
"8","2017","0","Hotel","15","27","0","0","0","0","0","0","1"
"8","2017","31","Otros","5","9","16","24","18","30","34","54","4.0454545454545"
"8","2017","31","Hotel","15","27","100","190","0","0","100","190","1"
"8","2017","31","Hotel","5","9","2","62","0","0","2","62","1"
"8","2017","31","Hotel","8","34","62","129","36","106","98","235","2.5714285714286"
"8","2017","31","Hotel","15","27","0","0","0","0","0","0","1"
"8","2017","31","Hotel","6","27","145","425","0","0","145","425","3"
"8","2017","0","Otros","6","27","0","0","0","0","0","0","1"
"8","2017","31","Otros","12","27","9","9","76","76","85","85","3.4285714285714"
"8","2017","31","Hotel","2","27","279","694","143","312","422","1006","1"
"8","2017","31","Hotel","2","6","41","82","0","0","41","82","1"
"8","2017","31","Otros","2","6","31","31","0","0","31","31","1"
"8","2017","31","Hotel","4","39","128","128","0","0","128","128","1"
"8","2017","31","Hotel","6","10","334","452","22","28","356","480","1"
"8","2017","31","Otros","5","8","1","2","0","0","1","2","5"
"8","2017","0","Hotel","13","33","0","0","0","0","0","0","1"
"8","2017","31","Hotel","13","33","127","254","41","82","168","336","1"
"8","2017","31","Otros","11","32","182","428","16","31","198","459","2.2857142857143"
"8","2017","31","Hotel","9","26","196","279","401","477","597","756","1"
"8","2017","31","Hotel","16","20","125","158","0","0","125","158","1"
"8","2017","31","Otros","16","20","41","82","1","1","42","83","3.0769230769231"
"8","2017","31","","16","40","495","892","6","12","501","904","1"
"8","2017","31","Hotel","15","16","1727","3334","322","733","2049","4067","1"
"8","2017","31","Hotel","16","27","0","0","0","0","0","0","1"
"8","2017","31","Hotel","5","9","19","38","5","5","24","43","1"
"8","2017","31","Otros","7","38","42","78","0","0","42","78","2.75"
"8","2017","31","Otros","2","6","1765","1765","0","0","1765","1765","1"
"8","2017","31","Otros","2","6","392","392","0","0","392","392","1"
"8","2017","31","Hotel","15","27","217","855","12","13","229","868","1"
"8","2017","31","Otros","7","38","80","104","4","8","84","112","2.75"
"8","2017","31","Otros","2","1","14","129","21","44","35","173","1"
"8","2017","31","Otros","8","3","43","115","3","6","46","121","10"
"8","2017","31","Otros","11","36","22","60","0","0","22","60","5.1904761904762"
"8","2017","31","Otros","16","20","54","130","0","0","54","130","3.0769230769231"
"8","2017","31","Otros","8","3","360","590","0","0","360","590","1"
"8","2017","31","Otros","4","39","339","510","9","43","348","553","2.2222222222222"
"8","2017","31","Otros","5","5","101","282","23","64","124","346","3.65625"
"8","2017","31","Otros","12","27","3","4","11","15","14","19","3.4285714285714"
"8","2017","31","Otros","7","27","25","129","0","0","25","129","1"
"8","2017","31","Hotel","2","6","91","93","17","33","108","126","1"
"8","2017","31","Hotel","14","27","353","1572","39","115","392","1687","1"
"8","2017","31","Hotel","16","19","867","1461","0","0","867","1461","1"
"8","2017","31","","2","1","37","518","0","0","37","518","1"
"8","2017","31","Hotel","2","27","110","339","2","6","112","345","1"
"8","2017","31","Otros","16","20","84","93","0","0","84","93","1"
"8","2017","0","Otros","13","14","0","0","0","0","0","0","1"
"8","2017","31","Hotel","11","36","82","112","3","3","85","115","2.375"
"8","2017","31","Otros","13","14","6","186","0","0","6","186","7.3846153846154"
"8","2017","31","Otros","12","27","5","5","0","0","5","5","3.4285714285714"
"8","2017","31","Hotel","2","6","151","209","0","0","151","209","2.2"
"8","2017","31","Otros","2","6","171","699","0","0","171","699","1"
"8","2017","31","Otros","10","27","2","34","0","0","2","34","4.84"
"8","2017","31","Otros","12","27","9","17","15","15","24","32","3.4285714285714"
"8","2017","31","Otros","13","14","42","65","0","0","42","65","7.3846153846154"
"8","2017","31","Otros","6","12","147","223","24","28","171","251","1.8256578947368"
"8","2017","31","Otros","2","6","299","410","53","118","352","528","1"
"8","2017","31","Hotel","12","35","55","90","36","58","91","148","1.7272727272727"
"8","2017","31","Otros","5","5","6","6","8","49","14","55","3.65625"
"8","2017","31","Otros","9","30","11","220","0","0","11","220","2.3333333333333"
"8","2017","31","Hotel","8","2","5","19","1","1","6","20","1"
"8","2017","31","Otros","9","30","3","24","0","0","3","24","2.3333333333333"
"8","2017","31","Hotel","15","27","16","16","0","0","16","16","1"
"8","2017","31","Hotel","3","7","22","22","2","2","24","24","1"
"8","2017","31","Otros","6","12","485","782","0","0","485","782","1.8256578947368"
"8","2017","31","Otros","12","27","16","38","9","15","25","53","3.4285714285714"
"8","2017","31","Otros","2","6","4","10","0","0","4","10","5"
"8","2017","31","Otros","6","27","46","226","0","0","46","226","3.960088691796"
"8","2017","31","Hotel","10","11","35","43","0","0","35","43","1"
"8","2017","31","Otros","2","1","20","44","7","14","27","58","1"
"8","2017","31","Otros","11","36","33","41","0","0","33","41","5.1904761904762"
"8","2017","31","Hotel","11","32","0","0","0","0","0","0","1"
"8","2017","31","Otros","2","27","5","13","0","0","5","13","1"
"8","2017","31","Otros","12","27","6","12","0","0","6","12","3.4285714285714"
"8","2017","31","Hotel","8","2","28","128","8","16","36","144","3"
"8","2017","31","Hotel","16","20","50","65","0","0","50","65","1"
"8","2017","31","Otros","12","35","34","62","22","58","56","120","3.5"
"8","2017","31","Otros","13","14","14","19","0","0","14","19","1"
"8","2017","1","Otros","2","27","8","8","0","0","8","8","3.2"
"8","2017","31","Hotel","6","27","20","20","0","0","20","20","3"
"8","2017","31","Hotel","8","3","40","65","6","10","46","75","4.1111111111111"
"8","2017","31","Hotel","15","27","8","248","0","0","8","248","1"
"8","2017","31","Otros","8","3","41","108","3","6","44","114","10"
"8","2017","0","Hotel","16","20","0","0","0","0","0","0","1"
"8","2017","31","Hotel","6","28","89","109","6","15","95","124","2.4"
"8","2017","31","Otros","2","1","30","92","2","6","32","98","5.5"
"8","2017","29","Hotel","11","36","42","91","49","76","91","167","2.375"
"8","2017","31","Otros","4","13","52","60","0","0","52","60","1"
"8","2017","31","Otros","2","6","211","1477","0","0","211","1477","1"
"8","2017","31","Otros","8","34","57","77","37","51","94","128","5.75"
"8","2017","29","Hotel","11","15","4","10","0","0","4","10","1"
"8","2017","31","Otros","15","27","6","6","0","0","6","6","1.4222222222222"
"8","2017","31","Hotel","13","14","53","82","0","0","53","82","1"
"8","2017","31","Hotel","13","14","173","224","5","5","178","229","1"
"8","2017","31","Hotel","9","30","31","55","0","0","31","55","1"
"8","2017","31","Hotel","4","13","259","732","34","100","293","832","5.4"
"8","2017","31","Otros","6","27","20","32","0","0","20","32","3.960088691796"
"8","2017","0","Hotel","15","27","0","0","0","0","0","0","1"
"8","2017","31","Hotel","2","29","10","37","74","248","84","285","2"
"8","2017","31","Hotel","13","33","40","69","0","0","40","69","2"
"8","2017","31","Hotel","12","35","55","90","36","58","91","148","1.7272727272727"
"8","2017","31","Hotel","13","14","221","263","7","16","228","279","1"
"8","2017","31","Otros","6","25","34","68","0","0","34","68","2.3846153846154"
"8","2017","31","Hotel","8","2","6","13","0","0","6","13","3"
"8","2017","31","Otros","4","39","286","564","0","0","286","564","2.2222222222222"
"8","2017","31","Otros","6","12","114","144","15","51","129","195","1.8256578947368"
"8","2017","31","Otros","13","33","55","83","52","80","107","163","5.125"
"8","2017","31","Hotel","4","13","37","74","0","0","37","74","5.4"
"8","2017","31","Hotel","7","27","29","214","0","0","29","214","4.1666666666667"
"8","2017","31","Hotel","4","13","981","2543","124","169","1105","2712","1"
"8","2017","0","","5","8","0","0","0","0","0","0","1"
"8","2017","31","Otros","8","2","129","228","22","36","151","264","6.4285714285714"
"8","2017","31","Otros","2","6","14","14","24","24","38","38","1"
"8","2017","31","","6","10","48","114","0","0","48","114","1"
"8","2017","31","Hotel","2","29","50","66","54","78","104","144","2"
"8","2017","31","","14","31","74","170","425","1858","499","2028","1"
"8","2017","31","Hotel","16","27","4293","10181","0","0","4293","10181","1"
"8","2017","31","Hotel","12","35","23","33","12","19","35","52","1.7272727272727"
"8","2017","31","","12","35","15","24","51","92","66","116","1"
"8","2017","31","","9","26","138","147","10","10","148","157","1"
"8","2017","31","Otros","11","32","98","162","0","0","98","162","2.2857142857143"
"8","2017","31","Otros","12","24","8","13","31","61","39","74","9.2"
"8","2017","31","Hotel","6","25","41","63","0","0","41","63","1"
"8","2017","31","Otros","11","32","2","2","0","0","2","2","2.2857142857143"
"8","2017","31","Hotel","16","19","106","182","3","3","109","185","4"
"8","2017","31","Otros","13","33","45","51","0","0","45","51","5.125"
"8","2017","31","Otros","16","27","30","60","1","7","31","67","13.818181818182"
"8","2017","31","Otros","6","12","104","130","1","1","105","131","1.8256578947368"
"8","2017","31","Otros","2","29","2","6","0","0","2","6","3.28"
"8","2017","31","Hotel","14","27","290","331","180","218","470","549","1"
"8","2017","31","Otros","2","1","115","1610","0","0","115","1610","1"
"8","2017","31","Otros","11","32","19","21","0","0","19","21","2.2857142857143"
"8","2017","31","Otros","2","27","54","54","0","0","54","54","1"
"8","2017","31","Hotel","2","29","150","326","19","68","169","394","1"
"8","2017","31","Hotel","4","13","24","206","0","0","24","206","3.2"
"8","2017","31","Hotel","4","21","29","41","4","4","33","45","3"
"8","2017","31","Otros","7","27","145","194","7","33","152","227","4.8333333333333"
"8","2017","31","","3","4","91","161","76","131","167","292","1"
"8","2017","31","Hotel","6","27","19","46","3","7","22","53","3"
"8","2017","31","Otros","16","19","2","2","0","0","2","2","10.263157894737"
"8","2017","31","Otros","11","32","6","6","0","0","6","6","2.2857142857143"
"8","2017","31","Otros","3","7","26","38","87","162","113","200","2"
"8","2017","31","Otros","5","5","6","19","0","0","6","19","3.65625"
"8","2017","24","Otros","15","27","1227","1986","0","0","1227","1986","1.4222222222222"
"8","2017","31","Otros","6","25","8","8","0","0","8","8","2.3846153846154"
"8","2017","31","","10","27","4","4","0","0","4","4","1"
"8","2017","31","Otros","2","29","34","96","84","234","118","330","3.28"
"8","2017","31","Otros","12","35","12","21","5","8","17","29","3.5"
"8","2017","31","Otros","16","19","14","31","0","0","14","31","10.263157894737"
"8","2017","31","Otros","9","26","75","75","1","1","76","76","3.8888888888889"
"8","2017","31","Hotel","13","33","86","86","1","4","87","90","2"
"8","2017","31","Otros","11","32","2","2","0","0","2","2","2.2857142857143"
"8","2017","31","Otros","9","22","54","97","0","0","54","97","7.6428571428571"
"8","2017","31","Otros","6","27","3","93","0","0","3","93","3.960088691796"
"8","2017","31","Otros","15","27","148","282","0","0","148","282","1.4222222222222"
"8","2017","31","Otros","11","32","60","65","2","2","62","67","2.2857142857143"
"8","2017","31","Otros","11","15","37","37","0","0","37","37","2.3571428571429"
"8","2017","31","Otros","9","37","1","15","0","0","1","15","4.5"
"8","2017","31","Otros","5","9","8","12","3","9","11","21","4.0454545454545"
"8","2017","31","Hotel","10","27","19","50","0","0","19","50","2.25"
"8","2017","31","Otros","6","28","35","36","1","1","36","37","4.65"
"8","2017","31","Otros","4","13","65","107","11","12","76","119","3.4"
"8","2017","31","Otros","2","1","1","1","0","0","1","1","1"
"8","2017","31","Otros","2","29","28","62","55","120","83","182","3.28"
"8","2017","31","Hotel","8","3","15","30","0","0","15","30","4.1111111111111"
"8","2017","31","Otros","16","19","17","50","0","0","17","50","1.3333333333333"
"8","2017","31","Otros","12","35","7","14","3","4","10","18","3.5"
"8","2017","31","Hotel","12","35","14","28","7","14","21","42","1.7272727272727"
"8","2017","31","Otros","12","35","15","23","5","9","20","32","3.5"
"8","2017","31","Otros","2","29","25","29","40","66","65","95","3.28"
"8","2017","31","Hotel","7","27","101","137","6","6","107","143","1"
"8","2017","31","Hotel","9","22","25","25","1","1","26","26","2.5555555555556"
"8","2017","31","Hotel","12","35","30","30","43","103","73","133","1.7272727272727"
"8","2017","31","Otros","15","16","89","152","24","59","113","211","2"
"8","2017","31","Hotel","15","27","25","50","0","0","25","50","1"
"8","2017","31","Otros","4","13","54","57","5","5","59","62","3.4"
"8","2017","31","Hotel","8","34","109","221","42","72","151","293","2.5714285714286"
"8","2017","31","Hotel","16","20","120","240","0","0","120","240","1"
"8","2017","31","Hotel","6","28","118","203","78","111","196","314","2.4"
"8","2017","31","Hotel","15","27","144","392","5","7","149","399","1"
"8","2017","31","Otros","12","35","45","99","23","44","68","143","3.5"
"8","2017","31","Otros","11","15","44","98","0","0","44","98","2.3571428571429"
"8","2017","31","Otros","11","15","13","55","0","0","13","55","2.3571428571429"
"8","2017","31","Otros","11","36","109","213","49","64","158","277","5.1904761904762"
"8","2017","31","Hotel","11","36","19","34","0","0","19","34","2.375"
"8","2017","31","Hotel","6","12","109","151","0","0","109","151","5"
"8","2017","31","Otros","8","3","33","35","17","17","50","52","10"
"8","2017","31","Otros","10","27","46","68","24","31","70","99","4.84"
"8","2017","31","Otros","8","3","8","16","0","0","8","16","10"
"8","2017","31","Otros","6","25","18","18","0","0","18","18","2.3846153846154"
"8","2017","31","Hotel","2","27","87","161","11","18","98","179","1"
"8","2017","31","Hotel","10","18","0","0","98","259","98","259","3.2"
"8","2017","31","Otros","11","32","33","52","2","6","35","58","1"
"8","2017","31","Hotel","6","10","1085","1461","255","378","1340","1839","1"
"8","2017","31","Otros","11","32","41","71","0","0","41","71","2.2857142857143"
"8","2017","0","Otros","2","27","0","0","0","0","0","0","1"
"8","2017","31","","12","24","22","109","67","331","89","440","1"
"8","2017","31","Hotel","16","27","476","589","4","8","480","597","5.8571428571429"
"8","2017","31","Hotel","7","38","22","24","0","0","22","24","1"
"8","2017","31","Hotel","6","12","2577","2795","33","33","2610","2828","1"
"9","2017","30","Hotel","14","31","1697","2372","7290","9173","8987","11545","1"
"9","2017","30","Hotel","14","31","541","852","2880","8315","3421","9167","1"
"9","2017","30","Hotel","14","31","438","567","799","3061","1237","3628","1"
"9","2017","30","Hotel","11","32","68","102","0","0","68","102","1"
"9","2017","30","Hotel","14","27","3442","4356","705","893","4147","5249","1"
"9","2017","30","Otros","11","32","126","220","0","0","126","220","2.2857142857143"
"9","2017","30","Hotel","14","31","311","420","2984","3663","3295","4083","5.4"
"9","2017","30","Hotel","15","16","821","2784","36","79","857","2863","1"
"9","2017","30","Hotel","14","31","906","1431","1354","5036","2260","6467","5.4"
"9","2017","30","Hotel","12","24","2046","2854","1187","2319","3233","5173","1"
"9","2017","30","Hotel","16","40","644","2137","178","844","822","2981","1"
"9","2017","30","Hotel","6","12","1134","1572","38","85","1172","1657","1"
"9","2017","30","Hotel","10","23","1256","1735","85","156","1341","1891","1"
"9","2017","30","Hotel","14","31","1380","3433","282","705","1662","4138","5.4"
"9","2017","30","Hotel","3","4","706","1527","269","2113","975","3640","1"
"9","2017","30","","11","32","550","912","37","84","587","996","1"
"9","2017","30","Hotel","6","12","752","1698","44","117","796","1815","1"
"9","2017","30","Hotel","6","12","2068","2864","128","343","2196","3207","1"
"9","2017","30","Hotel","9","26","3472","6827","32","64","3504","6891","1"
"9","2017","30","Hotel","2","1","695","2077","21","148","716","2225","1"
"9","2017","30","Hotel","9","26","1327","2040","154","339","1481","2379","1"
"9","2017","30","Hotel","6","12","635","1053","31","57","666","1110","1"
"9","2017","30","Hotel","14","31","62","91","4021","7876","4083","7967","5.4"
"9","2017","30","Hotel","11","32","294","566","17","35","311","601","1"
"9","2017","30","Hotel","2","6","1365","2028","102","165","1467","2193","1"
"9","2017","30","Hotel","16","40","1537","2832","688","1030","2225","3862","1"
"9","2017","30","Hotel","14","27","1262","2349","471","1076","1733","3425","1"
"9","2017","30","Otros","11","36","76","108","0","0","76","108","1"
"9","2017","30","Hotel","10","23","887","1623","524","915","1411","2538","1"
"9","2017","30","Hotel","14","31","301","878","520","2867","821","3745","7.8"
"9","2017","30","Hotel","7","17","671","1100","196","427","867","1527","1"
"9","2017","30","Hotel","2","1","2093","2712","328","375","2421","3087","2"
"9","2017","30","Hotel","2","1","1398","2040","254","624","1652","2664","2"
"9","2017","30","Hotel","4","13","964","1704","325","599","1289","2303","1"
"9","2017","30","Hotel","2","1","875","1778","82","104","957","1882","2"
"9","2017","30","Hotel","10","27","1354","3247","691","1337","2045","4584","1"
"9","2017","30","Hotel","14","27","794","1289","1001","1701","1795","2990","1"
"9","2017","30","Hotel","14","27","2071","2708","1113","2359","3184","5067","1"
"9","2017","30","Hotel","6","12","1848","2022","47","75","1895","2097","1"
"9","2017","30","Hotel","6","12","1444","1954","326","392","1770","2346","1"
"9","2017","30","Hotel","13","27","2272","4964","5","8","2277","4972","1"
"9","2017","30","Hotel","14","31","363","567","1861","2957","2224","3524","7.8"
"9","2017","30","Hotel","6","12","1226","2159","251","442","1477","2601","1"
"9","2017","30","Hotel","16","27","2445","4475","85","155","2530","4630","1"
"9","2017","30","","10","27","19","21","0","0","19","21","1"
"9","2017","30","Hotel","10","18","928","1873","602","1327","1530","3200","1"
"9","2017","30","Hotel","9","37","1613","3177","225","516","1838","3693","1"
"9","2017","30","Hotel","16","27","1299","3897","0","0","1299","3897","1"
"9","2017","30","Hotel","15","16","810","1459","57","113","867","1572","2"
"9","2017","30","Hotel","2","1","1446","1960","245","401","1691","2361","2"
"9","2017","30","Hotel","3","4","635","1348","138","280","773","1628","1"
"9","2017","30","Hotel","16","40","1613","2443","852","1311","2465","3754","1"
"9","2017","30","Hotel","7","17","3461","3960","571","637","4032","4597","1"
"9","2017","30","Hotel","12","24","1216","1932","752","1260","1968","3192","1"
"9","2017","30","Hotel","12","35","902","1871","602","1541","1504","3412","1"
"9","2017","30","Hotel","2","6","265","611","30","36","295","647","1"
"9","2017","30","Hotel","13","33","1047","1047","141","141","1188","1188","1"
"9","2017","30","Hotel","10","27","1352","1665","868","1104","2220","2769","1"
"9","2017","30","Hotel","10","23","951","1556","490","802","1441","2358","1"
"9","2017","30","Hotel","11","36","1024","1571","229","619","1253","2190","1"
"9","2017","30","Hotel","8","34","1358","2163","44","92","1402","2255","1"
"9","2017","30","Hotel","2","6","1032","1514","65","87","1097","1601","1"
"9","2017","30","Hotel","14","31","430","669","1477","2060","1907","2729","7.8"
"9","2017","30","Hotel","11","36","2043","3068","157","266","2200","3334","1"
"9","2017","30","","10","27","755","3322","150","933","905","4255","1"
"9","2017","30","Hotel","14","31","1901","3437","2122","5543","4023","8980","5.4"
"9","2017","30","Hotel","4","13","2940","2954","3","6","2943","2960","1"
"9","2017","30","Hotel","6","28","1016","1292","61","82","1077","1374","1"
"9","2017","30","Otros","14","31","62","138","423","600","485","738","2.8"
"9","2017","30","Otros","16","27","85","85","0","0","85","85","2"
"9","2017","30","Hotel","2","1","746","1289","53","76","799","1365","2"
"9","2017","30","Hotel","10","18","951","1556","460","802","1411","2358","1"
"9","2017","30","Hotel","7","17","1133","1431","108","305","1241","1736","1"
"9","2017","30","Hotel","12","24","563","1553","444","1313","1007","2866","1"
"9","2017","30","Hotel","10","18","1541","2448","338","665","1879","3113","1"
"9","2017","30","Hotel","2","1","1866","2039","35","62","1901","2101","1"
"9","2017","30","Hotel","10","18","866","1150","260","613","1126","1763","1"
"9","2017","30","Hotel","6","28","1503","2050","189","240","1692","2290","1"
"9","2017","30","Hotel","5","5","1152","1485","176","204","1328","1689","1"
"9","2017","30","Hotel","4","13","489","938","45","116","534","1054","1"
"9","2017","30","Hotel","10","18","586","998","288","491","874","1489","1"
"9","2017","30","Hotel","16","40","751","1183","33","39","784","1222","1"
"9","2017","30","Hotel","8","3","2106","4880","516","1085","2622","5965","1"
"9","2017","30","Hotel","15","16","764","1218","218","270","982","1488","2"
"9","2017","30","Hotel","14","31","97","169","415","1969","512","2138","7.8"
"9","2017","30","Hotel","13","33","739","872","372","444","1111","1316","1"
"9","2017","30","Hotel","15","16","1198","1906","214","403","1412","2309","2"
"9","2017","30","Otros","4","21","667","1373","0","0","667","1373","1"
"9","2017","30","Hotel","6","10","1075","2032","50","204","1125","2236","1"
"9","2017","30","Hotel","16","19","266","379","20","41","286","420","1"
"9","2017","30","Hotel","16","27","783","1965","3","6","786","1971","1"
"9","2017","30","Hotel","10","11","1407","2576","99","176","1506","2752","1"
"9","2017","30","Otros","10","23","396","928","7","17","403","945","1"
"9","2017","30","Hotel","12","35","129","233","134","206","263","439","1"
"9","2017","30","Hotel","11","36","571","1016","174","340","745","1356","1"
"9","2017","30","Hotel","14","31","52","157","241","1343","293","1500","17.4"
"9","2017","30","Hotel","10","18","501","1294","639","1451","1140","2745","3.2"
"9","2017","30","Hotel","4","13","731","1415","23","59","754","1474","1"
"9","2017","30","Hotel","6","12","318","464","52","76","370","540","5"
"9","2017","30","Hotel","6","10","846","1283","149","226","995","1509","1"
"9","2017","30","Otros","5","5","170","263","94","145","264","408","3.65625"
"9","2017","30","Hotel","12","24","864","1177","726","1421","1590","2598","1"
"9","2017","30","Hotel","8","3","1019","2166","162","328","1181","2494","1"
"9","2017","30","Hotel","13","27","540","939","0","0","540","939","2.75"
"9","2017","30","Hotel","15","16","275","850","28","120","303","970","4"
"9","2017","30","Otros","15","16","78","269","64","348","142","617","2"
"9","2017","30","Otros","16","20","272","575","0","0","272","575","1"
"9","2017","30","Hotel","3","4","338","666","212","232","550","898","1"
"9","2017","30","Hotel","11","36","106","120","0","0","106","120","1"
"9","2017","30","Hotel","2","6","222","1181","44","246","266","1427","1"
"9","2017","30","Hotel","8","34","736","1223","151","250","887","1473","1"
"9","2017","30","Hotel","4","13","18","26","0","0","18","26","3.2"
"9","2017","30","Hotel","13","27","530","1043","0","0","530","1043","2.75"
"9","2017","30","Hotel","2","29","311","616","467","981","778","1597","1"
"9","2017","30","Otros","11","36","159","303","2","2","161","305","1"
"9","2017","30","","10","11","2","2","0","0","2","2","1"
"9","2017","30","Hotel","4","13","1014","1541","52","295","1066","1836","1"
"9","2017","30","Hotel","16","40","2320","3485","521","783","2841","4268","5.6666666666667"
"9","2017","30","Hotel","10","23","863","1314","581","1216","1444","2530","2.8"
"9","2017","30","Hotel","8","34","344","623","338","672","682","1295","1"
"9","2017","30","Hotel","5","5","400","797","58","300","458","1097","1"
"9","2017","30","Hotel","3","4","120","254","47","85","167","339","3"
"9","2017","30","Hotel","9","26","115","248","1","1","116","249","1"
"9","2017","30","Hotel","8","34","411","572","243","404","654","976","1"
"9","2017","30","Hotel","7","17","306","529","73","149","379","678","4"
"9","2017","30","Hotel","4","13","197","407","105","126","302","533","3.2"
"9","2017","30","Hotel","12","35","25","130","160","574","185","704","1"
"9","2017","30","Hotel","16","40","1200","2183","711","1317","1911","3500","1"
"9","2017","30","Hotel","9","26","280","467","51","175","331","642","1"
"9","2017","30","","6","27","179","374","4","12","183","386","1"
"9","2017","30","Hotel","9","26","137","207","0","0","137","207","1"
"9","2017","30","Hotel","4","13","183","365","23","35","206","400","3.2"
"9","2017","30","Hotel","6","28","486","570","13","16","499","586","1"
"9","2017","30","","2","29","99","267","532","1665","631","1932","1"
"9","2017","30","Hotel","14","31","18","31","50","133","68","164","1"
"9","2017","30","Hotel","13","33","1248","1591","90","166","1338","1757","1"
"9","2017","30","Hotel","8","3","584","1180","59","126","643","1306","1"
"9","2017","30","Hotel","14","27","344","352","835","1311","1179","1663","1"
"9","2017","30","Hotel","16","40","352","607","0","0","352","607","5.6666666666667"
"9","2017","30","Hotel","12","24","447","515","536","729","983","1244","1"
"9","2017","30","Hotel","10","18","814","1605","169","410","983","2015","3.2"
"9","2017","30","Otros","15","16","165","171","5","5","170","176","9"
"9","2017","30","Hotel","6","10","484","559","0","0","484","559","1"
"9","2017","30","Hotel","10","11","631","1094","47","152","678","1246","1"
"9","2017","30","Otros","6","10","54","161","0","0","54","161","3.8518518518518"
"9","2017","30","Otros","10","23","276","381","5","10","281","391","1"
"9","2017","30","Hotel","10","23","468","744","336","692","804","1436","2.8"
"9","2017","30","Hotel","6","12","339","444","26","39","365","483","5"
"9","2017","30","Hotel","6","27","173","399","0","0","173","399","3"
"9","2017","30","Hotel","10","23","487","810","337","665","824","1475","2.8"
"9","2017","30","","4","39","89","173","0","0","89","173","1"
"9","2017","30","Hotel","8","34","368","551","341","509","709","1060","1"
"9","2017","30","Hotel","8","34","509","710","233","356","742","1066","1"
"9","2017","30","Otros","4","39","6","13","0","0","6","13","2.2222222222222"
"9","2017","30","Otros","13","14","126","252","0","0","126","252","1"
"9","2017","30","Hotel","10","23","208","290","15","19","223","309","2.8"
"9","2017","30","Otros","13","14","445","1200","0","0","445","1200","1"
"9","2017","30","Hotel","12","24","491","698","278","596","769","1294","1"
"9","2017","30","","6","25","108","121","0","0","108","121","1"
"9","2017","30","Hotel","15","27","864","1256","11","14","875","1270","1"
"9","2017","30","Hotel","12","35","87","206","131","325","218","531","1"
"9","2017","30","Hotel","16","40","370","1850","238","636","608","2486","1"
"9","2017","30","Hotel","16","27","132","398","533","1994","665","2392","1"
"9","2017","30","Hotel","9","30","91","156","6","31","97","187","1"
"9","2017","30","Hotel","4","13","225","456","41","155","266","611","3.2"
"9","2017","30","Hotel","2","29","207","602","121","415","328","1017","1"
"9","2017","30","Hotel","16","20","1016","1016","141","141","1157","1157","1"
"9","2017","30","Hotel","5","5","380","585","95","176","475","761","1"
"9","2017","30","Hotel","13","33","791","1252","92","171","883","1423","1"
"9","2017","30","Otros","16","19","133","202","0","0","133","202","1.3333333333333"
"9","2017","30","Hotel","12","24","128","325","244","595","372","920","1"
"9","2017","30","","8","2","556","1143","42","60","598","1203","1"
"9","2017","0","Hotel","12","35","0","0","0","0","0","0","1"
"9","2017","30","Hotel","16","27","23","27","291","340","314","367","2.5"
"9","2017","30","Otros","16","27","379","739","4","4","383","743","2"
"9","2017","30","Hotel","8","34","463","626","165","265","628","891","1"
"9","2017","30","Otros","8","3","97","224","0","0","97","224","1"
"9","2017","30","Hotel","7","27","220","297","104","184","324","481","1"
"9","2017","30","Hotel","4","39","360","808","2","2","362","810","1"
"9","2017","30","Hotel","15","16","176","357","15","36","191","393","4"
"9","2017","30","Hotel","4","39","552","862","4","4","556","866","1"
"9","2017","30","Hotel","4","39","468","769","24","32","492","801","1"
"9","2017","30","Hotel","15","16","161","346","7","13","168","359","4"
"9","2017","30","Hotel","14","31","12","17","346","1241","358","1258","17.4"
"9","2017","30","Hotel","8","34","231","502","201","308","432","810","1"
"9","2017","30","Hotel","6","28","244","398","30","46","274","444","1"
"9","2017","30","Hotel","7","17","966","1276","61","117","1027","1393","4"
"9","2017","30","Otros","7","27","7","10","0","0","7","10","1"
"9","2017","30","Hotel","11","36","813","902","56","96","869","998","1"
"9","2017","30","Otros","4","21","563","1127","99","187","662","1314","1"
"9","2017","30","Otros","15","16","102","106","58","60","160","166","2"
"9","2017","30","Otros","7","17","237","502","8","12","245","514","3"
"9","2017","30","Hotel","7","38","104","134","2","2","106","136","1"
"9","2017","30","Hotel","16","27","381","503","84","150","465","653","2.5"
"9","2017","30","Hotel","2","6","23","47","3","3","26","50","2.2"
"9","2017","30","Hotel","11","36","410","704","32","76","442","780","1"
"9","2017","30","Hotel","6","28","27","33","6","10","33","43","1"
"9","2017","30","Hotel","6","12","41","72","0","0","41","72","5"
"9","2017","30","Otros","9","22","77","198","0","0","77","198","1"
"9","2017","30","","13","14","180","284","1","2","181","286","2"
"9","2017","30","Hotel","2","29","102","287","353","584","455","871","1"
"9","2017","30","Hotel","2","29","86","222","90","534","176","756","1"
"9","2017","30","Otros","4","13","446","464","13","13","459","477","1"
"9","2017","30","Hotel","15","16","84","231","32","84","116","315","4"
"9","2017","30","Hotel","2","1","109","219","5","9","114","228","6.4"
"9","2017","30","Otros","7","27","93","147","0","0","93","147","1"
"9","2017","30","Otros","13","33","25","35","0","0","25","35","5.125"
"9","2017","30","","4","21","606","703","4","4","610","707","1"
"9","2017","30","Hotel","6","10","360","360","2","2","362","362","1"
"9","2017","30","Hotel","11","36","206","590","6","18","212","608","1"
"9","2017","30","Otros","14","31","50","600","60","210","110","810","2.8"
"9","2017","30","Hotel","7","27","149","282","0","0","149","282","1"
"9","2017","30","Otros","6","10","10","10","0","0","10","10","3.8518518518518"
"9","2017","30","Hotel","4","39","344","383","16","20","360","403","2.6"
"9","2017","30","Otros","8","2","51","144","20","35","71","179","6.4285714285714"
"9","2017","30","Otros","11","36","44","88","4","6","48","94","5.1904761904762"
"9","2017","30","Hotel","13","33","598","598","0","0","598","598","1"
"9","2017","30","","3","4","127","186","40","59","167","245","1"
"9","2017","30","Hotel","7","17","262","728","61","255","323","983","4"
"9","2017","30","Hotel","8","2","215","333","4","4","219","337","1"
"9","2017","30","Otros","15","16","164","253","17","24","181","277","2"
"9","2017","30","Hotel","10","11","219","249","3","3","222","252","1"
"9","2017","30","Hotel","16","19","245","359","0","0","245","359","1"
"9","2017","30","Hotel","10","23","150","227","43","66","193","293","4"
"9","2017","30","","7","38","269","442","41","70","310","512","1"
"9","2017","30","Hotel","7","27","4","4","0","0","4","4","1"
"9","2017","30","Hotel","11","36","472","930","75","141","547","1071","1"
"9","2017","30","Hotel","16","40","178","250","9","21","187","271","16.333333333333"
"9","2017","30","Hotel","16","19","37","66","7","7","44","73","1"
"9","2017","30","Hotel","16","19","7","14","0","0","7","14","1"
"9","2017","0","Hotel","16","20","0","0","0","0","0","0","1"
"9","2017","30","Hotel","10","11","171","240","15","19","186","259","1"
"9","2017","30","Otros","7","27","93","169","0","0","93","169","4.8333333333333"
"9","2017","30","Otros","7","27","23","80","0","0","23","80","1"
"9","2017","30","Hotel","7","27","22","26","0","0","22","26","4.1666666666667"
"9","2017","30","Otros","13","14","171","426","0","0","171","426","1"
"9","2017","30","Otros","11","15","18","35","0","0","18","35","2.3571428571429"
"9","2017","30","Otros","10","27","31","89","7","11","38","100","4.84"
"9","2017","30","Otros","14","31","131","131","2434","2434","2565","2565","2.8"
"9","2017","30","Otros","11","36","9","13","0","0","9","13","5.1904761904762"
"9","2017","30","Hotel","16","19","36","40","0","0","36","40","1"
"9","2017","30","","14","27","246","302","7","14","253","316","2.6666666666667"
"9","2017","30","Hotel","16","40","59","185","0","0","59","185","5.6666666666667"
"9","2017","30","Hotel","10","27","11","27","0","0","11","27","2.25"
"9","2017","30","Otros","2","29","115","307","173","496","288","803","3.28"
"9","2017","30","Hotel","13","27","0","0","19","20","19","20","1"
"9","2017","30","Otros","9","22","39","43","0","0","39","43","1"
"9","2017","30","Hotel","2","27","59","90","1","4","60","94","1"
"9","2017","30","Hotel","8","34","380","528","114","184","494","712","1"
"9","2017","30","Hotel","7","27","249","416","0","0","249","416","1"
"9","2017","30","Hotel","15","16","188","396","34","66","222","462","4"
"9","2017","30","Hotel","16","20","48","97","2","2","50","99","1"
"9","2017","30","Otros","4","13","61","251","3","9","64","260","1"
"9","2017","30","Hotel","2","1","199","450","4","4","203","454","6.4"
"9","2017","30","Otros","11","32","16","39","0","0","16","39","2.2857142857143"
"9","2017","30","Hotel","2","29","20","180","138","927","158","1107","1"
"9","2017","30","Hotel","16","27","98","109","148","166","246","275","2.5"
"9","2017","30","Hotel","10","18","199","920","0","0","199","920","3.2"
"9","2017","30","Otros","11","36","344","367","19","28","363","395","1"
"9","2017","30","Otros","13","14","43","87","0","0","43","87","1"
"9","2017","30","Hotel","7","27","105","152","0","0","105","152","1"
"9","2017","30","Otros","7","17","187","368","0","0","187","368","3"
"9","2017","30","Otros","14","31","242","376","182","494","424","870","2.8"
"9","2017","30","Hotel","2","29","125","371","231","829","356","1200","1"
"9","2017","30","Hotel","8","3","163","374","121","299","284","673","1"
"9","2017","30","Hotel","8","34","250","355","109","213","359","568","2.5714285714286"
"9","2017","30","Hotel","8","34","213","274","197","398","410","672","2.5714285714286"
"9","2017","30","Hotel","12","35","84","106","100","120","184","226","1"
"9","2017","30","Hotel","11","32","209","440","10","25","219","465","1"
"9","2017","30","Hotel","13","33","152","237","8","8","160","245","2"
"9","2017","30","Hotel","10","23","233","353","43","70","276","423","2.8"
"9","2017","30","Hotel","12","35","85","149","42","50","127","199","1"
"9","2017","30","","16","40","357","505","25","54","382","559","3.0555555555556"
"9","2017","30","Otros","16","19","11","38","0","0","11","38","1.3333333333333"
"9","2017","30","Otros","16","20","44","122","0","0","44","122","1"
"9","2017","30","Hotel","6","12","168","400","0","0","168","400","5"
"9","2017","30","Hotel","16","19","191","231","0","0","191","231","4"
"9","2017","30","Hotel","12","24","110","327","153","320","263","647","1"
"9","2017","30","Hotel","12","24","172","344","102","152","274","496","3"
"9","2017","30","Hotel","8","3","32","192","0","0","32","192","1"
"9","2017","0","Hotel","5","9","0","0","0","0","0","0","1"
"9","2017","30","Hotel","16","27","294","600","28","91","322","691","2.5"
"9","2017","30","Otros","10","23","41","41","0","0","41","41","7"
"9","2017","30","Otros","13","14","110","206","0","0","110","206","7.3846153846154"
"9","2017","30","Otros","2","6","36","81","9","24","45","105","1"
"9","2017","14","Hotel","15","16","12","12","82","89","94","101","7.8"
"9","2017","30","Hotel","8","3","175","855","0","0","175","855","1"
"9","2017","30","Hotel","8","34","375","553","182","310","557","863","1"
"9","2017","30","Hotel","8","3","59","104","19","28","78","132","1"
"9","2017","30","","2","29","77","221","0","0","77","221","1"
"9","2017","30","Hotel","2","1","213","332","30","56","243","388","6.4"
"9","2017","30","Hotel","7","17","121","199","4","4","125","203","4"
"9","2017","30","Otros","7","17","225","559","0","0","225","559","3"
"9","2017","30","Hotel","16","40","116","189","53","94","169","283","5.6666666666667"
"9","2017","30","Hotel","12","24","153","351","127","239","280","590","1"
"9","2017","30","Hotel","14","31","183","408","272","1194","455","1602","17.4"
"9","2017","0","Hotel","9","26","0","0","0","0","0","0","1"
"9","2017","30","Hotel","6","12","21","50","0","0","21","50","5"
"9","2017","30","Otros","5","9","14","14","0","0","14","14","4.0454545454545"
"9","2017","30","Otros","5","9","4","4","0","0","4","4","4.0454545454545"
"9","2017","30","Otros","15","27","91","106","11","16","102","122","1.4222222222222"
"9","2017","30","Hotel","8","34","8","8","11","11","19","19","2.5714285714286"
"9","2017","30","Hotel","10","18","292","665","118","233","410","898","7.75"
"9","2017","30","Hotel","15","16","290","549","39","100","329","649","7.8"
"9","2017","30","Hotel","2","29","132","389","268","921","400","1310","1"
"9","2017","30","Hotel","4","39","312","571","11","22","323","593","2.6"
"9","2017","30","Otros","4","39","124","207","0","0","124","207","2.2222222222222"
"9","2017","30","Hotel","4","13","306","537","50","86","356","623","5.4"
"9","2017","30","Otros","10","23","44","48","0","0","44","48","7"
"9","2017","30","Otros","14","31","98","163","358","665","456","828","20.2"
"9","2017","20","Hotel","3","4","30","48","0","0","30","48","2.6"
"9","2017","30","Hotel","10","23","67","78","25","30","92","108","4"
"9","2017","30","Otros","9","22","290","902","0","0","290","902","1"
"9","2017","30","Hotel","12","24","205","314","115","195","320","509","3"
"9","2017","30","Hotel","13","14","16","19","0","0","16","19","1"
"9","2017","30","Hotel","12","35","179","327","106","148","285","475","1.7272727272727"
"9","2017","30","Hotel","6","28","356","562","0","0","356","562","1"
"9","2017","30","","6","28","35","81","0","0","35","81","1"
"9","2017","30","Hotel","12","24","286","598","126","250","412","848","3"
"9","2017","30","Otros","5","9","10","10","0","0","10","10","4.0454545454545"
"9","2017","30","Hotel","16","20","44","47","1","2","45","49","1"
"9","2017","30","Hotel","4","21","343","500","26","29","369","529","3"
"9","2017","30","Otros","10","11","20","32","0","0","20","32","11.764705882353"
"9","2017","30","Otros","13","14","20","38","0","0","20","38","7.3846153846154"
"9","2017","30","Otros","16","27","30","62","0","0","30","62","13.818181818182"
"9","2017","30","Hotel","9","26","444","444","0","0","444","444","1"
"9","2017","30","Hotel","16","27","433","590","346","550","779","1140","2.5"
"9","2017","30","Hotel","3","4","769","1258","145","278","914","1536","3"
"9","2017","30","Otros","16","27","50","50","0","0","50","50","2"
"9","2017","30","Otros","16","19","584","1014","10","12","594","1026","1.3333333333333"
"9","2017","30","Hotel","6","12","461","652","22","23","483","675","5"
"9","2017","30","Hotel","2","1","221","488","60","140","281","628","6.4"
"9","2017","30","Hotel","10","11","320","502","27","36","347","538","1"
"9","2017","30","Otros","10","23","59","59","2","2","61","61","1"
"9","2017","30","Otros","10","27","719","884","72","83","791","967","4.84"
"9","2017","30","Hotel","16","27","215","482","22","74","237","556","2.5"
"9","2017","30","Hotel","6","28","134","171","26","30","160","201","1"
"9","2017","30","Hotel","4","13","99","211","7","11","106","222","5.4"
"9","2017","30","Hotel","14","27","582","780","38","52","620","832","8.5"
"9","2017","30","Hotel","10","27","80","122","314","399","394","521","1"
"9","2017","30","Hotel","13","27","89","141","37","45","126","186","4.2"
"9","2017","30","Hotel","3","4","309","434","2","6","311","440","3"
"9","2017","30","Otros","4","13","203","545","4","4","207","549","3.4"
"9","2017","30","Otros","11","15","7","18","3","3","10","21","2.3571428571429"
"9","2017","30","Otros","6","10","393","742","0","0","393","742","3.8518518518518"
"9","2017","30","Otros","2","1","39","61","0","0","39","61","1"
"9","2017","30","","6","12","45","113","0","0","45","113","1"
"9","2017","30","Otros","10","23","249","807","0","0","249","807","1"
"9","2017","30","Hotel","16","19","130","150","0","0","130","150","4"
"9","2017","30","Hotel","10","11","23","138","0","0","23","138","5.6666666666667"
"9","2017","30","Hotel","10","23","47","47","2","2","49","49","4"
"9","2017","30","Otros","14","31","45","95","263","571","308","666","2.8"
"9","2017","30","Otros","13","27","5","5","0","0","5","5","12.2"
"9","2017","30","Hotel","2","1","286","840","0","0","286","840","6.4"
"9","2017","30","Hotel","16","19","40","46","0","0","40","46","4"
"9","2017","30","Otros","12","35","22","29","4","8","26","37","3.5"
"9","2017","30","Otros","15","16","84","190","9","21","93","211","2"
"9","2017","30","Otros","9","22","234","468","0","0","234","468","1"
"9","2017","30","Hotel","10","27","190","236","566","729","756","965","1"
"9","2017","30","Hotel","2","27","83","106","7","10","90","116","3.6"
"9","2017","30","Hotel","16","20","60","226","16","50","76","276","1"
"9","2017","30","Hotel","10","18","164","371","73","157","237","528","7.75"
"9","2017","30","Hotel","6","12","162","340","0","0","162","340","5"
"9","2017","30","Hotel","2","27","93","181","4","6","97","187","3.6"
"9","2017","30","Hotel","15","16","80","202","3","6","83","208","7.8"
"9","2017","30","Hotel","10","23","74","74","20","23","94","97","4"
"9","2017","30","Hotel","11","32","11","12","3","3","14","15","1"
"9","2017","30","Hotel","14","27","88","282","65","182","153","464","8.5"
"9","2017","30","Otros","10","11","33","37","0","0","33","37","11.764705882353"
"9","2017","30","Hotel","2","27","89","188","14","21","103","209","3.6"
"9","2017","30","Otros","13","14","180","536","0","0","180","536","7.3846153846154"
"9","2017","30","Hotel","2","1","165","320","28","39","193","359","6.4"
"9","2017","30","Otros","7","17","218","576","6","12","224","588","17.166666666667"
"9","2017","30","Otros","10","23","25","109","0","0","25","109","7"
"9","2017","30","Hotel","13","27","170","170","5","5","175","175","2.75"
"9","2017","30","Otros","10","18","1","1","0","0","1","1","10.25"
"9","2017","30","Otros","5","9","14","14","0","0","14","14","4.0454545454545"
"9","2017","30","Hotel","4","39","175","308","8","12","183","320","2.6"
"9","2017","30","Otros","16","27","40","235","11","23","51","258","13.818181818182"
"9","2017","30","Hotel","14","27","28","51","84","174","112","225","8.5"
"9","2017","30","Hotel","10","11","146","253","14","20","160","273","5.6666666666667"
"9","2017","30","Hotel","10","18","168","374","81","211","249","585","7.75"
"9","2017","30","Otros","14","31","144","271","79","170","223","441","20.2"
"9","2017","30","Otros","11","32","29","57","0","0","29","57","2.2857142857143"
"9","2017","30","Otros","5","5","72","148","0","0","72","148","3.65625"
"9","2017","30","Otros","6","25","27","114","0","0","27","114","2.3846153846154"
"9","2017","30","Hotel","3","4","37","98","6","7","43","105","2.6"
"9","2017","30","Otros","7","27","106","225","0","0","106","225","4.8333333333333"
"9","2017","30","Otros","2","29","70","161","89","214","159","375","3.28"
"9","2017","30","Hotel","2","29","71","206","170","541","241","747","1"
"9","2017","30","Otros","4","21","152","323","10","28","162","351","1"
"9","2017","30","Hotel","7","27","175","200","1","1","176","201","4.1666666666667"
"9","2017","30","Otros","5","5","13","57","0","0","13","57","3.65625"
"9","2017","30","Otros","11","36","54","71","10","20","64","91","5.1904761904762"
"9","2017","30","Hotel","7","27","415","415","0","0","415","415","4.1666666666667"
"9","2017","0","Hotel","16","20","0","0","0","0","0","0","1"
"9","2017","30","Hotel","12","24","77","145","76","280","153","425","3"
"9","2017","30","Hotel","9","26","105","147","7","8","112","155","1.5"
"9","2017","30","Hotel","7","17","337","1034","3","6","340","1040","10"
"9","2017","30","Hotel","9","37","274","356","26","65","300","421","3.4"
"9","2017","30","Hotel","5","5","374","533","88","108","462","641","2.1428571428571"
"9","2017","30","Otros","6","27","69","138","0","0","69","138","3.960088691796"
"9","2017","30","Hotel","9","37","47","92","1","2","48","94","3.4"
"9","2017","30","Otros","10","27","15","27","61","99","76","126","4.84"
"9","2017","30","Otros","8","3","185","275","14","16","199","291","10"
"9","2017","30","Otros","16","20","43","45","5","5","48","50","3.0769230769231"
"9","2017","30","Otros","9","22","47","113","0","0","47","113","7.6428571428571"
"9","2017","30","Otros","10","27","167","260","4","4","171","264","4.84"
"9","2017","30","Otros","10","23","36","45","4","4","40","49","7"
"9","2017","30","Otros","2","6","432","432","221","221","653","653","1"
"9","2017","30","Otros","4","39","41","77","1","1","42","78","2.2222222222222"
"9","2017","30","Hotel","2","27","55","77","8","8","63","85","1"
"9","2017","30","Hotel","14","31","47","72","119","499","166","571","24"
"9","2017","30","Otros","2","29","124","204","94","220","218","424","3.28"
"9","2017","30","Otros","8","3","264","1320","0","0","264","1320","10"
"9","2017","30","","13","14","24","62","2","6","26","68","1"
"9","2017","30","Hotel","6","10","166","214","12","16","178","230","6.6"
"9","2017","30","Hotel","8","34","178","214","83","103","261","317","2.5714285714286"
"9","2017","30","Hotel","9","22","171","704","0","0","171","704","2.5555555555556"
"9","2017","30","Hotel","2","6","148","276","67","73","215","349","2.2"
"9","2017","30","Hotel","10","27","129","245","156","208","285","453","2.25"
"9","2017","30","Otros","14","27","165","165","0","0","165","165","11.833333333333"
"9","2017","30","Otros","6","12","362","550","11","24","373","574","1.8256578947368"
"9","2017","30","Hotel","6","27","130","134","0","0","130","134","3"
"9","2017","30","Hotel","5","5","20","42","5","12","25","54","2.1428571428571"
"9","2017","26","Hotel","5","5","100","168","8","22","108","190","2.1428571428571"
"9","2017","30","Hotel","13","27","134","236","0","0","134","236","4.2"
"9","2017","30","Hotel","2","27","218","345","0","0","218","345","3.6"
"9","2017","30","Hotel","8","3","43","43","33","33","76","76","4.1111111111111"
"9","2017","30","Otros","11","36","62","138","2","6","64","144","5.1904761904762"
"9","2017","30","Otros","9","30","66","113","0","0","66","113","2.3333333333333"
"9","2017","30","Otros","16","19","42","76","0","0","42","76","10.263157894737"
"9","2017","30","Hotel","14","31","53","87","325","959","378","1046","17.4"
"9","2017","30","Hotel","2","1","272","304","8","9","280","313","6.4"
"9","2017","30","Hotel","16","40","942","1777","282","387","1224","2164","5.6666666666667"
"9","2017","30","Otros","7","17","336","560","5","20","341","580","17.166666666667"
"9","2017","30","Hotel","13","27","232","264","117","160","349","424","2.75"
"9","2017","30","Hotel","14","31","172","224","376","533","548","757","24"
"9","2017","30","Otros","3","4","45","120","4","6","49","126","12.2"
"9","2017","30","Otros","8","34","144","188","188","337","332","525","5.75"
"9","2017","30","Hotel","9","22","114","184","10","24","124","208","2.5555555555556"
"9","2017","30","Hotel","4","21","71","118","4","4","75","122","3"
"9","2017","30","Hotel","6","27","91","128","0","0","91","128","3"
"9","2017","30","Hotel","12","35","63","100","24","40","87","140","1.7272727272727"
"9","2017","30","Hotel","2","29","35","69","33","56","68","125","2"
"9","2017","30","Otros","10","11","37","54","8","11","45","65","11.764705882353"
"9","2017","30","Hotel","6","10","63","85","0","0","63","85","6.6"
"9","2017","30","Hotel","13","14","37","73","0","0","37","73","2"
"9","2017","12","Otros","16","27","41","77","0","0","41","77","13.818181818182"
"9","2017","30","Otros","6","27","34","66","0","0","34","66","3.960088691796"
"9","2017","30","Hotel","16","40","372","617","382","537","754","1154","5.6666666666667"
"9","2017","30","Otros","6","10","147","249","6","12","153","261","3.8518518518518"
"9","2017","30","Otros","10","23","8","20","0","0","8","20","7"
"9","2017","30","Hotel","6","28","199","230","3","9","202","239","1"
"9","2017","30","Otros","7","38","375","935","44","83","419","1018","2.75"
"9","2017","30","Hotel","6","12","161","289","6","14","167","303","5"
"9","2017","30","Hotel","13","27","308","461","0","0","308","461","4.2"
"9","2017","30","Otros","4","21","41","87","0","0","41","87","4.8333333333333"
"9","2017","30","Hotel","16","27","59","152","7","35","66","187","5.8571428571429"
"9","2017","30","Hotel","5","5","35","35","2","2","37","37","2.1428571428571"
"9","2017","30","Otros","12","24","59","113","87","161","146","274","9.2"
"9","2017","30","Otros","15","16","105","139","41","47","146","186","9"
"9","2017","30","Hotel","8","27","83","83","5","5","88","88","4.5"
"9","2017","30","Hotel","9","22","75","147","0","0","75","147","2.5555555555556"
"9","2017","30","Hotel","10","11","251","419","30","49","281","468","5.6666666666667"
"9","2017","30","Hotel","8","3","57","101","16","28","73","129","4.1111111111111"
"9","2017","30","Hotel","6","10","285","377","0","0","285","377","6.6"
"9","2017","30","Otros","9","26","78","228","0","0","78","228","3.8888888888889"
"9","2017","30","Hotel","4","39","110","314","12","55","122","369","2.6"
"9","2017","30","Otros","6","27","2","3","0","0","2","3","3.960088691796"
"9","2017","30","Otros","6","12","156","217","0","0","156","217","1.8256578947368"
"9","2017","30","Hotel","6","27","77","149","0","0","77","149","3"
"9","2017","30","Otros","5","9","103","151","21","39","124","190","4.0454545454545"
"9","2017","30","Hotel","2","27","119","119","12","12","131","131","3.6"
"9","2017","30","Hotel","2","29","32","96","198","594","230","690","1"
"9","2017","30","Hotel","4","13","115","210","6","6","121","216","5.4"
"9","2017","30","","11","15","17","34","0","0","17","34","1"
"9","2017","30","Hotel","6","10","345","384","15","28","360","412","6.6"
"9","2017","30","Otros","6","12","12","12","0","0","12","12","1.8256578947368"
"9","2017","30","Otros","10","18","39","59","2","4","41","63","10.25"
"9","2017","30","Otros","9","22","128","298","0","0","128","298","7.6428571428571"
"9","2017","30","","14","27","98","180","32","45","130","225","1"
"9","2017","30","Hotel","16","27","81","289","0","0","81","289","5.8571428571429"
"9","2017","30","Otros","2","29","8","24","36","65","44","89","3.28"
"9","2017","30","Otros","13","33","82","86","2","2","84","88","5.125"
"9","2017","30","Otros","13","33","20","24","5","5","25","29","5.125"
"9","2017","26","Otros","6","10","73","383","0","0","73","383","3.8518518518518"
"9","2017","30","Hotel","10","18","37","71","15","30","52","101","7.75"
"9","2017","30","Hotel","14","31","100","171","65","245","165","416","24"
"9","2017","30","Hotel","4","21","69","69","11","11","80","80","3"
"9","2017","30","Hotel","3","4","8","12","6","152","14","164","2.6"
"9","2017","0","Otros","8","27","0","0","0","0","0","0","1"
"9","2017","30","Otros","6","27","19","55","0","0","19","55","3.960088691796"
"9","2017","30","Hotel","6","25","204","324","0","0","204","324","1"
"9","2017","30","Otros","6","12","163","248","1","2","164","250","1.8256578947368"
"9","2017","30","Hotel","6","27","23","30","0","0","23","30","3"
"9","2017","30","Otros","6","27","15","45","0","0","15","45","3.960088691796"
"9","2017","30","Otros","6","10","119","182","12","24","131","206","3.8518518518518"
"9","2017","30","Otros","6","12","33","66","0","0","33","66","1.8256578947368"
"9","2017","30","Otros","5","5","20","43","4","8","24","51","3.65625"
"9","2017","30","Hotel","12","24","42","178","5","12","47","190","3"
"9","2017","30","Hotel","15","16","75","94","4","4","79","98","7.8"
"9","2017","30","Otros","4","13","79","87","0","0","79","87","3.4"
"9","2017","30","Hotel","2","29","254","901","45","127","299","1028","1"
"9","2017","30","Hotel","4","21","68","146","0","0","68","146","3"
"9","2017","30","Hotel","10","27","132","179","97","117","229","296","2.25"
"9","2017","30","Hotel","8","3","167","277","43","60","210","337","4.1111111111111"
"9","2017","30","Hotel","12","27","41","49","7","15","48","64","1"
"9","2017","30","Otros","5","5","112","321","37","86","149","407","3.65625"
"9","2017","30","Otros","13","14","9","12","0","0","9","12","7.3846153846154"
"9","2017","30","Otros","10","11","214","245","41","69","255","314","11.764705882353"
"9","2017","30","Otros","16","40","113","214","6","13","119","227","28.142857142857"
"9","2017","30","Hotel","11","36","236","356","22","30","258","386","1"
"9","2017","27","Otros","8","34","51","76","58","91","109","167","5.75"
"9","2017","30","Hotel","7","17","170","323","4","8","174","331","10"
"9","2017","30","Otros","12","35","198","370","9","12","207","382","3.5"
"9","2017","30","Otros","5","9","20","40","12","30","32","70","4.0454545454545"
"9","2017","30","Hotel","9","22","48","62","0","0","48","62","2.5555555555556"
"9","2017","30","Otros","2","29","32","92","41","71","73","163","3.28"
"9","2017","30","Otros","2","29","57","127","59","132","116","259","3.28"
"9","2017","30","Hotel","10","27","76","111","80","95","156","206","2.25"
"9","2017","30","Hotel","16","19","59","149","5","7","64","156","4"
"9","2017","30","Hotel","16","40","189","294","45","80","234","374","16.333333333333"
"9","2017","30","Hotel","8","27","174","262","46","48","220","310","4.5"
"9","2017","30","Otros","13","14","28","46","0","0","28","46","7.3846153846154"
"9","2017","30","Hotel","7","27","33","43","0","0","33","43","4.1666666666667"
"9","2017","30","Otros","2","6","40","507","0","0","40","507","5"
"9","2017","30","Hotel","7","17","283","671","14","65","297","736","10"
"9","2017","30","Hotel","3","4","108","245","39","81","147","326","2.6"
"9","2017","20","Otros","6","12","17","144","0","0","17","144","1.8256578947368"
"9","2017","30","Otros","6","10","4","4","0","0","4","4","3.8518518518518"
"9","2017","30","Hotel","16","40","38","80","5","15","43","95","16.333333333333"
"9","2017","30","Otros","4","39","141","225","13","13","154","238","2.2222222222222"
"9","2017","30","Otros","13","14","46","92","0","0","46","92","7.3846153846154"
"9","2017","30","Otros","7","38","136","242","8","9","144","251","2.75"
"9","2017","30","Hotel","11","32","74","119","0","0","74","119","1"
"9","2017","30","Otros","11","36","119","248","7","9","126","257","5.1904761904762"
"9","2017","30","Hotel","4","21","114","163","0","0","114","163","3"
"9","2017","30","Otros","3","4","4","9","0","0","4","9","12.2"
"9","2017","30","Otros","5","9","51","74","12","19","63","93","4.0454545454545"
"9","2017","30","Hotel","8","27","64","77","1","1","65","78","4.5"
"9","2017","30","","7","17","327","964","0","0","327","964","1"
"9","2017","30","Otros","16","20","71","214","0","0","71","214","3.0769230769231"
"9","2017","30","Otros","4","21","45","100","0","0","45","100","4.8333333333333"
"9","2017","30","Otros","13","33","52","71","5","5","57","76","5.125"
"9","2017","21","","12","35","0","0","92","240","92","240","1"
"9","2017","30","Hotel","13","33","1","1","0","0","1","1","2"
"9","2017","30","Otros","4","39","94","196","0","0","94","196","2.2222222222222"
"9","2017","30","Otros","10","18","7","21","0","0","7","21","10.25"
"9","2017","30","Otros","6","27","63","93","2","4","65","97","3.960088691796"
"9","2017","30","Hotel","4","39","79","185","0","0","79","185","2.6"
"9","2017","30","Otros","14","31","76","123","52","86","128","209","20.2"
"9","2017","30","Hotel","2","29","42","114","310","698","352","812","2"
"9","2017","30","Hotel","9","26","221","325","0","0","221","325","1.5"
"9","2017","30","Otros","12","35","3","4","1","2","4","6","3.5"
"9","2017","30","Hotel","14","27","74","109","37","51","111","160","8.5"
"9","2017","30","Otros","11","36","45","91","3","3","48","94","5.1904761904762"
"9","2017","30","Otros","16","20","149","410","10","32","159","442","3.0769230769231"
"9","2017","30","Otros","4","39","7","10","0","0","7","10","2.2222222222222"
"9","2017","30","Otros","7","27","130","146","2","3","132","149","4.8333333333333"
"9","2017","30","Otros","6","27","81","138","0","0","81","138","3.960088691796"
"9","2017","30","Otros","5","8","10","300","0","0","10","300","5"
"9","2017","30","Otros","9","37","143","345","12","20","155","365","4.5"
"9","2017","30","Hotel","2","6","52","265","0","0","52","265","5.5"
"9","2017","30","Hotel","10","27","294","507","248","340","542","847","2.25"
"9","2017","30","Hotel","9","30","141","388","30","120","171","508","1"
"9","2017","30","Otros","4","13","64","224","2","2","66","226","3.4"
"9","2017","30","Hotel","5","5","265","270","17","17","282","287","1"
"9","2017","30","Otros","7","38","175","371","5","9","180","380","2.75"
"9","2017","30","Hotel","13","14","8","8","0","0","8","8","1"
"9","2017","30","Otros","5","9","34","57","2","4","36","61","4.0454545454545"
"9","2017","30","Otros","5","8","6","9","0","0","6","9","5"
"9","2017","30","Otros","10","27","16","416","0","0","16","416","4.84"
"9","2017","0","Hotel","13","14","0","0","0","0","0","0","1"
"9","2017","30","Otros","11","15","22","31","1","1","23","32","2.3571428571429"
"9","2017","30","Hotel","9","22","257","376","0","0","257","376","2.5555555555556"
"9","2017","30","Otros","11","36","59","67","2","3","61","70","5.1904761904762"
"9","2017","30","Hotel","10","18","1778","3878","1642","3887","3420","7765","1"
"9","2017","30","Hotel","6","12","56","98","4","55","60","153","5"
"9","2017","30","","2","29","509","1542","255","415","764","1957","1"
"9","2017","30","Hotel","16","27","618","2413","14","30","632","2443","1"
"9","2017","30","","14","31","287","637","557","2178","844","2815","1"
"9","2017","30","Hotel","8","3","14","98","10","22","24","120","4.1111111111111"
"9","2017","30","Otros","13","33","14","29","0","0","14","29","5.125"
"9","2017","30","","14","27","246","302","7","14","253","316","2.6666666666667"
"9","2017","30","Otros","9","22","68","368","0","0","68","368","7.6428571428571"
"9","2017","30","Hotel","10","11","18","18","2","6","20","24","5.6666666666667"
"9","2017","30","Otros","6","12","9","37","0","0","9","37","1.8256578947368"
"9","2017","30","Hotel","8","3","52","67","12","12","64","79","4.1111111111111"
"9","2017","30","Otros","6","12","216","317","0","0","216","317","1.8256578947368"
"9","2017","30","Hotel","8","27","108","108","0","0","108","108","4.5"
"9","2017","30","Hotel","6","28","206","242","9","9","215","251","2.4"
"9","2017","30","Otros","6","25","50","283","0","0","50","283","2.3846153846154"
"9","2017","30","Otros","6","25","53","118","0","0","53","118","2.3846153846154"
"9","2017","30","Hotel","11","36","445","1289","0","0","445","1289","1"
"9","2017","30","Otros","2","6","11","28","179","589","190","617","5"
"9","2017","30","Hotel","14","31","37","62","151","436","188","498","24"
"9","2017","30","Otros","4","21","36","94","10","10","46","104","4.8333333333333"
"9","2017","30","Otros","7","38","33","61","0","0","33","61","2.75"
"9","2017","30","Otros","13","14","56","87","0","0","56","87","7.3846153846154"
"9","2017","30","Otros","2","29","29","46","33","45","62","91","3.28"
"9","2017","30","Otros","3","4","81","81","24","24","105","105","12.2"
"9","2017","30","Hotel","3","4","432","799","32","76","464","875","3"
"9","2017","30","Otros","7","27","261","320","13","13","274","333","1"
"9","2017","30","Otros","7","17","108","109","0","0","108","109","3"
"9","2017","30","Hotel","12","27","185","383","27","35","212","418","1"
"9","2017","30","Otros","5","5","28","38","5","11","33","49","3.65625"
"9","2017","30","Hotel","6","10","210","279","6","6","216","285","6.6"
"9","2017","30","Otros","10","18","4","40","0","0","4","40","10.25"
"9","2017","30","Otros","8","27","51","89","0","0","51","89","9.4"
"9","2017","30","Otros","8","3","39","64","10","27","49","91","10"
"9","2017","30","Hotel","16","27","94","95","0","0","94","95","5.8571428571429"
"9","2017","30","Otros","6","10","52","151","0","0","52","151","3.8518518518518"
"9","2017","30","Hotel","2","6","38","64","0","0","38","64","5.5"
"9","2017","30","Hotel","8","3","0","0","3","6","3","6","4.1111111111111"
"9","2017","30","Otros","10","11","47","82","6","8","53","90","11.764705882353"
"9","2017","30","Otros","6","27","50","500","0","0","50","500","3.960088691796"
"9","2017","26","Otros","15","16","0","0","3","6","3","6","9"
"9","2017","30","Otros","5","5","2","4","0","0","2","4","3.65625"
"9","2017","30","Otros","10","27","138","278","29","31","167","309","4.84"
"9","2017","30","Hotel","7","38","123","224","6","9","129","233","1"
"9","2017","30","Hotel","13","27","11","165","0","0","11","165","4.2"
"9","2017","30","Hotel","16","20","85","107","0","0","85","107","1"
"9","2017","30","Otros","10","27","50","73","146","226","196","299","4.84"
"9","2017","30","Hotel","3","7","52","64","12","16","64","80","1"
"9","2017","30","Otros","2","29","77","123","6","8","83","131","3.28"
"9","2017","30","Otros","10","18","12","45","0","0","12","45","10.25"
"9","2017","30","Otros","9","22","192","391","0","0","192","391","7.6428571428571"
"9","2017","30","Otros","15","27","81","84","0","0","81","84","1.4222222222222"
"9","2017","30","Otros","11","36","9","20","0","0","9","20","5.1904761904762"
"9","2017","30","Otros","5","5","25","47","7","13","32","60","3.65625"
"9","2017","30","Otros","2","29","12","96","55","380","67","476","3.28"
"9","2017","30","Hotel","9","22","144","144","2","2","146","146","2.5555555555556"
"9","2017","30","Otros","11","32","1","1","0","0","1","1","2.2857142857143"
"9","2017","30","Hotel","10","27","243","420","176","199","419","619","1"
"9","2017","30","Otros","16","27","82","202","0","0","82","202","2"
"9","2017","30","Hotel","16","20","56","117","0","0","56","117","1"
"9","2017","30","Otros","11","15","35","46","0","0","35","46","2.3571428571429"
"9","2017","30","Otros","7","17","123","537","0","0","123","537","3"
"9","2017","30","Otros","5","8","11","14","1","1","12","15","5"
"9","2017","28","Hotel","13","33","64","84","2","2","66","86","2"
"9","2017","14","Otros","5","9","21","33","18","21","39","54","4.0454545454545"
"9","2017","30","Otros","10","27","45","207","18","76","63","283","4.84"
"9","2017","30","Otros","9","22","56","99","0","0","56","99","7.6428571428571"
"9","2017","30","Otros","16","40","80","128","0","0","80","128","28.142857142857"
"9","2017","30","Hotel","16","40","136","141","14","17","150","158","1"
"9","2017","30","Otros","15","16","7","29","5","7","12","36","9"
"9","2017","30","Hotel","8","2","17","28","10","11","27","39","3"
"9","2017","30","Otros","8","3","14","41","0","0","14","41","10"
"9","2017","30","Otros","7","17","40","71","0","0","40","71","17.166666666667"
"9","2017","30","Otros","16","20","64","180","0","0","64","180","3.0769230769231"
"9","2017","30","Otros","6","27","24","28","0","0","24","28","3.960088691796"
"9","2017","30","Otros","12","35","49","136","48","120","97","256","3.5"
"9","2017","30","Otros","6","28","105","388","6","9","111","397","4.65"
"9","2017","30","Otros","6","28","355","949","20","30","375","979","4.65"
"9","2017","30","Hotel","8","34","49","93","77","91","126","184","2.5714285714286"
"9","2017","30","Hotel","16","20","2255","2331","7","9","2262","2340","1"
"9","2017","30","Hotel","2","6","26","72","0","0","26","72","2.2"
"9","2017","30","Hotel","7","27","53","335","0","0","53","335","4.1666666666667"
"9","2017","30","Hotel","10","23","52","177","0","0","52","177","4"
"9","2017","30","Hotel","9","26","58","63","1","1","59","64","1.5"
"9","2017","30","Otros","8","27","40","50","0","0","40","50","9.4"
"9","2017","30","Otros","10","27","14","14","3","3","17","17","4.84"
"9","2017","30","Otros","11","15","10","20","0","0","10","20","2.3571428571429"
"9","2017","30","Otros","16","20","74","144","0","0","74","144","3.0769230769231"
"9","2017","30","Otros","11","32","62","82","0","0","62","82","1"
"9","2017","30","Otros","16","27","41","41","3","3","44","44","13.818181818182"
"9","2017","30","Otros","9","37","57","79","0","0","57","79","4.5"
"9","2017","30","Hotel","2","29","12","28","32","118","44","146","2"
"9","2017","30","Hotel","2","1","20","104","5","15","25","119","6.4"
"9","2017","30","Otros","5","8","18","21","3","3","21","24","5"
"9","2017","30","Otros","9","37","83","151","25","44","108","195","4.5"
"9","2017","30","Otros","7","38","166","417","8","12","174","429","2.75"
"9","2017","30","Otros","11","32","46","81","0","0","46","81","1"
"9","2017","30","Otros","4","39","115","142","13","25","128","167","2.2222222222222"
"9","2017","30","Hotel","11","36","72","140","20","62","92","202","2.375"
"9","2017","30","Otros","10","23","15","32","2","6","17","38","7"
"9","2017","30","Hotel","15","16","671","1556","141","466","812","2022","2"
"9","2017","30","Otros","2","29","175","320","0","0","175","320","3.28"
"9","2017","30","Hotel","6","12","1193","1547","31","38","1224","1585","1"
"9","2017","30","Hotel","11","15","33","147","0","0","33","147","1"
"9","2017","30","Otros","4","21","484","916","3","3","487","919","1"
"9","2017","30","Otros","16","19","96","155","0","0","96","155","10.263157894737"
"9","2017","30","","9","37","326","495","8","20","334","515","1"
"9","2017","30","Otros","10","27","151","268","102","173","253","441","4.84"
"9","2017","30","Otros","11","15","57","57","0","0","57","57","2.3571428571429"
"9","2017","30","Hotel","2","29","43","123","44","176","87","299","2"
"9","2017","30","Hotel","10","27","191","205","158","208","349","413","1"
"9","2017","30","Hotel","11","36","74","266","19","52","93","318","2.375"
"9","2017","30","Hotel","9","37","154","213","16","34","170","247","3.4"
"9","2017","30","Otros","14","27","2","4","4","4","6","8","11.833333333333"
"9","2017","30","Otros","7","38","179","471","0","0","179","471","1"
"9","2017","30","Hotel","2","1","10","150","0","0","10","150","6.4"
"9","2017","30","Otros","2","29","6","12","62","223","68","235","3.28"
"9","2017","30","Hotel","6","27","21","23","0","0","21","23","3"
"9","2017","30","Otros","5","9","12","17","0","0","12","17","4.0454545454545"
"9","2017","30","Hotel","2","1","145","171","0","0","145","171","6.4"
"9","2017","30","Hotel","3","7","32","84","46","60","78","144","1"
"9","2017","30","Otros","7","38","57","57","53","53","110","110","2.75"
"9","2017","30","Otros","7","17","19","267","0","0","19","267","17.166666666667"
"9","2017","30","Otros","7","38","24","82","0","0","24","82","2.75"
"9","2017","30","Otros","4","21","18","18","2","2","20","20","4.8333333333333"
"9","2017","30","Otros","2","1","47","47","5","5","52","52","5.5"
"9","2017","30","Otros","12","35","45","57","34","34","79","91","3.5"
"9","2017","30","Otros","12","35","17","31","15","24","32","55","3.5"
"9","2017","30","Otros","4","21","56","67","2","2","58","69","4.8333333333333"
"9","2017","30","Otros","12","24","18","24","15","30","33","54","9.2"
"9","2017","30","Otros","16","19","7","10","0","0","7","10","10.263157894737"
"9","2017","30","Otros","10","11","41","47","0","0","41","47","11.764705882353"
"9","2017","30","Otros","16","19","33","66","0","0","33","66","10.263157894737"
"9","2017","30","Hotel","2","27","57","57","0","0","57","57","1"
"9","2017","30","Otros","6","28","34","34","0","0","34","34","4.65"
"9","2017","30","Otros","10","18","166","317","47","105","213","422","10.25"
"9","2017","30","Otros","14","27","35","169","1","11","36","180","11.833333333333"
"9","2017","30","Hotel","11","32","6","14","0","0","6","14","1"
"9","2017","30","Otros","8","27","3","5","0","0","3","5","9.4"
"9","2017","30","Hotel","12","35","58","120","25","58","83","178","1.7272727272727"
"9","2017","30","Otros","13","14","22","22","0","0","22","22","7.3846153846154"
"9","2017","30","Otros","11","36","19","22","0","0","19","22","5.1904761904762"
"9","2017","30","Otros","16","20","34","48","2","2","36","50","3.0769230769231"
"9","2017","30","Hotel","14","31","157","675","370","840","527","1515","7.8"
"9","2017","30","Otros","2","27","151","280","2","4","153","284","3.2"
"9","2017","30","","16","40","302","589","0","0","302","589","3.0555555555556"
"9","2017","30","Hotel","11","36","76","104","25","33","101","137","2.375"
"9","2017","30","Hotel","9","22","32","40","0","0","32","40","2.5555555555556"
"9","2017","30","Otros","2","29","22","42","22","44","44","86","3.28"
"9","2017","30","Hotel","10","27","22","31","79","83","101","114","2.25"
"9","2017","30","Otros","10","27","18","52","0","0","18","52","4.84"
"9","2017","30","Hotel","16","19","30","40","0","0","30","40","4"
"9","2017","30","Otros","2","6","6","25","0","0","6","25","5"
"9","2017","30","Otros","7","27","165","214","0","0","165","214","4.8333333333333"
"9","2017","30","Hotel","2","6","121","896","0","0","121","896","5.5"
"9","2017","30","Hotel","6","28","5","5","6","6","11","11","2.4"
"9","2017","30","Otros","6","10","143","282","0","0","143","282","3.8518518518518"
"9","2017","30","Hotel","6","27","14","21","0","0","14","21","3"
"9","2017","30","Otros","5","5","25","47","7","13","32","60","3.65625"
"9","2017","21","Otros","12","24","40","66","27","34","67","100","9.2"
"9","2017","30","Hotel","8","2","182","483","48","111","230","594","3"
"9","2017","30","Hotel","11","32","10","49","1","2","11","51","1"
"9","2017","30","Otros","10","18","10","24","6","16","16","40","10.25"
"9","2017","30","Hotel","9","37","6","16","7","17","13","33","3.4"
"9","2017","30","Otros","5","9","15","23","5","5","20","28","4.0454545454545"
"9","2017","30","Otros","12","24","4","5","5","34","9","39","9.2"
"9","2017","30","Otros","9","22","36","60","0","0","36","60","7.6428571428571"
"9","2017","30","Otros","2","29","11","25","33","109","44","134","3.28"
"9","2017","30","Otros","10","23","14","96","0","0","14","96","7"
"9","2017","30","Otros","10","27","53","250","20","140","73","390","4.84"
"9","2017","30","Otros","10","11","37","37","0","0","37","37","11.764705882353"
"9","2017","30","Otros","8","3","31","61","0","0","31","61","10"
"9","2017","30","Otros","14","31","64","168","126","556","190","724","20.2"
"9","2017","30","Otros","2","29","168","402","130","380","298","782","3.28"
"9","2017","0","Otros","6","25","0","0","0","0","0","0","1"
"9","2017","30","Hotel","15","16","24","53","0","0","24","53","7.8"
"9","2017","30","Hotel","15","27","68","116","2","10","70","126","1"
"9","2017","30","Otros","10","27","2","3","2","3","4","6","4.84"
"9","2017","30","Otros","10","23","31","31","0","0","31","31","7"
"9","2017","30","Otros","6","27","23","41","0","0","23","41","3.960088691796"
"9","2017","30","Otros","16","40","138","198","0","0","138","198","28.142857142857"
"9","2017","30","Otros","11","36","167","199","0","0","167","199","5.1904761904762"
"9","2017","30","Otros","8","34","30","45","11","16","41","61","5.75"
"9","2017","30","Otros","6","12","17","103","0","0","17","103","1.8256578947368"
"9","2017","30","Otros","6","10","116","166","8","8","124","174","3.8518518518518"
"9","2017","30","Hotel","4","21","293","445","9","9","302","454","3"
"9","2017","30","Hotel","11","36","86","276","22","55","108","331","2.375"
"9","2017","30","Otros","5","8","123","159","20","20","143","179","5"
"9","2017","30","Hotel","7","17","80","140","0","0","80","140","10"
"9","2017","24","Hotel","11","36","291","339","18","18","309","357","1"
"9","2017","30","Otros","9","30","15","24","0","0","15","24","2.3333333333333"
"9","2017","30","Hotel","12","35","85","161","87","151","172","312","1.7272727272727"
"9","2017","30","Otros","2","1","90","163","13","21","103","184","5.5"
"9","2017","30","Hotel","6","25","85","153","0","0","85","153","1"
"9","2017","30","Otros","5","5","0","0","7","133","7","133","3.65625"
"9","2017","30","Otros","2","29","33","100","62","158","95","258","3.28"
"9","2017","30","Hotel","2","6","20","21","13","14","33","35","5.5"
"9","2017","30","Otros","7","17","19","27","0","0","19","27","17.166666666667"
"9","2017","30","Hotel","8","2","52","69","8","8","60","77","3"
"9","2017","30","Hotel","13","14","9","9","0","0","9","9","1"
"9","2017","30","Otros","7","38","40","92","8","14","48","106","2.75"
"9","2017","30","Hotel","14","31","10","13","88","242","98","255","24"
"9","2017","30","Hotel","5","5","52","90","5","15","57","105","2.1428571428571"
"9","2017","30","Otros","2","27","1","1","4","4","5","5","3.2"
"9","2017","30","Otros","5","8","31","51","1","1","32","52","5"
"9","2017","30","Otros","3","4","11","28","0","0","11","28","12.2"
"9","2017","30","Otros","13","14","3","6","0","0","3","6","7.3846153846154"
"9","2017","30","Otros","9","37","45","115","0","0","45","115","4.5"
"9","2017","30","Hotel","10","23","672","829","32","51","704","880","1"
"9","2017","30","Otros","11","32","6","7","1","1","7","8","2.2857142857143"
"9","2017","30","Otros","11","15","16","28","0","0","16","28","2.3571428571429"
"9","2017","30","Otros","8","3","24","82","0","0","24","82","10"
"9","2017","30","Otros","16","20","68","242","0","0","68","242","3.0769230769231"
"9","2017","30","Otros","8","3","15","29","0","0","15","29","10"
"9","2017","30","Otros","16","27","37","74","0","0","37","74","2"
"9","2017","30","Hotel","16","19","8","15","0","0","8","15","4"
"9","2017","30","Hotel","16","27","26","67","0","0","26","67","5.8571428571429"
"9","2017","30","Otros","9","26","25","51","0","0","25","51","3.8888888888889"
"9","2017","30","Otros","5","5","20","23","5","7","25","30","3.65625"
"9","2017","30","Otros","14","27","25","30","1","1","26","31","11.833333333333"
"9","2017","30","Hotel","5","5","1","1","0","0","1","1","2.1428571428571"
"9","2017","30","Hotel","12","24","85","251","84","187","169","438","3"
"9","2017","30","Otros","16","27","25","87","0","0","25","87","13.818181818182"
"9","2017","30","Hotel","14","31","25","43","184","421","209","464","1"
"9","2017","30","Otros","8","3","33","112","0","0","33","112","1"
"9","2017","30","Otros","13","27","75","112","0","0","75","112","12.2"
"9","2017","30","Hotel","16","40","27","33","15","31","42","64","16.333333333333"
"9","2017","30","Otros","11","36","40","181","0","0","40","181","1"
"9","2017","30","Otros","10","27","30","32","9","13","39","45","4.84"
"9","2017","30","Otros","9","22","54","83","0","0","54","83","7.6428571428571"
"9","2017","30","Hotel","5","5","45","67","12","22","57","89","2.1428571428571"
"9","2017","30","Otros","2","29","119","526","61","157","180","683","3.28"
"9","2017","30","Otros","2","29","14","29","8","12","22","41","3.28"
"9","2017","30","Hotel","13","14","9","9","0","0","9","9","1"
"9","2017","30","Otros","6","25","7","7","0","0","7","7","2.3846153846154"
"9","2017","30","Otros","2","1","20","24","0","0","20","24","5.5"
"9","2017","30","Hotel","12","27","151","262","0","0","151","262","1"
"9","2017","30","Hotel","13","27","28","28","0","0","28","28","4.2"
"9","2017","30","Otros","6","12","76","188","0","0","76","188","1.8256578947368"
"9","2017","30","Otros","6","27","2","3","0","0","2","3","3.960088691796"
"9","2017","30","Otros","6","25","10","14","0","0","10","14","2.3846153846154"
"9","2017","30","Hotel","6","28","22","66","0","0","22","66","2.5833333333333"
"9","2017","30","Otros","5","5","25","48","7","15","32","63","3.65625"
"9","2017","30","Otros","5","9","6","6","0","0","6","6","4.0454545454545"
"9","2017","30","Otros","5","8","19","29","0","0","19","29","5"
"9","2017","30","Hotel","2","29","45","809","76","166","121","975","1"
"9","2017","30","Otros","5","5","83","177","18","28","101","205","3.65625"
"9","2017","30","Hotel","9","26","10","18","0","0","10","18","1.5"
"9","2017","30","Otros","9","30","10","29","0","0","10","29","2.3333333333333"
"9","2017","30","Otros","11","15","20","40","0","0","20","40","2.3571428571429"
"9","2017","30","Hotel","16","27","1","1","12","20","13","21","5.8571428571429"
"9","2017","30","Otros","9","30","29","59","0","0","29","59","2.3333333333333"
"9","2017","30","Otros","2","29","11","25","17","49","28","74","3.28"
"9","2017","30","Otros","7","38","43","88","14","29","57","117","2.75"
"9","2017","30","Otros","4","21","308","308","0","0","308","308","4.8333333333333"
"9","2017","30","Otros","9","22","31","63","0","0","31","63","7.6428571428571"
"9","2017","30","Otros","9","22","342","957","0","0","342","957","7.6428571428571"
"9","2017","30","Otros","13","27","14","22","0","0","14","22","12.2"
"9","2017","30","Hotel","11","36","1245","1399","38","65","1283","1464","1"
"9","2017","30","Otros","13","33","18","33","0","0","18","33","5.125"
"9","2017","30","Otros","11","36","86","182","24","60","110","242","5.1904761904762"
"9","2017","30","Otros","12","35","24","45","38","90","62","135","3.5"
"9","2017","30","Otros","12","35","17","31","15","24","32","55","3.5"
"9","2017","30","Otros","10","11","23","62","12","24","35","86","11.764705882353"
"9","2017","30","Otros","12","24","10","28","16","25","26","53","9.2"
"9","2017","30","Otros","16","20","28","108","0","0","28","108","3.0769230769231"
"9","2017","30","Hotel","7","27","28","30","5","9","33","39","1"
"9","2017","30","Otros","6","12","18","18","0","0","18","18","1.8256578947368"
"9","2017","30","Otros","11","32","36","84","7","14","43","98","2.2857142857143"
"9","2017","30","Otros","6","28","102","220","0","0","102","220","4.65"
"9","2017","30","Otros","8","34","1","1","0","0","1","1","5.75"
"9","2017","30","Otros","16","27","64","324","0","0","64","324","13.818181818182"
"9","2017","10","Otros","10","11","6","6","0","0","6","6","11.764705882353"
"9","2017","30","Otros","6","10","46","143","2","6","48","149","3.8518518518518"
"9","2017","30","Otros","8","3","50","178","2","3","52","181","10"
"9","2017","30","Hotel","16","20","103","266","0","0","103","266","1"
"9","2017","30","Hotel","11","32","9","9","0","0","9","9","1"
"9","2017","30","Otros","8","27","5","22","7","22","12","44","9.4"
"9","2017","30","Otros","12","27","34","71","2","2","36","73","3.4285714285714"
"9","2017","30","Otros","6","10","75","184","2","2","77","186","3.8518518518518"
"9","2017","30","Otros","6","10","28","138","0","0","28","138","3.8518518518518"
"9","2017","30","Otros","5","8","15","20","0","0","15","20","5"
"9","2017","30","Otros","5","8","14","21","3","3","17","24","5"
"9","2017","30","Hotel","9","26","52","67","3","3","55","70","1.5"
"9","2017","30","Hotel","13","14","25","28","2","2","27","30","1"
"9","2017","30","Otros","10","18","62","185","8","8","70","193","10.25"
"9","2017","30","Otros","8","2","37","40","31","33","68","73","6.4285714285714"
"9","2017","30","Otros","7","27","18","25","0","0","18","25","4.8333333333333"
"9","2017","30","Otros","2","29","6","14","8","23","14","37","3.28"
"9","2017","30","Otros","11","32","35","65","4","4","39","69","2.2857142857143"
"9","2017","30","Otros","9","30","12","30","0","0","12","30","2.3333333333333"
"9","2017","30","Otros","2","29","8","28","5","18","13","46","3.28"
"9","2017","30","Otros","5","5","1","4","0","0","1","4","3.65625"
"9","2017","30","Otros","11","15","5","7","0","0","5","7","2.3571428571429"
"9","2017","30","Otros","10","23","5","5","0","0","5","5","7"
"9","2017","30","Otros","11","36","55","122","7","10","62","132","5.1904761904762"
"9","2017","30","Hotel","3","7","24","28","63","136","87","164","1"
"9","2017","30","Otros","10","27","2","2","0","0","2","2","4.84"
"9","2017","30","Otros","2","27","10","10","0","0","10","10","3.2"
"9","2017","30","Otros","12","35","0","0","2","2","2","2","3.5"
"9","2017","30","Otros","10","27","18","34","2","2","20","36","4.84"
"9","2017","30","Otros","16","40","40","96","97","297","137","393","28.142857142857"
"9","2017","30","Hotel","8","3","245","484","63","107","308","591","4.1111111111111"
"9","2017","30","Otros","9","22","42","106","0","0","42","106","7.6428571428571"
"9","2017","30","Otros","13","14","6","8","0","0","6","8","7.3846153846154"
"9","2017","30","Otros","5","9","15","23","5","5","20","28","4.0454545454545"
"9","2017","30","Otros","10","18","33","90","12","20","45","110","10.25"
"9","2017","30","Otros","6","25","169","280","5","8","174","288","2.3846153846154"
"9","2017","30","Otros","9","22","30","34","0","0","30","34","7.6428571428571"
"9","2017","30","Otros","10","27","29","40","10","15","39","55","4.84"
"9","2017","30","Otros","16","20","34","80","0","0","34","80","3.0769230769231"
"9","2017","30","Hotel","7","17","150","394","0","0","150","394","10"
"9","2017","30","Otros","15","27","54","63","0","0","54","63","1.4222222222222"
"9","2017","30","Otros","12","35","31","55","44","52","75","107","3.5"
"9","2017","30","Otros","12","35","6","26","73","91","79","117","3.5"
"9","2017","30","Otros","3","7","8","16","0","0","8","16","2"
"9","2017","30","Otros","10","11","17","38","7","12","24","50","11.764705882353"
"9","2017","30","Otros","12","24","8","8","0","0","8","8","9.2"
"9","2017","30","Otros","10","23","11","15","0","0","11","15","7"
"9","2017","30","Otros","7","27","21","29","0","0","21","29","4.8333333333333"
"9","2017","30","","10","18","1","1","0","0","1","1","1"
"9","2017","30","Otros","16","27","0","0","2","2","2","2","13.818181818182"
"9","2017","30","Hotel","2","29","3","12","5","21","8","33","1"
"9","2017","30","Otros","14","27","2","12","0","0","2","12","11.833333333333"
"9","2017","30","Otros","11","32","87","118","0","0","87","118","2.2857142857143"
"9","2017","30","Otros","16","19","53","90","18","36","71","126","1"
"9","2017","30","Otros","16","27","17","19","0","0","17","19","13.818181818182"
"9","2017","30","Otros","8","3","27","94","8","16","35","110","10"
"9","2017","30","Otros","16","27","54","96","6","18","60","114","13.818181818182"
"9","2017","30","Otros","16","20","80","203","0","0","80","203","3.0769230769231"
"9","2017","30","Otros","16","40","201","349","16","42","217","391","28.142857142857"
"9","2017","30","Hotel","11","36","57","102","19","35","76","137","2.375"
"9","2017","30","Otros","6","10","89","165","0","0","89","165","3.8518518518518"
"9","2017","30","Otros","7","38","268","336","22","66","290","402","2.75"
"9","2017","30","Otros","13","14","8","16","0","0","8","16","7.3846153846154"
"9","2017","30","Otros","9","30","65","69","0","0","65","69","2.3333333333333"
"9","2017","30","Otros","13","27","7","12","0","0","7","12","12.2"
"9","2017","30","Otros","10","27","12","33","5","5","17","38","4.84"
"9","2017","30","Otros","6","25","25","33","4","4","29","37","2.3846153846154"
"9","2017","30","Otros","9","26","13","13","0","0","13","13","3.8888888888889"
"9","2017","30","Otros","10","18","15","39","8","16","23","55","10.25"
"9","2017","30","Otros","2","29","29","87","0","0","29","87","3.28"
"9","2017","30","Otros","6","25","10","50","0","0","10","50","2.3846153846154"
"9","2017","30","Otros","5","9","12","12","5","5","17","17","4.0454545454545"
"9","2017","30","Otros","5","9","12","12","5","5","17","17","4.0454545454545"
"9","2017","30","Hotel","9","37","70","115","4","18","74","133","3.4"
"9","2017","30","Hotel","7","38","151","322","14","41","165","363","1"
"9","2017","30","Otros","7","27","49","59","0","0","49","59","4.8333333333333"
"9","2017","30","Otros","5","9","15","23","5","5","20","28","4.0454545454545"
"9","2017","30","Otros","10","27","4","4","2","2","6","6","4.84"
"9","2017","30","Otros","7","27","18","24","2","2","20","26","4.8333333333333"
"9","2017","30","Otros","16","40","42","54","27","63","69","117","28.142857142857"
"9","2017","30","Otros","10","23","31","31","0","0","31","31","7"
"9","2017","30","Otros","15","16","79","170","12","18","91","188","9"
"9","2017","28","Otros","3","7","3","10","65","180","68","190","2"
"9","2017","30","Otros","7","17","30","91","0","0","30","91","17.166666666667"
"9","2017","30","Otros","8","27","42","71","2","2","44","73","9.4"
"9","2017","30","Otros","9","22","92","213","0","0","92","213","7.6428571428571"
"9","2017","30","Otros","16","19","15","45","0","0","15","45","10.263157894737"
"9","2017","0","","15","27","0","0","0","0","0","0","1"
"9","2017","30","Hotel","10","11","13","13","2","2","15","15","5.6666666666667"
"9","2017","30","Otros","2","27","5","75","0","0","5","75","3.2"
"9","2017","30","Otros","8","2","53","67","41","50","94","117","6.4285714285714"
"9","2017","30","Otros","5","5","6","7","0","0","6","7","3.65625"
"9","2017","30","Otros","12","35","1","1","0","0","1","1","3.5"
"9","2017","30","Otros","8","3","9","18","0","0","9","18","10"
"9","2017","30","Otros","12","24","27","47","50","115","77","162","9.2"
"9","2017","30","Otros","11","32","22","100","2","6","24","106","2.2857142857143"
"9","2017","30","Otros","10","27","32","71","21","25","53","96","4.84"
"9","2017","30","Otros","11","15","24","72","0","0","24","72","2.3571428571429"
"9","2017","30","Otros","5","8","5","10","3","6","8","16","5"
"9","2017","30","Otros","14","27","11","11","0","0","11","11","11.833333333333"
"9","2017","30","Otros","13","27","159","217","0","0","159","217","12.2"
"9","2017","30","Hotel","10","18","78","78","173","173","251","251","3.2"
"9","2017","30","Otros","10","27","8","8","0","0","8","8","4.84"
"9","2017","30","Otros","11","32","23","30","0","0","23","30","1"
"9","2017","30","Otros","9","37","38","153","0","0","38","153","4.5"
"9","2017","30","Otros","12","35","25","35","68","93","93","128","3.5"
"9","2017","30","Otros","8","34","110","158","48","76","158","234","5.75"
"9","2017","30","Hotel","16","40","19","27","28","71","47","98","16.333333333333"
"9","2017","30","Hotel","10","11","66","122","2","2","68","124","5.6666666666667"
"9","2017","30","Otros","7","27","27","55","0","0","27","55","4.8333333333333"
"9","2017","30","Hotel","7","38","12","18","0","0","12","18","1"
"9","2017","30","Otros","6","27","7","22","0","0","7","22","3.960088691796"
"9","2017","30","Otros","6","10","40","110","0","0","40","110","3.8518518518518"
"9","2017","15","Otros","6","25","55","102","0","0","55","102","1"
"9","2017","30","Otros","6","25","21","32","0","0","21","32","2.3846153846154"
"9","2017","30","Otros","6","27","23","29","0","0","23","29","3.960088691796"
"9","2017","30","Otros","6","27","68","232","0","0","68","232","3.960088691796"
"9","2017","30","Otros","5","5","8","15","2","6","10","21","3.65625"
"9","2017","30","Otros","5","5","4","32","0","0","4","32","3.65625"
"9","2017","30","Otros","3","4","10","10","3","3","13","13","12.2"
"9","2017","30","Otros","10","23","2","2","0","0","2","2","7"
"9","2017","30","Otros","8","3","2","4","0","0","2","4","10"
"9","2017","30","Otros","5","5","21","45","20","40","41","85","3.65625"
"9","2017","30","Otros","5","8","32","32","0","0","32","32","5"
"9","2017","30","Otros","6","10","43","146","0","0","43","146","3.8518518518518"
"9","2017","30","Otros","16","19","22","65","0","0","22","65","10.263157894737"
"9","2017","30","Otros","11","15","26","33","0","0","26","33","2.3571428571429"
"9","2017","30","Otros","7","38","44","57","0","0","44","57","2.75"
"9","2017","30","Otros","11","32","91","180","14","14","105","194","2.2857142857143"
"9","2017","30","Otros","8","2","47","100","0","0","47","100","6.4285714285714"
"9","2017","30","Otros","10","27","14","29","6","10","20","39","4.84"
"9","2017","30","Otros","6","27","21","32","0","0","21","32","3.960088691796"
"9","2017","30","Otros","11","32","35","65","4","4","39","69","2.2857142857143"
"9","2017","30","Otros","8","34","27","27","7","9","34","36","5.75"
"9","2017","30","Otros","11","32","10","13","4","5","14","18","2.2857142857143"
"9","2017","30","Otros","10","11","4","8","0","0","4","8","11.764705882353"
"9","2017","30","Otros","11","32","8","10","0","0","8","10","2.2857142857143"
"9","2017","30","Otros","14","31","0","0","8","14","8","14","20.2"
"9","2017","30","Hotel","14","31","153","250","638","2421","791","2671","17.4"
"9","2017","30","Otros","11","36","141","286","34","79","175","365","5.1904761904762"
"9","2017","30","Hotel","15","16","945","2045","195","420","1140","2465","2"
"9","2017","30","Otros","15","27","2","28","0","0","2","28","1.4222222222222"
"9","2017","30","Otros","5","5","17","20","7","7","24","27","3.65625"
"9","2017","30","Otros","8","34","6","6","7","7","13","13","5.75"
"9","2017","30","Otros","7","27","22","69","0","0","22","69","4.8333333333333"
"9","2017","30","Otros","12","35","17","31","15","24","32","55","3.5"
"9","2017","30","Otros","5","5","55","135","1","1","56","136","3.65625"
"9","2017","30","Otros","10","11","1","1","0","0","1","1","11.764705882353"
"9","2017","30","Otros","10","11","1","2","0","0","1","2","11.764705882353"
"9","2017","30","Otros","9","30","11","220","0","0","11","220","2.3333333333333"
"9","2017","30","Otros","8","2","43","103","0","0","43","103","6.4285714285714"
"9","2017","30","Otros","10","27","54","66","28","35","82","101","4.84"
"9","2017","30","Otros","5","9","15","23","5","5","20","28","4.0454545454545"
"9","2017","30","Otros","6","27","4","4","0","0","4","4","3.960088691796"
"9","2017","30","Otros","6","10","120","283","33","116","153","399","3.8518518518518"
"9","2017","30","Otros","6","10","55","152","0","0","55","152","3.8518518518518"
"9","2017","30","Otros","6","27","19","19","0","0","19","19","3.960088691796"
"9","2017","15","Otros","6","12","5","52","0","0","5","52","1.8256578947368"
"9","2017","30","Otros","6","10","42","96","0","0","42","96","3.8518518518518"
"9","2017","30","Otros","6","10","28","54","0","0","28","54","3.8518518518518"
"9","2017","30","Otros","6","27","3","3","0","0","3","3","3.960088691796"
"9","2017","30","Otros","6","12","34","36","0","0","34","36","1.8256578947368"
"9","2017","30","Otros","6","10","16","43","0","0","16","43","3.8518518518518"
"9","2017","30","Hotel","6","25","60","117","0","0","60","117","1"
"9","2017","30","Otros","6","27","1","1","0","0","1","1","3.960088691796"
"9","2017","30","Otros","5","9","17","33","5","8","22","41","4.0454545454545"
"9","2017","30","Otros","5","5","20","48","14","32","34","80","3.65625"
"9","2017","30","Otros","5","5","9","9","1","2","10","11","3.65625"
"9","2017","30","Otros","5","5","32","39","22","40","54","79","3.65625"
"9","2017","30","Otros","11","36","55","93","0","0","55","93","5.1904761904762"
"9","2017","30","Hotel","6","10","782","2346","194","719","976","3065","1"
"9","2017","30","Otros","5","9","15","23","5","5","20","28","4.0454545454545"
"9","2017","30","Otros","5","8","8","18","19","28","27","46","5"
"9","2017","0","Hotel","15","27","0","0","0","0","0","0","1"
"9","2017","30","Hotel","14","31","9","135","99","1482","108","1617","1"
"9","2017","30","Hotel","3","4","337","1926","12","52","349","1978","3"
"9","2017","30","Otros","3","7","28","28","26","28","54","56","1"
"9","2017","30","Otros","7","38","140","289","0","0","140","289","2.75"
"9","2017","30","Hotel","10","27","13","17","0","0","13","17","1"
"9","2017","30","Hotel","12","35","1","1","29","29","30","30","1.7272727272727"
"9","2017","30","Hotel","10","27","7","7","0","0","7","7","2.25"
"9","2017","30","Hotel","7","17","723","1344","73","138","796","1482","4"
"9","2017","30","Hotel","16","19","15","17","0","0","15","17","4"
"9","2017","30","Hotel","2","6","227","227","0","0","227","227","2.2"
"9","2017","30","Otros","5","5","58","228","2","22","60","250","3.65625"
"9","2017","30","Otros","12","24","87","97","126","148","213","245","9.2"
"9","2017","30","Otros","5","8","11","15","0","0","11","15","5"
"9","2017","30","Otros","4","13","154","501","16","16","170","517","1"
"9","2017","30","Otros","10","11","80","80","0","0","80","80","11.764705882353"
"9","2017","30","Otros","12","35","10","54","31","133","41","187","3.5"
"9","2017","30","Otros","10","23","67","68","1","1","68","69","7"
"9","2017","30","Otros","11","36","465","907","63","148","528","1055","5.1904761904762"
"9","2017","30","Otros","12","35","29","52","7","10","36","62","3.5"
"9","2017","30","Otros","11","36","50","110","4","8","54","118","5.1904761904762"
"9","2017","30","Otros","8","2","47","196","18","82","65","278","6.4285714285714"
"9","2017","30","Otros","9","30","23","57","0","0","23","57","2.3333333333333"
"9","2017","30","Otros","11","36","47","176","0","0","47","176","5.1904761904762"
"9","2017","30","Otros","6","10","14","32","0","0","14","32","3.8518518518518"
"9","2017","30","Otros","10","18","30","50","0","0","30","50","10.25"
"9","2017","30","Otros","7","27","27","108","2","4","29","112","4.8333333333333"
"9","2017","30","Otros","16","20","32","128","0","0","32","128","1"
"9","2017","30","Otros","9","22","25","50","0","0","25","50","7.6428571428571"
"9","2017","30","Otros","5","5","154","208","9","21","163","229","3.65625"
"9","2017","30","Otros","12","35","17","31","15","24","32","55","3.5"
"9","2017","30","Otros","10","11","0","0","3","3","3","3","11.764705882353"
"9","2017","30","Otros","10","11","3","19","0","0","3","19","11.764705882353"
"9","2017","19","Otros","5","9","21","43","0","0","21","43","4.0454545454545"
"9","2017","30","Otros","5","5","15","37","4","8","19","45","3.65625"
"9","2017","30","Otros","12","35","0","0","2","5","2","5","3.5"
"9","2017","30","Otros","7","38","112","288","8","14","120","302","2.75"
"9","2017","30","Hotel","12","35","4","8","14","23","18","31","1.7272727272727"
"9","2017","30","Otros","13","14","24","38","0","0","24","38","1"
"9","2017","30","Otros","5","5","6","11","0","0","6","11","3.65625"
"9","2017","30","Hotel","14","31","18","265","352","5271","370","5536","1"
"9","2017","30","Hotel","14","31","7","111","265","2673","272","2784","1"
"9","2017","30","Hotel","9","26","4","6","0","0","4","6","1.5"
"9","2017","30","Hotel","16","19","20","42","0","0","20","42","1"
"9","2017","30","Otros","16","19","126","268","0","0","126","268","10.263157894737"
"9","2017","30","Otros","9","30","30","44","0","0","30","44","2.3333333333333"
"9","2017","30","Otros","16","19","57","109","0","0","57","109","10.263157894737"
"9","2017","30","Otros","16","19","41","153","0","0","41","153","10.263157894737"
"9","2017","30","Otros","9","26","9","10","0","0","9","10","3.8888888888889"
"9","2017","30","Otros","16","40","6","8","0","0","6","8","28.142857142857"
"9","2017","30","Hotel","16","27","21","34","0","0","21","34","5.8571428571429"
"9","2017","30","Otros","16","19","17","31","0","0","17","31","10.263157894737"
"9","2017","30","Otros","16","19","57","114","0","0","57","114","10.263157894737"
"9","2017","30","","9","30","88","217","10","23","98","240","1"
"9","2017","30","Otros","16","19","26","35","0","0","26","35","10.263157894737"
"9","2017","30","Otros","10","11","3","3","0","0","3","3","11.764705882353"
"9","2017","30","Otros","11","36","18","18","0","0","18","18","5.1904761904762"
"9","2017","30","Otros","16","19","10","46","0","0","10","46","10.263157894737"
"9","2017","30","Otros","16","19","158","244","0","0","158","244","1.3333333333333"
"9","2017","30","Otros","16","19","21","22","0","0","21","22","10.263157894737"
"9","2017","30","Otros","10","18","23","67","12","19","35","86","10.25"
"9","2017","30","Otros","16","19","13","26","0","0","13","26","10.263157894737"
"9","2017","30","Otros","16","19","1","1","0","0","1","1","1.3333333333333"
"9","2017","30","","9","26","348","2065","0","0","348","2065","1"
"9","2017","30","Otros","16","19","2","2","0","0","2","2","10.263157894737"
"9","2017","30","Otros","16","19","33","48","2","4","35","52","10.263157894737"
"9","2017","30","Hotel","8","2","331","1116","332","1903","663","3019","1"
"9","2017","30","Otros","6","10","6","10","0","0","6","10","3.8518518518518"
"9","2017","30","Otros","6","12","16","16","0","0","16","16","1.8256578947368"
"9","2017","30","Hotel","16","19","35","73","0","0","35","73","1"
"9","2017","30","Otros","3","7","14","14","14","14","28","28","2"
"9","2017","30","Hotel","2","6","2023","3208","117","292","2140","3500","1"
"9","2017","30","Hotel","3","4","435","767","37","62","472","829","2.6"
"9","2017","30","Hotel","16","40","2030","3306","813","1230","2843","4536","1"
"9","2017","30","Otros","16","27","71","85","0","0","71","85","13.818181818182"
"9","2017","30","Hotel","6","28","183","273","28","38","211","311","2.4"
"9","2017","30","Hotel","8","34","982","1694","267","328","1249","2022","1"
"9","2017","30","Otros","9","30","1","10","0","0","1","10","2.3333333333333"
"9","2017","30","Hotel","10","18","73","73","216","216","289","289","1"
"9","2017","30","Hotel","9","30","107","309","0","0","107","309","1"
"9","2017","30","Hotel","15","27","9","9","0","0","9","9","1"
"9","2017","30","Hotel","9","22","111","807","0","0","111","807","2.5555555555556"
"9","2017","30","Hotel","6","10","197","325","16","110","213","435","1"
"9","2017","30","","11","15","10","11","0","0","10","11","1"
"9","2017","30","Otros","6","12","7","7","0","0","7","7","1.8256578947368"
"9","2017","30","Hotel","15","27","30","900","0","0","30","900","1"
"9","2017","30","Otros","15","27","142","237","0","0","142","237","1.4222222222222"
"9","2017","30","Otros","15","27","15","30","0","0","15","30","1.4222222222222"
"9","2017","30","Otros","2","1","25","25","0","0","25","25","1"
"9","2017","30","Otros","12","24","3","5","1","1","4","6","9.2"
"9","2017","30","Otros","5","5","4","6","2","6","6","12","3.65625"
"9","2017","30","Hotel","7","27","118","132","18","18","136","150","1"
"9","2017","30","Otros","16","20","53","73","2","2","55","75","3.0769230769231"
"9","2017","0","","10","11","0","0","0","0","0","0","1"
"9","2017","30","Hotel","16","40","31","31","15","25","46","56","16.333333333333"
"9","2017","30","Otros","12","35","5","7","0","0","5","7","3.5"
"9","2017","30","Hotel","6","27","16","16","2","2","18","18","3"
"9","2017","30","Otros","5","5","10","10","3","3","13","13","3.65625"
"9","2017","30","Hotel","6","27","34","42","0","0","34","42","3"
"9","2017","30","Otros","6","25","32","53","5","5","37","58","2.3846153846154"
"9","2017","0","Hotel","15","27","0","0","0","0","0","0","1"
"9","2017","30","Otros","5","9","36","62","18","36","54","98","4.0454545454545"
"9","2017","30","Hotel","15","27","75","135","0","0","75","135","1"
"9","2017","0","Hotel","5","9","0","0","0","0","0","0","1"
"9","2017","30","Hotel","8","34","42","99","46","232","88","331","2.5714285714286"
"9","2017","30","Hotel","15","27","0","0","0","0","0","0","1"
"9","2017","30","Hotel","6","27","303","669","0","0","303","669","3"
"9","2017","0","Otros","6","27","0","0","0","0","0","0","1"
"9","2017","30","Otros","12","27","0","0","85","85","85","85","3.4285714285714"
"9","2017","30","Hotel","2","27","246","654","106","327","352","981","1"
"9","2017","30","Hotel","2","6","115","142","0","0","115","142","1"
"9","2017","30","Otros","2","6","31","48","0","0","31","48","1"
"9","2017","30","Hotel","4","39","153","153","0","0","153","153","1"
"9","2017","30","Hotel","6","10","1335","2031","0","0","1335","2031","1"
"9","2017","30","Otros","5","8","10","14","4","4","14","18","5"
"9","2017","0","Hotel","13","33","0","0","0","0","0","0","1"
"9","2017","30","Hotel","13","33","152","305","12","24","164","329","1"
"9","2017","30","Otros","11","32","156","438","19","30","175","468","2.2857142857143"
"9","2017","30","Hotel","9","26","386","835","416","964","802","1799","1"
"9","2017","30","Hotel","16","20","85","122","2","2","87","124","1"
"9","2017","30","Otros","16","20","2","4","0","0","2","4","3.0769230769231"
"9","2017","30","","16","40","864","1650","2","2","866","1652","1"
"9","2017","30","Hotel","15","16","1444","2917","184","449","1628","3366","1"
"9","2017","30","Hotel","16","27","0","0","0","0","0","0","1"
"9","2017","30","Hotel","5","9","13","26","2","12","15","38","1"
"9","2017","30","Otros","7","38","88","204","0","0","88","204","2.75"
"9","2017","30","Otros","2","6","1835","1835","0","0","1835","1835","1"
"9","2017","30","Otros","2","6","133","197","0","0","133","197","1"
"9","2017","30","Hotel","15","27","190","679","11","23","201","702","1"
"9","2017","30","Otros","7","38","62","108","0","0","62","108","2.75"
"9","2017","30","Otros","2","1","18","83","7","13","25","96","1"
"9","2017","30","Otros","8","3","50","178","2","3","52","181","10"
"9","2017","30","Otros","11","36","10","18","0","0","10","18","5.1904761904762"
"9","2017","30","Otros","16","20","74","176","0","0","74","176","3.0769230769231"
"9","2017","30","Otros","8","3","326","577","0","0","326","577","1"
"9","2017","30","Otros","4","39","251","306","5","5","256","311","2.2222222222222"
"9","2017","30","Otros","5","5","112","239","40","98","152","337","3.65625"
"9","2017","30","Otros","12","27","0","0","29","30","29","30","3.4285714285714"
"9","2017","30","Otros","7","27","153","504","0","0","153","504","1"
"9","2017","30","Hotel","2","6","169","444","8","30","177","474","1"
"9","2017","30","Hotel","14","27","496","1796","128","181","624","1977","1"
"9","2017","30","Hotel","16","19","699","1189","0","0","699","1189","1"
"9","2017","30","","2","1","24","336","0","0","24","336","1"
"9","2017","30","Hotel","2","27","120","251","4","4","124","255","1"
"9","2017","30","Otros","16","20","82","102","0","0","82","102","1"
"9","2017","0","Otros","13","14","0","0","0","0","0","0","1"
"9","2017","30","Hotel","11","36","134","206","5","5","139","211","2.375"
"9","2017","30","Otros","13","14","4","104","0","0","4","104","7.3846153846154"
"9","2017","30","Otros","12","27","16","25","2","6","18","31","3.4285714285714"
"9","2017","30","Hotel","2","6","196","263","0","0","196","263","2.2"
"9","2017","30","Otros","2","6","254","950","0","0","254","950","1"
"9","2017","30","Otros","10","27","5","150","2","2","7","152","4.84"
"9","2017","30","Otros","12","27","5","6","7","7","12","13","3.4285714285714"
"9","2017","30","Otros","13","14","35","51","0","0","35","51","7.3846153846154"
"9","2017","30","Otros","6","12","84","126","41","70","125","196","1.8256578947368"
"9","2017","30","Otros","2","6","1194","1829","74","172","1268","2001","1"
"9","2017","30","Hotel","12","35","16","22","3","4","19","26","1.7272727272727"
"9","2017","30","Otros","5","5","14","31","2","8","16","39","3.65625"
"9","2017","30","Otros","9","30","0","0","8","240","8","240","2.3333333333333"
"9","2017","30","Hotel","8","2","7","15","9","17","16","32","1"
"9","2017","30","Otros","9","30","2","31","0","0","2","31","2.3333333333333"
"9","2017","30","Hotel","15","27","19","27","4","4","23","31","1"
"9","2017","30","Hotel","3","7","19","19","0","0","19","19","1"
"9","2017","30","Otros","6","12","450","719","0","0","450","719","1.8256578947368"
"9","2017","30","Otros","12","27","27","44","5","6","32","50","3.4285714285714"
"9","2017","30","Otros","2","6","9","62","0","0","9","62","5"
"9","2017","30","Otros","6","27","7","7","0","0","7","7","3.960088691796"
"9","2017","30","Hotel","10","11","49","67","3","3","52","70","1"
"9","2017","30","Otros","2","1","20","40","0","0","20","40","1"
"9","2017","30","Otros","11","36","25","25","0","0","25","25","5.1904761904762"
"9","2017","30","Hotel","11","32","0","0","0","0","0","0","1"
"9","2017","30","Otros","2","27","5","150","0","0","5","150","1"
"9","2017","30","Otros","12","27","6","6","0","0","6","6","3.4285714285714"
"9","2017","30","Hotel","8","2","76","125","2","4","78","129","3"
"9","2017","30","Hotel","16","20","48","50","2","2","50","52","1"
"9","2017","30","Otros","12","35","28","68","54","96","82","164","3.5"
"9","2017","30","Otros","13","14","21","31","0","0","21","31","1"
"9","2017","30","Otros","2","27","69","109","0","0","69","109","3.2"
"9","2017","30","Hotel","6","27","21","21","0","0","21","21","3"
"9","2017","30","Hotel","8","3","59","146","15","32","74","178","4.1111111111111"
"9","2017","25","Hotel","15","27","16","400","0","0","16","400","1"
"9","2017","30","Otros","8","3","16","60","0","0","16","60","10"
"9","2017","30","Hotel","16","20","9","19","0","0","9","19","1"
"9","2017","30","Hotel","6","28","98","138","0","0","98","138","2.4"
"9","2017","30","Otros","2","1","25","87","3","8","28","95","5.5"
"9","2017","30","Hotel","11","36","52","91","42","61","94","152","2.375"
"9","2017","30","Otros","4","13","46","56","0","0","46","56","1"
"9","2017","0","Otros","2","6","0","0","0","0","0","0","1"
"9","2017","30","Otros","8","34","144","182","78","112","222","294","5.75"
"9","2017","30","Hotel","11","15","0","0","0","0","0","0","1"
"9","2017","30","Otros","15","27","11","13","0","0","11","13","1.4222222222222"
"9","2017","30","Hotel","13","14","101","163","4","10","105","173","1"
"9","2017","30","Hotel","13","14","173","300","18","27","191","327","1"
"9","2017","30","Hotel","9","30","84","137","12","17","96","154","1"
"9","2017","30","Hotel","4","13","339","613","21","70","360","683","5.4"
"9","2017","30","Otros","6","27","5","16","0","0","5","16","3.960088691796"
"9","2017","0","Hotel","15","27","0","0","0","0","0","0","1"
"9","2017","30","Hotel","2","29","10","27","64","229","74","256","2"
"9","2017","30","Hotel","13","33","13","21","2","4","15","25","2"
"9","2017","30","Hotel","12","35","27","27","8","8","35","35","1.7272727272727"
"9","2017","30","Hotel","13","14","210","354","2","8","212","362","1"
"9","2017","30","Otros","6","25","35","48","0","0","35","48","2.3846153846154"
"9","2017","30","Hotel","8","2","14","23","4","8","18","31","3"
"9","2017","30","Otros","4","39","202","359","0","0","202","359","2.2222222222222"
"9","2017","30","Otros","6","12","106","140","17","40","123","180","1.8256578947368"
"9","2017","30","Otros","13","33","73","104","6","6","79","110","5.125"
"9","2017","30","Hotel","4","13","110","248","15","24","125","272","5.4"
"9","2017","30","Hotel","7","27","120","548","2","2","122","550","4.1666666666667"
"9","2017","30","Hotel","4","13","915","2568","57","100","972","2668","1"
"9","2017","30","","5","8","13","25","0","0","13","25","1"
"9","2017","30","Otros","8","2","14","16","0","0","14","16","6.4285714285714"
"9","2017","30","Otros","2","6","4","4","2","2","6","6","1"
"9","2017","30","","6","10","58","156","0","0","58","156","1"
"9","2017","30","Hotel","2","29","65","119","67","99","132","218","2"
"9","2017","30","","14","31","91","175","463","1823","554","1998","1"
"9","2017","30","Hotel","16","27","4036","12109","0","0","4036","12109","1"
"9","2017","30","Hotel","12","35","48","74","37","73","85","147","1.7272727272727"
"9","2017","30","","12","35","147","189","444","569","591","758","1"
"9","2017","30","","9","26","129","149","14","16","143","165","1"
"9","2017","30","Otros","11","32","81","144","0","0","81","144","2.2857142857143"
"9","2017","30","Otros","12","24","9","18","53","74","62","92","9.2"
"9","2017","30","Hotel","6","25","33","93","0","0","33","93","1"
"9","2017","30","Otros","11","32","14","30","2","2","16","32","2.2857142857143"
"9","2017","30","Hotel","16","19","104","160","1","1","105","161","4"
"9","2017","30","Otros","13","33","38","51","1","1","39","52","5.125"
"9","2017","30","Otros","16","27","16","55","3","34","19","89","13.818181818182"
"9","2017","30","Otros","6","12","69","93","4","4","73","97","1.8256578947368"
"9","2017","30","Otros","2","29","20","58","0","0","20","58","3.28"
"9","2017","30","Hotel","14","27","234","306","128","184","362","490","1"
"9","2017","30","Otros","2","1","150","2100","0","0","150","2100","1"
"9","2017","30","Otros","11","32","13","18","2","2","15","20","2.2857142857143"
"9","2017","30","Otros","2","27","67","67","6","6","73","73","1"
"9","2017","30","Hotel","2","29","89","353","24","85","113","438","1"
"9","2017","30","Hotel","4","13","60","591","0","0","60","591","3.2"
"9","2017","30","Hotel","4","21","52","106","20","30","72","136","3"
"9","2017","30","Otros","7","27","128","201","2","3","130","204","4.8333333333333"
"9","2017","30","","3","4","86","157","52","74","138","231","1"
"9","2017","30","Hotel","6","27","16","22","8","8","24","30","3"
"9","2017","30","Otros","16","19","4","8","0","0","4","8","10.263157894737"
"9","2017","30","Otros","11","32","6","7","0","0","6","7","2.2857142857143"
"9","2017","30","Otros","3","7","59","79","70","150","129","229","2"
"9","2017","30","Otros","5","5","11","23","7","14","18","37","3.65625"
"9","2017","24","Otros","15","27","1335","2364","0","0","1335","2364","1.4222222222222"
"9","2017","30","Otros","6","25","36","167","0","0","36","167","2.3846153846154"
"9","2017","30","","10","27","25","34","0","0","25","34","1"
"9","2017","30","Otros","2","29","46","94","166","260","212","354","3.28"
"9","2017","30","Otros","12","35","7","7","2","5","9","12","3.5"
"9","2017","30","Otros","16","19","27","60","0","0","27","60","10.263157894737"
"9","2017","30","Otros","9","26","53","53","0","0","53","53","3.8888888888889"
"9","2017","30","Hotel","13","33","44","44","2","2","46","46","2"
"9","2017","27","Otros","11","32","2","4","0","0","2","4","2.2857142857143"
"9","2017","30","Otros","9","22","17","45","0","0","17","45","7.6428571428571"
"9","2017","30","Otros","6","27","80","80","0","0","80","80","3.960088691796"
"9","2017","30","Otros","15","27","157","267","0","0","157","267","1.4222222222222"
"9","2017","30","Otros","11","32","40","48","5","5","45","53","2.2857142857143"
"9","2017","30","Otros","11","15","29","29","0","0","29","29","2.3571428571429"
"9","2017","30","Otros","9","37","4","26","0","0","4","26","4.5"
"9","2017","30","Otros","5","9","12","21","5","10","17","31","4.0454545454545"
"9","2017","30","Hotel","10","27","10","200","0","0","10","200","2.25"
"9","2017","30","Otros","6","28","47","263","0","0","47","263","4.65"
"9","2017","30","Otros","4","13","66","119","26","31","92","150","3.4"
"9","2017","30","Otros","2","1","1","1","0","0","1","1","1"
"9","2017","30","Otros","2","29","35","65","53","126","88","191","3.28"
"9","2017","30","Hotel","8","3","27","61","3","3","30","64","4.1111111111111"
"9","2017","30","Otros","16","19","156","607","0","0","156","607","1.3333333333333"
"9","2017","30","Otros","12","35","19","37","32","38","51","75","3.5"
"9","2017","30","Hotel","12","35","34","63","32","60","66","123","1.7272727272727"
"9","2017","30","Otros","12","35","7","8","4","4","11","12","3.5"
"9","2017","30","Otros","2","29","54","200","23","62","77","262","3.28"
"9","2017","30","Hotel","7","27","103","177","3","3","106","180","1"
"9","2017","30","Hotel","9","22","35","44","1","1","36","45","2.5555555555556"
"9","2017","30","Hotel","12","35","30","50","65","149","95","199","1.7272727272727"
"9","2017","30","Otros","15","16","74","185","10","10","84","195","2"
"9","2017","30","Hotel","15","27","22","44","0","0","22","44","1"
"9","2017","30","Otros","4","13","71","75","0","0","71","75","3.4"
"9","2017","30","Hotel","8","34","71","102","42","75","113","177","2.5714285714286"
"9","2017","30","Hotel","16","20","125","295","0","0","125","295","1"
"9","2017","30","Hotel","6","28","196","221","38","57","234","278","2.4"
"9","2017","30","Hotel","15","27","92","201","8","8","100","209","1"
"9","2017","30","Otros","12","35","117","200","29","106","146","306","3.5"
"9","2017","30","Otros","11","15","17","17","0","0","17","17","2.3571428571429"
"9","2017","30","Otros","11","15","7","12","1","4","8","16","2.3571428571429"
"9","2017","30","Otros","11","36","101","148","60","90","161","238","5.1904761904762"
"9","2017","30","Hotel","11","36","34","124","0","0","34","124","2.375"
"9","2017","30","Hotel","6","12","102","196","0","0","102","196","5"
"9","2017","30","Otros","8","3","45","58","11","11","56","69","10"
"9","2017","30","Otros","10","27","51","86","59","74","110","160","4.84"
"9","2017","30","Otros","8","3","12","21","0","0","12","21","10"
"9","2017","30","Otros","6","25","27","44","0","0","27","44","2.3846153846154"
"9","2017","30","Hotel","2","27","57","103","2","9","59","112","1"
"9","2017","30","Hotel","10","18","0","0","146","416","146","416","3.2"
"9","2017","30","Otros","11","32","67","159","2","6","69","165","1"
"9","2017","30","Hotel","6","10","971","1300","76","200","1047","1500","1"
"9","2017","30","Otros","11","32","55","83","0","0","55","83","2.2857142857143"
"9","2017","0","Otros","2","27","0","0","0","0","0","0","1"
"9","2017","0","","12","24","0","0","0","0","0","0","1"
"9","2017","30","Hotel","16","27","759","884","3","12","762","896","5.8571428571429"
"9","2017","30","Hotel","7","38","36","47","0","0","36","47","1"
"9","2017","30","Hotel","6","12","2637","2673","56","71","2693","2744","1"
"10","2017","31","Hotel","14","31","2332","3114","9694","11844","12026","14958","1"
"10","2017","31","Hotel","14","31","570","1031","3193","10335","3763","11366","1"
"10","2017","31","Hotel","14","31","778","962","996","3442","1774","4404","1"
"10","2017","31","Hotel","11","32","0","0","52","109","52","109","1"
"10","2017","31","Hotel","14","27","4066","5470","833","1120","4899","6590","1"
"10","2017","31","Otros","11","32","50","93","6","12","56","105","2.2857142857143"
"10","2017","31","Hotel","14","31","295","418","4537","5511","4832","5929","5.4"
"10","2017","31","Hotel","15","16","1143","3207","71","142","1214","3349","1"
"10","2017","31","Hotel","14","31","807","1435","1495","5549","2302","6984","5.4"
"10","2017","31","Hotel","12","24","2385","3297","2455","3479","4840","6776","1"
"10","2017","31","Hotel","16","40","1788","3082","551","1114","2339","4196","1"
"10","2017","31","Hotel","6","12","1139","1934","112","238","1251","2172","1"
"10","2017","31","Hotel","10","23","1255","1977","158","297","1413","2274","1"
"10","2017","31","Hotel","14","31","1713","3946","351","810","2064","4756","5.4"
"10","2017","31","Hotel","3","4","714","1929","283","2525","997","4454","1"
"10","2017","31","","11","32","574","904","18","37","592","941","1"
"10","2017","31","Hotel","6","12","895","1834","46","147","941","1981","1"
"10","2017","31","Hotel","6","12","2195","3323","155","440","2350","3763","1"
"10","2017","31","Hotel","9","26","3378","6669","78","151","3456","6820","1"
"10","2017","31","Hotel","2","1","917","2254","47","303","964","2557","1"
"10","2017","31","Hotel","9","26","1350","1988","221","770","1571","2758","1"
"10","2017","31","Hotel","6","12","257","401","48","77","305","478","1"
"10","2017","31","Hotel","14","31","81","94","4332","8608","4413","8702","5.4"
"10","2017","31","Hotel","11","32","356","552","26","54","382","606","1"
"10","2017","31","Hotel","2","6","1638","2243","121","363","1759","2606","1"
"10","2017","31","Hotel","16","40","1776","3325","887","1394","2663","4719","1"
"10","2017","31","Hotel","14","27","1426","2961","617","1694","2043","4655","1"
"10","2017","31","Otros","11","36","214","710","0","0","214","710","1"
"10","2017","31","Hotel","10","23","1022","1500","1022","1500","2044","3000","1"
"10","2017","31","Hotel","14","31","380","962","723","3684","1103","4646","7.8"
"10","2017","31","Hotel","7","17","711","1241","105","335","816","1576","1"
"10","2017","31","Hotel","2","1","2370","2848","272","314","2642","3162","2"
"10","2017","31","Hotel","2","1","2215","3409","319","651","2534","4060","2"
"10","2017","31","Hotel","4","13","736","1318","368","672","1104","1990","1"
"10","2017","31","Hotel","2","1","1045","2142","149","239","1194","2381","2"
"10","2017","31","Hotel","10","27","1212","2881","1102","1806","2314","4687","1"
"10","2017","31","Hotel","14","27","925","1646","1117","2036","2042","3682","1"
"10","2017","31","Hotel","14","27","1900","2722","1125","2564","3025","5286","1"
"10","2017","31","Hotel","6","12","2117","2460","67","161","2184","2621","1"
"10","2017","31","Hotel","6","12","2015","2734","623","695","2638","3429","1"
"10","2017","31","Hotel","13","27","2446","5027","15","41","2461","5068","1"
"10","2017","31","Hotel","14","31","383","1219","565","1955","948","3174","7.8"
"10","2017","31","Hotel","6","12","1798","3035","367","621","2165","3656","1"
"10","2017","31","Hotel","16","27","2453","4507","230","387","2683","4894","1"
"10","2017","31","","10","27","24","32","16","28","40","60","1"
"10","2017","31","Hotel","10","18","711","1419","601","1340","1312","2759","1"
"10","2017","31","Hotel","9","37","1887","3018","307","592","2194","3610","1"
"10","2017","31","Hotel","16","27","1320","4921","0","0","1320","4921","1"
"10","2017","31","Hotel","15","16","1082","2071","114","283","1196","2354","2"
"10","2017","31","Hotel","2","1","1424","2226","291","455","1715","2681","2"
"10","2017","31","Hotel","3","4","736","1531","206","329","942","1860","1"
"10","2017","31","Hotel","16","40","1608","2254","1091","1759","2699","4013","1"
"10","2017","31","Hotel","7","17","2954","3961","544","682","3498","4643","1"
"10","2017","31","Hotel","12","24","1043","1852","1335","1942","2378","3794","1"
"10","2017","31","Hotel","12","35","958","1741","1117","1903","2075","3644","1"
"10","2017","31","Hotel","2","6","367","1056","14","18","381","1074","1"
"10","2017","31","Hotel","13","33","1075","1075","320","320","1395","1395","1"
"10","2017","31","Hotel","10","27","1165","1805","689","1089","1854","2894","1"
"10","2017","31","Hotel","10","23","1381","2458","283","503","1664","2961","1"
"10","2017","31","Hotel","11","36","1412","2219","124","362","1536","2581","1"
"10","2017","31","Hotel","8","34","1440","2190","117","203","1557","2393","1"
"10","2017","31","Hotel","2","6","1770","2015","33","50","1803","2065","1"
"10","2017","31","Hotel","14","31","666","967","1606","2245","2272","3212","7.8"
"10","2017","31","Hotel","11","36","2081","3109","208","340","2289","3449","1"
"10","2017","31","","10","27","880","2357","159","934","1039","3291","1"
"10","2017","31","Hotel","14","31","1968","5068","2693","7843","4661","12911","5.4"
"10","2017","31","Hotel","4","13","3376","3390","9","18","3385","3408","1"
"10","2017","31","Hotel","6","28","1222","1527","89","138","1311","1665","1"
"10","2017","31","Otros","14","31","73","168","439","631","512","799","2.8"
"10","2017","31","Otros","16","27","56","112","0","0","56","112","2"
"10","2017","31","Hotel","2","1","1084","1808","76","129","1160","1937","2"
"10","2017","31","Hotel","10","18","1460","2225","490","628","1950","2853","1"
"10","2017","31","Hotel","7","17","1156","1863","69","95","1225","1958","1"
"10","2017","31","Hotel","12","24","707","1994","370","1395","1077","3389","1"
"10","2017","31","Hotel","10","18","1260","2257","615","976","1875","3233","1"
"10","2017","31","Hotel","2","1","1878","1984","13","27","1891","2011","1"
"10","2017","31","Hotel","10","18","319","1124","394","1048","713","2172","1"
"10","2017","31","Hotel","6","28","1754","2311","359","403","2113","2714","1"
"10","2017","31","Hotel","5","5","1811","3454","124","333","1935","3787","1"
"10","2017","31","Hotel","4","13","559","1119","42","149","601","1268","1"
"10","2017","31","Hotel","10","18","1418","2917","435","745","1853","3662","1"
"10","2017","31","Hotel","16","40","1077","1591","25","34","1102","1625","1"
"10","2017","31","Hotel","8","3","2278","4525","668","1304","2946","5829","1"
"10","2017","31","Hotel","15","16","882","1452","195","226","1077","1678","2"
"10","2017","31","Hotel","14","31","115","193","535","2245","650","2438","7.8"
"10","2017","31","Hotel","13","33","730","1037","285","436","1015","1473","1"
"10","2017","31","Hotel","15","16","1153","1675","180","316","1333","1991","2"
"10","2017","31","Otros","4","21","544","1936","3","3","547","1939","1"
"10","2017","31","Hotel","6","10","708","1081","2","8","710","1089","1"
"10","2017","31","Hotel","16","19","275","389","8","12","283","401","1"
"10","2017","31","Hotel","16","27","635","1650","13","33","648","1683","1"
"10","2017","31","Hotel","10","11","1579","2798","134","219","1713","3017","1"
"10","2017","31","Otros","10","23","445","969","6","18","451","987","1"
"10","2017","31","Hotel","12","35","75","197","92","146","167","343","1"
"10","2017","31","Hotel","11","36","762","1636","242","487","1004","2123","1"
"10","2017","31","Hotel","14","31","95","306","389","1965","484","2271","17.4"
"10","2017","31","Hotel","10","18","518","1186","626","1326","1144","2512","3.2"
"10","2017","31","Hotel","4","13","497","1007","13","51","510","1058","1"
"10","2017","31","Hotel","6","12","447","704","109","194","556","898","5"
"10","2017","31","Hotel","6","10","858","1276","133","220","991","1496","1"
"10","2017","31","Otros","5","5","236","466","101","166","337","632","3.65625"
"10","2017","31","Hotel","12","24","1065","1317","996","1148","2061","2465","1"
"10","2017","31","Hotel","8","3","1188","2154","270","534","1458","2688","1"
"10","2017","31","Hotel","13","27","788","1461","0","0","788","1461","2.75"
"10","2017","31","Hotel","15","16","167","819","57","185","224","1004","4"
"10","2017","31","Otros","15","16","145","563","104","322","249","885","2"
"10","2017","31","Otros","16","20","391","522","0","0","391","522","1"
"10","2017","31","Hotel","3","4","1200","1940","279","279","1479","2219","1"
"10","2017","31","Hotel","11","36","136","168","0","0","136","168","1"
"10","2017","31","Hotel","2","6","277","1187","69","269","346","1456","1"
"10","2017","31","Hotel","8","34","948","2049","195","421","1143","2470","1"
"10","2017","31","Hotel","4","13","17","25","0","0","17","25","3.2"
"10","2017","31","Hotel","13","27","517","1137","0","0","517","1137","2.75"
"10","2017","31","Hotel","2","29","543","1123","1067","2425","1610","3548","1"
"10","2017","31","Otros","11","36","93","249","2","2","95","251","1"
"10","2017","31","","10","11","4","8","0","0","4","8","1"
"10","2017","31","Hotel","4","13","1064","1419","72","380","1136","1799","1"
"10","2017","31","Hotel","16","40","2412","3619","900","1353","3312","4972","5.6666666666667"
"10","2017","31","Hotel","10","23","946","1502","655","1303","1601","2805","2.8"
"10","2017","31","Hotel","8","34","473","725","284","632","757","1357","1"
"10","2017","31","Hotel","5","5","500","1050","81","113","581","1163","1"
"10","2017","31","Hotel","3","4","115","240","43","81","158","321","3"
"10","2017","31","Hotel","9","26","78","235","7","30","85","265","1"
"10","2017","31","Hotel","8","34","523","764","119","239","642","1003","1"
"10","2017","31","Hotel","7","17","324","649","52","89","376","738","4"
"10","2017","31","Hotel","4","13","289","507","22","53","311","560","3.2"
"10","2017","31","Hotel","12","35","53","198","369","1359","422","1557","1"
"10","2017","31","Hotel","16","40","1339","2922","1745","3698","3084","6620","1"
"10","2017","31","Hotel","9","26","379","598","89","267","468","865","1"
"10","2017","31","","6","27","212","629","9","32","221","661","1"
"10","2017","31","Hotel","9","26","213","378","10","29","223","407","1"
"10","2017","31","Hotel","4","13","232","454","29","52","261","506","3.2"
"10","2017","31","Hotel","6","28","441","550","33","37","474","587","1"
"10","2017","31","","2","29","91","220","710","2110","801","2330","1"
"10","2017","31","Hotel","13","33","1470","1971","136","259","1606","2230","1"
"10","2017","31","Hotel","8","3","423","785","162","373","585","1158","1"
"10","2017","31","Hotel","14","27","410","415","1210","1489","1620","1904","1"
"10","2017","31","Hotel","16","40","369","615","1","2","370","617","5.6666666666667"
"10","2017","31","Hotel","12","24","330","497","381","498","711","995","1"
"10","2017","31","Hotel","10","18","852","1726","203","523","1055","2249","3.2"
"10","2017","31","Otros","15","16","162","164","29","29","191","193","9"
"10","2017","31","Hotel","6","10","546","611","8","12","554","623","1"
"10","2017","31","Hotel","10","11","717","1264","74","155","791","1419","1"
"10","2017","31","Otros","6","10","137","959","0","0","137","959","3.8518518518518"
"10","2017","31","Otros","10","23","256","521","0","0","256","521","1"
"10","2017","31","Hotel","10","23","551","813","458","876","1009","1689","2.8"
"10","2017","31","Hotel","6","12","297","468","0","0","297","468","5"
"10","2017","31","Hotel","6","27","72","209","2","6","74","215","3"
"10","2017","31","Hotel","10","23","502","833","394","809","896","1642","2.8"
"10","2017","31","","4","39","294","847","0","0","294","847","1"
"10","2017","31","Hotel","8","34","357","543","285","494","642","1037","1"
"10","2017","31","Hotel","8","34","486","764","222","368","708","1132","1"
"10","2017","31","Otros","4","39","19","33","0","0","19","33","2.2222222222222"
"10","2017","31","Otros","13","14","152","304","0","0","152","304","1"
"10","2017","31","Hotel","10","23","224","313","35","44","259","357","2.8"
"10","2017","31","Otros","13","14","458","1810","0","0","458","1810","1"
"10","2017","31","Hotel","12","24","598","820","310","516","908","1336","1"
"10","2017","31","","6","25","126","207","0","0","126","207","1"
"10","2017","31","Hotel","15","27","784","1149","11","14","795","1163","1"
"10","2017","31","Hotel","12","35","133","266","363","715","496","981","1"
"10","2017","31","Hotel","16","40","782","4212","352","1184","1134","5396","1"
"10","2017","31","Hotel","16","27","80","81","7","7","87","88","1"
"10","2017","31","Hotel","9","30","96","224","0","0","96","224","1"
"10","2017","31","Hotel","4","13","303","534","68","154","371","688","3.2"
"10","2017","31","Hotel","2","29","93","235","274","906","367","1141","1"
"10","2017","31","Hotel","16","20","467","504","49","73","516","577","1"
"10","2017","31","Hotel","5","5","498","754","64","114","562","868","1"
"10","2017","31","Hotel","13","33","997","1578","116","217","1113","1795","1"
"10","2017","31","Otros","16","19","158","251","11","20","169","271","1.3333333333333"
"10","2017","31","Hotel","12","24","162","507","246","569","408","1076","1"
"10","2017","31","","8","2","423","616","73","138","496","754","1"
"10","2017","31","Hotel","12","35","23","157","200","1181","223","1338","1"
"10","2017","31","Hotel","16","27","34","46","494","658","528","704","2.5"
"10","2017","31","Otros","16","27","518","953","40","75","558","1028","2"
"10","2017","31","Hotel","8","34","729","877","191","363","920","1240","1"
"10","2017","31","Otros","8","3","262","2286","0","0","262","2286","1"
"10","2017","31","Hotel","7","27","345","468","127","183","472","651","1"
"10","2017","31","Hotel","4","39","238","551","6","23","244","574","1"
"10","2017","31","Hotel","15","16","229","468","25","58","254","526","4"
"10","2017","31","Hotel","4","39","59","100","17","17","76","117","1"
"10","2017","31","Hotel","4","39","309","425","8","19","317","444","1"
"10","2017","31","Hotel","15","16","165","635","200","394","365","1029","4"
"10","2017","31","Hotel","14","31","269","463","257","648","526","1111","17.4"
"10","2017","31","Hotel","8","34","490","854","142","209","632","1063","1"
"10","2017","31","Hotel","6","28","242","333","19","36","261","369","1"
"10","2017","31","Hotel","7","17","749","1250","70","128","819","1378","4"
"10","2017","31","Otros","7","27","5","5","0","0","5","5","1"
"10","2017","31","Hotel","11","36","1241","1453","52","119","1293","1572","1"
"10","2017","31","Otros","4","21","324","657","19","34","343","691","1"
"10","2017","31","Otros","15","16","145","153","72","74","217","227","2"
"10","2017","31","Otros","7","17","187","388","16","129","203","517","3"
"10","2017","31","Hotel","7","38","101","146","0","0","101","146","1"
"10","2017","31","Hotel","16","27","502","813","30","59","532","872","2.5"
"10","2017","31","Hotel","2","6","44","116","8","16","52","132","2.2"
"10","2017","31","Hotel","11","36","391","742","50","106","441","848","1"
"10","2017","31","Hotel","6","28","27","33","6","10","33","43","1"
"10","2017","31","Hotel","6","12","84","119","0","0","84","119","5"
"10","2017","31","Otros","9","22","135","335","0","0","135","335","1"
"10","2017","31","","13","14","454","650","14","14","468","664","2"
"10","2017","31","Hotel","2","29","201","394","554","795","755","1189","1"
"10","2017","31","Hotel","2","29","76","149","68","271","144","420","1"
"10","2017","31","Otros","4","13","420","445","20","20","440","465","1"
"10","2017","31","Hotel","15","16","86","222","40","96","126","318","4"
"10","2017","31","Hotel","2","1","148","464","21","73","169","537","6.4"
"10","2017","31","Otros","7","27","94","148","0","0","94","148","1"
"10","2017","31","Otros","13","33","77","79","0","0","77","79","5.125"
"10","2017","31","","4","21","489","578","3","3","492","581","1"
"10","2017","31","Hotel","6","10","319","319","2","2","321","321","1"
"10","2017","31","Hotel","11","36","97","241","30","30","127","271","1"
"10","2017","31","Otros","14","31","150","400","160","400","310","800","2.8"
"10","2017","31","Hotel","7","27","256","408","5","31","261","439","1"
"10","2017","31","Otros","6","10","29","413","0","0","29","413","3.8518518518518"
"10","2017","31","Hotel","4","39","16","25","3","6","19","31","2.6"
"10","2017","31","Otros","8","2","14","22","38","92","52","114","6.4285714285714"
"10","2017","31","Otros","11","36","73","166","8","22","81","188","5.1904761904762"
"10","2017","31","Hotel","13","33","589","1084","0","0","589","1084","1"
"10","2017","31","","3","4","107","187","35","53","142","240","1"
"10","2017","31","Hotel","7","17","361","731","52","132","413","863","4"
"10","2017","31","Hotel","8","2","213","257","8","22","221","279","1"
"10","2017","31","Otros","15","16","137","192","31","46","168","238","2"
"10","2017","31","Hotel","10","11","660","1116","8","12","668","1128","1"
"10","2017","31","Hotel","16","19","312","609","0","0","312","609","1"
"10","2017","31","Hotel","10","23","181","252","79","89","260","341","4"
"10","2017","31","","7","38","323","429","35","45","358","474","1"
"10","2017","31","Hotel","7","27","42","67","0","0","42","67","1"
"10","2017","31","Hotel","11","36","481","1152","129","279","610","1431","1"
"10","2017","31","Hotel","16","40","192","296","10","22","202","318","16.333333333333"
"10","2017","31","Hotel","16","19","4","6","0","0","4","6","1"
"10","2017","31","Hotel","16","19","0","0","0","0","0","0","1"
"10","2017","0","Hotel","16","20","0","0","0","0","0","0","1"
"10","2017","31","Hotel","10","11","246","318","16","30","262","348","1"
"10","2017","31","Otros","7","27","78","193","4","4","82","197","4.8333333333333"
"10","2017","31","Otros","7","27","61","130","0","0","61","130","1"
"10","2017","31","Hotel","7","27","31","42","0","0","31","42","4.1666666666667"
"10","2017","31","Otros","13","14","115","223","0","0","115","223","1"
"10","2017","31","Otros","11","15","53","53","0","0","53","53","2.3571428571429"
"10","2017","31","Otros","10","27","0","0","41","78","41","78","4.84"
"10","2017","31","Otros","14","31","163","163","2626","2626","2789","2789","2.8"
"10","2017","31","Otros","11","36","32","45","8","17","40","62","5.1904761904762"
"10","2017","31","Hotel","16","19","64","82","0","0","64","82","1"
"10","2017","31","","14","27","210","360","13","22","223","382","2.6666666666667"
"10","2017","31","Hotel","16","40","82","162","4","4","86","166","5.6666666666667"
"10","2017","31","Hotel","10","27","15","45","0","0","15","45","2.25"
"10","2017","31","Otros","2","29","124","291","276","702","400","993","3.28"
"10","2017","31","Hotel","13","27","10","20","25","50","35","70","1"
"10","2017","31","Otros","9","22","71","97","0","0","71","97","1"
"10","2017","31","Hotel","2","27","140","368","47","74","187","442","1"
"10","2017","31","Hotel","8","34","419","834","162","286","581","1120","1"
"10","2017","31","Hotel","7","27","301","389","6","7","307","396","1"
"10","2017","31","Hotel","15","16","256","603","30","63","286","666","4"
"10","2017","0","Hotel","16","20","0","0","0","0","0","0","1"
"10","2017","31","Otros","4","13","128","337","1","5","129","342","1"
"10","2017","31","Hotel","2","1","215","485","15","60","230","545","6.4"
"10","2017","31","Otros","11","32","11","21","0","0","11","21","2.2857142857143"
"10","2017","31","Hotel","2","29","16","111","219","1390","235","1501","1"
"10","2017","31","Hotel","16","27","215","220","100","115","315","335","2.5"
"10","2017","31","Hotel","10","18","264","1157","6","6","270","1163","3.2"
"10","2017","31","Otros","11","36","480","737","47","61","527","798","1"
"10","2017","31","Otros","13","14","19","33","0","0","19","33","1"
"10","2017","31","Hotel","7","27","178","224","0","0","178","224","1"
"10","2017","31","Otros","7","17","206","444","33","80","239","524","3"
"10","2017","31","Otros","14","31","337","688","256","607","593","1295","2.8"
"10","2017","31","Hotel","2","29","247","641","248","1128","495","1769","1"
"10","2017","31","Hotel","8","3","146","477","62","102","208","579","1"
"10","2017","31","Hotel","8","34","298","441","89","203","387","644","2.5714285714286"
"10","2017","31","Hotel","8","34","220","301","217","408","437","709","2.5714285714286"
"10","2017","31","Hotel","12","35","60","75","93","114","153","189","1"
"10","2017","31","Hotel","11","32","180","508","14","26","194","534","1"
"10","2017","31","Hotel","13","33","235","348","6","12","241","360","2"
"10","2017","31","Hotel","10","23","276","444","86","136","362","580","2.8"
"10","2017","31","Hotel","12","35","211","816","7","7","218","823","1"
"10","2017","31","","16","40","361","640","114","155","475","795","3.0555555555556"
"10","2017","31","Otros","16","19","17","43","0","0","17","43","1.3333333333333"
"10","2017","31","Otros","16","20","133","377","0","0","133","377","1"
"10","2017","31","Hotel","6","12","171","403","5","7","176","410","5"
"10","2017","31","Hotel","16","19","150","198","0","0","150","198","4"
"10","2017","31","Hotel","12","24","124","348","145","316","269","664","1"
"10","2017","31","Hotel","12","24","200","377","183","219","383","596","3"
"10","2017","31","Hotel","8","3","120","840","0","0","120","840","1"
"10","2017","31","Hotel","5","9","0","0","15","15","15","15","1"
"10","2017","31","Hotel","16","27","191","331","47","86","238","417","2.5"
"10","2017","27","Otros","10","23","35","35","0","0","35","35","7"
"10","2017","31","Otros","13","14","167","245","0","0","167","245","7.3846153846154"
"10","2017","31","Otros","2","6","36","88","9","24","45","112","1"
"10","2017","16","Hotel","15","16","9","9","60","71","69","80","7.8"
"10","2017","31","Hotel","8","3","253","1337","0","0","253","1337","1"
"10","2017","31","Hotel","8","34","652","1171","139","227","791","1398","1"
"10","2017","31","Hotel","8","3","67","154","55","103","122","257","1"
"10","2017","31","","2","29","114","342","49","156","163","498","1"
"10","2017","31","Hotel","2","1","271","529","12","33","283","562","6.4"
"10","2017","31","Hotel","7","17","170","305","3","3","173","308","4"
"10","2017","31","Otros","7","17","193","573","0","0","193","573","3"
"10","2017","31","Hotel","16","40","125","203","54","105","179","308","5.6666666666667"
"10","2017","31","Hotel","12","24","260","491","200","268","460","759","1"
"10","2017","31","Hotel","14","31","335","1522","150","607","485","2129","17.4"
"10","2017","0","Hotel","9","26","0","0","0","0","0","0","1"
"10","2017","31","Hotel","6","12","30","30","0","0","30","30","5"
"10","2017","31","Otros","5","9","25","34","7","11","32","45","4.0454545454545"
"10","2017","31","Otros","5","9","2","4","0","0","2","4","4.0454545454545"
"10","2017","31","Otros","15","27","100","113","0","0","100","113","1.4222222222222"
"10","2017","31","Hotel","8","34","23","25","2","2","25","27","2.5714285714286"
"10","2017","31","Hotel","10","18","283","564","126","242","409","806","7.75"
"10","2017","31","Hotel","15","16","196","387","154","267","350","654","7.8"
"10","2017","31","Hotel","2","29","169","450","384","1177","553","1627","1"
"10","2017","31","Hotel","4","39","144","489","11","25","155","514","2.6"
"10","2017","31","Otros","4","39","125","212","2","2","127","214","2.2222222222222"
"10","2017","31","Hotel","4","13","122","279","38","107","160","386","5.4"
"10","2017","31","Otros","10","23","106","116","19","25","125","141","7"
"10","2017","31","Otros","14","31","130","207","431","984","561","1191","20.2"
"10","2017","31","Hotel","3","4","47","69","5","10","52","79","2.6"
"10","2017","31","Hotel","10","23","76","115","27","32","103","147","4"
"10","2017","31","Otros","9","22","315","957","2","2","317","959","1"
"10","2017","31","Hotel","12","24","199","400","182","346","381","746","3"
"10","2017","31","Hotel","13","14","21","23","0","0","21","23","1"
"10","2017","31","Hotel","12","35","137","238","126","170","263","408","1.7272727272727"
"10","2017","31","Hotel","6","28","347","552","0","0","347","552","1"
"10","2017","31","","6","28","47","381","0","0","47","381","1"
"10","2017","31","Hotel","12","24","293","457","144","244","437","701","3"
"10","2017","31","Otros","5","9","4","4","1","1","5","5","4.0454545454545"
"10","2017","31","Hotel","16","20","58","63","0","0","58","63","1"
"10","2017","31","Hotel","4","21","181","316","25","31","206","347","3"
"10","2017","31","Otros","10","11","14","20","0","0","14","20","11.764705882353"
"10","2017","31","Otros","13","14","28","56","0","0","28","56","7.3846153846154"
"10","2017","31","Otros","16","27","72","105","0","0","72","105","13.818181818182"
"10","2017","22","Hotel","9","26","252","504","0","0","252","504","1"
"10","2017","31","Hotel","16","27","491","673","310","522","801","1195","2.5"
"10","2017","31","Hotel","3","4","1664","2633","100","210","1764","2843","3"
"10","2017","31","Otros","16","27","40","80","42","210","82","290","2"
"10","2017","31","Otros","16","19","536","1301","0","0","536","1301","1.3333333333333"
"10","2017","31","Hotel","6","12","607","845","3","3","610","848","5"
"10","2017","31","Hotel","2","1","215","471","13","14","228","485","6.4"
"10","2017","31","Hotel","10","11","422","613","45","69","467","682","1"
"10","2017","31","Otros","10","23","73","73","0","0","73","73","1"
"10","2017","31","Otros","10","27","629","691","125","143","754","834","4.84"
"10","2017","31","Hotel","16","27","269","374","42","538","311","912","2.5"
"10","2017","31","Hotel","6","28","210","297","13","17","223","314","1"
"10","2017","31","Hotel","4","13","82","170","2","2","84","172","5.4"
"10","2017","31","Hotel","14","27","659","865","52","65","711","930","8.5"
"10","2017","31","Hotel","10","27","138","195","392","513","530","708","1"
"10","2017","31","Hotel","13","27","142","205","60","87","202","292","4.2"
"10","2017","31","Hotel","3","4","482","681","7","13","489","694","3"
"10","2017","31","Otros","4","13","122","279","14","56","136","335","3.4"
"10","2017","31","Otros","11","15","2","2","0","0","2","2","2.3571428571429"
"10","2017","31","Otros","6","10","80","334","0","0","80","334","3.8518518518518"
"10","2017","31","Otros","2","1","63","103","9","9","72","112","1"
"10","2017","31","","6","12","37","283","1","1","38","284","1"
"10","2017","31","Otros","10","23","227","875","19","42","246","917","1"
"10","2017","31","Hotel","16","19","158","164","0","0","158","164","4"
"10","2017","31","Hotel","10","11","39","234","0","0","39","234","5.6666666666667"
"10","2017","31","Hotel","10","23","45","45","7","7","52","52","4"
"10","2017","31","Otros","14","31","46","96","273","588","319","684","2.8"
"10","2017","31","Otros","13","27","10","10","0","0","10","10","12.2"
"10","2017","31","Hotel","2","1","205","701","0","0","205","701","6.4"
"10","2017","31","Hotel","16","19","43","86","0","0","43","86","4"
"10","2017","31","Otros","12","35","32","50","6","6","38","56","3.5"
"10","2017","31","Otros","15","16","71","125","14","36","85","161","2"
"10","2017","31","Otros","9","22","203","406","56","112","259","518","1"
"10","2017","31","Hotel","10","27","278","456","508","683","786","1139","1"
"10","2017","31","Hotel","2","27","61","90","8","12","69","102","3.6"
"10","2017","31","Hotel","16","20","72","199","19","51","91","250","1"
"10","2017","31","Hotel","10","18","150","297","95","165","245","462","7.75"
"10","2017","31","Hotel","6","12","228","228","0","0","228","228","5"
"10","2017","31","Hotel","2","27","124","424","6","13","130","437","3.6"
"10","2017","31","Hotel","15","16","123","257","5","5","128","262","7.8"
"10","2017","31","Hotel","10","23","90","90","25","26","115","116","4"
"10","2017","31","Hotel","11","32","26","32","10","10","36","42","1"
"10","2017","31","Hotel","14","27","151","437","57","206","208","643","8.5"
"10","2017","31","Otros","10","11","37","53","0","0","37","53","11.764705882353"
"10","2017","31","Hotel","2","27","99","275","12","26","111","301","3.6"
"10","2017","31","Otros","13","14","240","389","0","0","240","389","7.3846153846154"
"10","2017","31","Hotel","2","1","118","144","7","7","125","151","6.4"
"10","2017","31","Otros","7","17","187","560","4","20","191","580","17.166666666667"
"10","2017","31","Otros","10","23","13","74","0","0","13","74","7"
"10","2017","31","Hotel","13","27","262","262","6","6","268","268","2.75"
"10","2017","31","Otros","10","18","40","148","6","18","46","166","10.25"
"10","2017","31","Otros","5","9","29","239","0","0","29","239","4.0454545454545"
"10","2017","31","Hotel","4","39","229","374","12","12","241","386","2.6"
"10","2017","31","Otros","16","27","116","231","52","166","168","397","13.818181818182"
"10","2017","31","Hotel","14","27","30","51","69","189","99","240","8.5"
"10","2017","31","Hotel","10","11","96","137","51","57","147","194","5.6666666666667"
"10","2017","31","Hotel","10","18","109","201","119","182","228","383","7.75"
"10","2017","31","Otros","14","31","117","179","98","246","215","425","20.2"
"10","2017","31","Otros","11","32","6","8","0","0","6","8","2.2857142857143"
"10","2017","31","Otros","5","5","32","96","0","0","32","96","3.65625"
"10","2017","31","Otros","6","25","43","92","0","0","43","92","2.3846153846154"
"10","2017","31","Hotel","3","4","53","95","18","23","71","118","2.6"
"10","2017","31","Otros","7","27","90","123","0","0","90","123","4.8333333333333"
"10","2017","31","Otros","2","29","71","174","63","187","134","361","3.28"
"10","2017","31","Hotel","2","29","88","252","206","593","294","845","1"
"10","2017","31","Otros","4","21","149","260","14","22","163","282","1"
"10","2017","31","Hotel","7","27","231","260","19","19","250","279","4.1666666666667"
"10","2017","31","Otros","5","5","37","128","7","20","44","148","3.65625"
"10","2017","31","Otros","11","36","89","178","41","120","130","298","5.1904761904762"
"10","2017","31","Hotel","7","27","560","560","0","0","560","560","4.1666666666667"
"10","2017","0","Hotel","16","20","0","0","0","0","0","0","1"
"10","2017","31","Hotel","12","24","140","286","314","390","454","676","3"
"10","2017","31","Hotel","9","26","120","189","10","10","130","199","1.5"
"10","2017","31","Hotel","7","17","341","852","11","51","352","903","10"
"10","2017","31","Hotel","9","37","270","403","37","52","307","455","3.4"
"10","2017","31","Hotel","5","5","380","606","117","137","497","743","2.1428571428571"
"10","2017","31","Otros","6","27","119","196","0","0","119","196","3.960088691796"
"10","2017","31","Hotel","9","37","80","162","7","9","87","171","3.4"
"10","2017","31","Otros","10","27","68","116","0","0","68","116","4.84"
"10","2017","31","Otros","8","3","151","233","14","16","165","249","10"
"10","2017","31","Otros","16","20","30","30","2","2","32","32","3.0769230769231"
"10","2017","31","Otros","9","22","15","24","0","0","15","24","7.6428571428571"
"10","2017","31","Otros","10","27","172","240","15","15","187","255","4.84"
"10","2017","31","Otros","10","23","33","40","2","3","35","43","7"
"10","2017","31","Otros","2","6","542","542","198","198","740","740","1"
"10","2017","31","Otros","4","39","13","28","0","0","13","28","2.2222222222222"
"10","2017","31","Hotel","2","27","54","61","28","34","82","95","1"
"10","2017","31","Hotel","14","31","64","234","146","721","210","955","24"
"10","2017","31","Otros","2","29","168","383","192","372","360","755","3.28"
"10","2017","31","Otros","8","3","264","792","0","0","264","792","10"
"10","2017","31","","13","14","13","26","8","20","21","46","1"
"10","2017","31","Hotel","6","10","196","316","27","44","223","360","6.6"
"10","2017","31","Hotel","8","34","118","147","70","81","188","228","2.5714285714286"
"10","2017","31","Hotel","9","22","399","1847","0","0","399","1847","2.5555555555556"
"10","2017","31","Hotel","2","6","134","234","57","92","191","326","2.2"
"10","2017","31","Hotel","10","27","109","230","128","166","237","396","2.25"
"10","2017","31","Otros","14","27","145","145","0","0","145","145","11.833333333333"
"10","2017","31","Otros","6","12","377","673","11","40","388","713","1.8256578947368"
"10","2017","31","Hotel","6","27","116","154","0","0","116","154","3"
"10","2017","31","Hotel","5","5","33","77","11","30","44","107","2.1428571428571"
"10","2017","31","Hotel","5","5","45","101","1","3","46","104","2.1428571428571"
"10","2017","31","Hotel","13","27","218","430","0","0","218","430","4.2"
"10","2017","31","Hotel","2","27","129","179","0","0","129","179","3.6"
"10","2017","31","Hotel","8","3","261","406","18","18","279","424","4.1111111111111"
"10","2017","31","Otros","11","36","31","76","0","0","31","76","5.1904761904762"
"10","2017","31","Otros","9","30","202","448","0","0","202","448","2.3333333333333"
"10","2017","31","Otros","16","19","26","28","0","0","26","28","10.263157894737"
"10","2017","31","Hotel","14","31","81","121","299","878","380","999","17.4"
"10","2017","31","Hotel","2","1","314","361","11","14","325","375","6.4"
"10","2017","31","Hotel","16","40","867","1404","596","785","1463","2189","5.6666666666667"
"10","2017","31","Otros","7","17","346","592","8","8","354","600","17.166666666667"
"10","2017","31","Hotel","13","27","355","403","236","365","591","768","2.75"
"10","2017","31","Hotel","14","31","290","354","379","570","669","924","24"
"10","2017","31","Otros","3","4","28","84","8","15","36","99","12.2"
"10","2017","31","Otros","8","34","281","464","207","327","488","791","5.75"
"10","2017","31","Hotel","9","22","131","174","7","7","138","181","2.5555555555556"
"10","2017","31","Hotel","4","21","85","153","9","13","94","166","3"
"10","2017","31","Hotel","6","27","68","114","0","0","68","114","3"
"10","2017","31","Hotel","12","35","117","179","56","85","173","264","1.7272727272727"
"10","2017","31","Hotel","2","29","83","197","116","350","199","547","2"
"10","2017","31","Otros","10","11","87","115","3","4","90","119","11.764705882353"
"10","2017","31","Hotel","6","10","96","283","1","1","97","284","6.6"
"10","2017","31","Hotel","13","14","178","224","0","0","178","224","2"
"10","2017","11","Otros","16","27","93","146","0","0","93","146","13.818181818182"
"10","2017","31","Otros","6","27","27","34","0","0","27","34","3.960088691796"
"10","2017","31","Hotel","16","40","123","241","381","764","504","1005","5.6666666666667"
"10","2017","31","Otros","6","10","76","169","6","12","82","181","3.8518518518518"
"10","2017","31","Otros","10","23","43","63","19","40","62","103","7"
"10","2017","31","Hotel","6","28","216","264","19","23","235","287","1"
"10","2017","31","Otros","7","38","382","559","66","123","448","682","2.75"
"10","2017","31","Hotel","6","12","188","322","0","0","188","322","5"
"10","2017","31","Hotel","13","27","229","354","5","5","234","359","4.2"
"10","2017","31","Otros","4","21","52","93","0","0","52","93","4.8333333333333"
"10","2017","31","Hotel","16","27","63","159","1","15","64","174","5.8571428571429"
"10","2017","31","Hotel","5","5","46","51","6","7","52","58","2.1428571428571"
"10","2017","31","Otros","12","24","54","117","87","122","141","239","9.2"
"10","2017","31","Otros","15","16","57","93","30","62","87","155","9"
"10","2017","31","Hotel","8","27","118","118","6","6","124","124","4.5"
"10","2017","31","Hotel","9","22","72","309","1","1","73","310","2.5555555555556"
"10","2017","31","Hotel","10","11","196","285","33","53","229","338","5.6666666666667"
"10","2017","31","Hotel","8","3","62","130","30","72","92","202","4.1111111111111"
"10","2017","31","Hotel","6","10","235","352","15","31","250","383","6.6"
"10","2017","31","Otros","9","26","52","246","0","0","52","246","3.8888888888889"
"10","2017","31","Hotel","4","39","89","250","10","25","99","275","2.6"
"10","2017","31","Otros","6","27","25","75","0","0","25","75","3.960088691796"
"10","2017","31","Otros","6","12","165","208","0","0","165","208","1.8256578947368"
"10","2017","31","Hotel","6","27","78","154","0","0","78","154","3"
"10","2017","31","Otros","5","9","103","193","13","20","116","213","4.0454545454545"
"10","2017","31","Hotel","2","27","138","138","28","28","166","166","3.6"
"10","2017","31","Hotel","2","29","109","327","178","534","287","861","1"
"10","2017","31","Hotel","4","13","156","228","4","4","160","232","5.4"
"10","2017","31","","11","15","41","282","0","0","41","282","1"
"10","2017","31","Hotel","6","10","400","428","20","27","420","455","6.6"
"10","2017","31","Otros","6","12","34","128","0","0","34","128","1.8256578947368"
"10","2017","31","Otros","10","18","39","43","2","2","41","45","10.25"
"10","2017","31","Otros","9","22","87","160","0","0","87","160","7.6428571428571"
"10","2017","31","","14","27","292","328","2","4","294","332","1"
"10","2017","31","Hotel","16","27","73","78","3","3","76","81","5.8571428571429"
"10","2017","31","Otros","2","29","10","43","27","45","37","88","3.28"
"10","2017","31","Otros","13","33","29","34","0","0","29","34","5.125"
"10","2017","31","Otros","13","33","25","37","7","7","32","44","5.125"
"10","2017","31","Otros","6","10","125","490","0","0","125","490","3.8518518518518"
"10","2017","31","Hotel","10","18","62","121","38","68","100","189","7.75"
"10","2017","31","Hotel","14","31","89","143","94","346","183","489","24"
"10","2017","31","Hotel","4","21","73","73","4","4","77","77","3"
"10","2017","31","Hotel","3","4","28","102","0","0","28","102","2.6"
"10","2017","31","Otros","8","27","25","39","8","8","33","47","1"
"10","2017","31","Otros","6","27","30","89","0","0","30","89","3.960088691796"
"10","2017","31","Hotel","6","25","195","645","0","0","195","645","1"
"10","2017","31","Otros","6","12","200","319","4","5","204","324","1.8256578947368"
"10","2017","31","Hotel","6","27","33","130","0","0","33","130","3"
"10","2017","31","Otros","6","27","180","360","0","0","180","360","3.960088691796"
"10","2017","31","Otros","6","10","20","32","0","0","20","32","3.8518518518518"
"10","2017","31","Otros","6","12","93","209","0","0","93","209","1.8256578947368"
"10","2017","31","Otros","5","5","24","48","6","12","30","60","3.65625"
"10","2017","31","Hotel","12","24","131","371","45","51","176","422","3"
"10","2017","31","Hotel","15","16","94","108","10","21","104","129","7.8"
"10","2017","31","Otros","4","13","86","176","2","2","88","178","3.4"
"10","2017","31","Hotel","2","29","265","742","120","368","385","1110","1"
"10","2017","31","Hotel","4","21","40","85","0","0","40","85","3"
"10","2017","31","Hotel","10","27","161","269","461","567","622","836","2.25"
"10","2017","31","Hotel","8","3","130","231","65","99","195","330","4.1111111111111"
"10","2017","31","Hotel","12","27","68","106","23","29","91","135","1"
"10","2017","31","Otros","5","5","135","399","19","68","154","467","3.65625"
"10","2017","31","Otros","13","14","19","23","0","0","19","23","7.3846153846154"
"10","2017","31","Otros","10","11","194","319","59","91","253","410","11.764705882353"
"10","2017","31","Otros","16","40","325","426","20","39","345","465","28.142857142857"
"10","2017","31","Hotel","11","36","323","822","8","16","331","838","1"
"10","2017","31","Otros","8","34","67","96","39","64","106","160","5.75"
"10","2017","31","Hotel","7","17","111","227","11","19","122","246","10"
"10","2017","31","Otros","12","35","255","372","8","11","263","383","3.5"
"10","2017","31","Otros","5","9","0","0","50","60","50","60","4.0454545454545"
"10","2017","31","Hotel","9","22","72","102","0","0","72","102","2.5555555555556"
"10","2017","31","Otros","2","29","29","85","61","181","90","266","3.28"
"10","2017","31","Otros","2","29","106","230","190","627","296","857","3.28"
"10","2017","31","Hotel","10","27","97","156","137","179","234","335","2.25"
"10","2017","31","Hotel","16","19","163","163","17","17","180","180","4"
"10","2017","31","Hotel","16","40","211","354","32","94","243","448","16.333333333333"
"10","2017","31","Hotel","8","27","177","243","43","65","220","308","4.5"
"10","2017","31","Otros","13","14","13","29","1","1","14","30","7.3846153846154"
"10","2017","31","Hotel","7","27","55","57","0","0","55","57","4.1666666666667"
"10","2017","31","Otros","2","6","8","24","0","0","8","24","5"
"10","2017","31","Hotel","7","17","371","881","21","85","392","966","10"
"10","2017","31","Hotel","3","4","84","162","54","135","138","297","2.6"
"10","2017","31","Otros","6","12","19","210","0","0","19","210","1.8256578947368"
"10","2017","31","Otros","6","10","6","6","0","0","6","6","3.8518518518518"
"10","2017","31","Hotel","16","40","34","62","16","28","50","90","16.333333333333"
"10","2017","31","Otros","4","39","83","117","5","7","88","124","2.2222222222222"
"10","2017","31","Otros","13","14","6","12","0","0","6","12","7.3846153846154"
"10","2017","31","Otros","7","38","108","156","4","4","112","160","2.75"
"10","2017","31","Hotel","11","32","61","97","0","0","61","97","1"
"10","2017","31","Otros","11","36","145","256","7","10","152","266","5.1904761904762"
"10","2017","31","Hotel","4","21","100","139","10","12","110","151","3"
"10","2017","31","Otros","3","4","3","18","14","68","17","86","12.2"
"10","2017","31","Otros","5","9","65","75","19","21","84","96","4.0454545454545"
"10","2017","31","Hotel","8","27","56","92","3","9","59","101","4.5"
"10","2017","31","","7","17","392","972","4","16","396","988","1"
"10","2017","31","Otros","16","20","18","71","0","0","18","71","3.0769230769231"
"10","2017","31","Otros","4","21","21","45","6","24","27","69","4.8333333333333"
"10","2017","31","Otros","13","33","94","108","8","11","102","119","5.125"
"10","2017","31","","12","35","0","0","323","1419","323","1419","1"
"10","2017","31","Hotel","13","33","0","0","1","1","1","1","2"
"10","2017","31","Otros","4","39","68","139","0","0","68","139","2.2222222222222"
"10","2017","31","Otros","10","18","31","57","0","0","31","57","10.25"
"10","2017","31","Otros","6","27","84","129","0","0","84","129","3.960088691796"
"10","2017","31","Hotel","4","39","74","211","0","0","74","211","2.6"
"10","2017","31","Otros","14","31","100","259","124","321","224","580","20.2"
"10","2017","31","Hotel","2","29","102","237","214","478","316","715","2"
"10","2017","31","Hotel","9","26","216","384","0","0","216","384","1.5"
"10","2017","31","Otros","12","35","6","8","1","2","7","10","3.5"
"10","2017","31","Hotel","14","27","94","132","48","64","142","196","8.5"
"10","2017","31","Otros","11","36","62","228","7","26","69","254","5.1904761904762"
"10","2017","31","Otros","16","20","70","179","4","12","74","191","3.0769230769231"
"10","2017","31","Otros","4","39","3","9","0","0","3","9","2.2222222222222"
"10","2017","31","Otros","7","27","115","128","1","1","116","129","4.8333333333333"
"10","2017","31","Otros","6","27","104","225","2","2","106","227","3.960088691796"
"10","2017","31","Otros","5","8","10","300","3","3","13","303","5"
"10","2017","31","Otros","9","37","160","335","18","18","178","353","4.5"
"10","2017","31","Hotel","2","6","45","269","0","0","45","269","5.5"
"10","2017","31","Hotel","10","27","220","374","110","138","330","512","2.25"
"10","2017","31","Hotel","9","30","186","364","22","43","208","407","1"
"10","2017","31","Otros","4","13","1","1","0","0","1","1","3.4"
"10","2017","31","Hotel","5","5","289","289","19","19","308","308","1"
"10","2017","31","Otros","7","38","123","284","0","0","123","284","2.75"
"10","2017","31","Hotel","13","14","11","11","0","0","11","11","1"
"10","2017","31","Otros","5","9","23","25","16","64","39","89","4.0454545454545"
"10","2017","31","Otros","5","8","5","15","0","0","5","15","5"
"10","2017","31","Otros","10","27","34","459","0","0","34","459","4.84"
"10","2017","31","Hotel","13","14","10","20","2","4","12","24","1"
"10","2017","31","Otros","11","15","29","44","0","0","29","44","2.3571428571429"
"10","2017","31","Hotel","9","22","135","279","0","0","135","279","2.5555555555556"
"10","2017","31","Otros","11","36","131","189","5","10","136","199","5.1904761904762"
"10","2017","31","Hotel","10","18","1629","2962","1836","3795","3465","6757","1"
"10","2017","31","Hotel","6","12","132","144","13","95","145","239","5"
"10","2017","31","","2","29","439","1148","928","2571","1367","3719","1"
"10","2017","31","Hotel","16","27","1141","2326","7","14","1148","2340","1"
"10","2017","31","","14","31","322","963","529","2068","851","3031","1"
"10","2017","31","Hotel","8","3","16","93","4","4","20","97","4.1111111111111"
"10","2017","31","Otros","13","33","32","47","1","1","33","48","5.125"
"10","2017","31","","14","27","210","360","13","22","223","382","2.6666666666667"
"10","2017","31","Otros","9","22","17","32","0","0","17","32","7.6428571428571"
"10","2017","31","Hotel","10","11","14","18","4","10","18","28","5.6666666666667"
"10","2017","31","Otros","6","12","11","31","0","0","11","31","1.8256578947368"
"10","2017","31","Hotel","8","3","97","134","24","26","121","160","4.1111111111111"
"10","2017","31","Otros","6","12","244","579","0","0","244","579","1.8256578947368"
"10","2017","31","Hotel","8","27","223","223","0","0","223","223","4.5"
"10","2017","31","Hotel","6","28","208","263","24","38","232","301","2.4"
"10","2017","31","Otros","6","25","55","281","0","0","55","281","2.3846153846154"
"10","2017","31","Otros","6","25","23","32","0","0","23","32","2.3846153846154"
"10","2017","31","Hotel","11","36","637","1719","0","0","637","1719","1"
"10","2017","31","Otros","2","6","33","87","204","632","237","719","5"
"10","2017","31","Hotel","14","31","58","81","137","466","195","547","24"
"10","2017","31","Otros","4","21","18","29","0","0","18","29","4.8333333333333"
"10","2017","31","Otros","7","38","63","109","14","22","77","131","2.75"
"10","2017","31","Otros","13","14","49","61","0","0","49","61","7.3846153846154"
"10","2017","31","Otros","2","29","18","30","75","82","93","112","3.28"
"10","2017","31","Otros","3","4","135","135","22","22","157","157","12.2"
"10","2017","31","Hotel","3","4","412","810","36","93","448","903","3"
"10","2017","31","Otros","7","27","224","305","6","7","230","312","1"
"10","2017","31","Otros","7","17","169","192","2","4","171","196","3"
"10","2017","31","Hotel","12","27","276","395","59","61","335","456","1"
"10","2017","31","Otros","5","5","27","68","7","12","34","80","3.65625"
"10","2017","31","Hotel","6","10","260","359","4","4","264","363","6.6"
"10","2017","31","Otros","10","18","15","53","6","43","21","96","10.25"
"10","2017","31","Otros","8","27","58","84","0","0","58","84","9.4"
"10","2017","31","Otros","8","3","22","38","12","14","34","52","10"
"10","2017","31","Hotel","16","27","55","106","0","0","55","106","5.8571428571429"
"10","2017","31","Otros","6","10","32","75","0","0","32","75","3.8518518518518"
"10","2017","25","Hotel","2","6","29","42","0","0","29","42","5.5"
"10","2017","31","Hotel","8","3","34","91","0","0","34","91","4.1111111111111"
"10","2017","31","Otros","10","11","32","47","14","29","46","76","11.764705882353"
"10","2017","31","Otros","6","27","96","126","0","0","96","126","3.960088691796"
"10","2017","31","Otros","15","16","2","8","0","0","2","8","9"
"10","2017","31","Otros","5","5","4","8","0","0","4","8","3.65625"
"10","2017","31","Otros","10","27","125","220","32","32","157","252","4.84"
"10","2017","31","Hotel","7","38","57","87","4","5","61","92","1"
"10","2017","31","Hotel","13","27","4","60","0","0","4","60","4.2"
"10","2017","31","Hotel","16","20","93","162","0","0","93","162","1"
"10","2017","31","Otros","10","27","44","89","46","114","90","203","4.84"
"10","2017","31","Hotel","3","7","70","133","11","17","81","150","1"
"10","2017","31","Otros","2","29","75","93","15","27","90","120","3.28"
"10","2017","31","Otros","10","18","5","52","0","0","5","52","10.25"
"10","2017","31","Otros","9","22","262","449","0","0","262","449","7.6428571428571"
"10","2017","31","Otros","15","27","87","87","2","2","89","89","1.4222222222222"
"10","2017","31","Otros","11","36","7","24","1","2","8","26","5.1904761904762"
"10","2017","31","Otros","5","5","25","45","4","7","29","52","3.65625"
"10","2017","31","Otros","2","29","40","80","62","136","102","216","3.28"
"10","2017","31","Hotel","9","22","154","154","23","23","177","177","2.5555555555556"
"10","2017","31","Otros","11","32","5","5","0","0","5","5","2.2857142857143"
"10","2017","31","Hotel","10","27","218","292","169","277","387","569","1"
"10","2017","31","Otros","16","27","86","104","1","1","87","105","2"
"10","2017","31","Hotel","16","20","23","60","0","0","23","60","1"
"10","2017","31","Otros","11","15","35","72","0","0","35","72","2.3571428571429"
"10","2017","31","Otros","7","17","141","680","0","0","141","680","3"
"10","2017","31","Otros","5","8","18","19","2","2","20","21","5"
"10","2017","31","Hotel","13","33","117","193","6","6","123","199","2"
"10","2017","31","Otros","5","9","36","60","9","9","45","69","4.0454545454545"
"10","2017","31","Otros","10","27","71","111","76","150","147","261","4.84"
"10","2017","31","Otros","9","22","38","62","0","0","38","62","7.6428571428571"
"10","2017","31","Otros","16","40","120","233","0","0","120","233","28.142857142857"
"10","2017","31","Hotel","16","40","56","70","28","28","84","98","1"
"10","2017","31","Otros","15","16","20","61","0","0","20","61","9"
"10","2017","31","Hotel","8","2","8","10","2","4","10","14","3"
"10","2017","31","Otros","8","3","54","112","0","0","54","112","10"
"10","2017","31","Otros","7","17","49","95","0","0","49","95","17.166666666667"
"10","2017","31","Otros","16","20","42","136","0","0","42","136","3.0769230769231"
"10","2017","31","Otros","6","27","46","82","0","0","46","82","3.960088691796"
"10","2017","31","Otros","12","35","65","103","62","97","127","200","3.5"
"10","2017","31","Otros","6","28","113","286","4","4","117","290","4.65"
"10","2017","31","Otros","6","28","427","1618","14","21","441","1639","4.65"
"10","2017","31","Hotel","8","34","102","197","66","119","168","316","2.5714285714286"
"10","2017","31","Hotel","16","20","1507","2410","5","8","1512","2418","1"
"10","2017","31","Hotel","2","6","112","324","0","0","112","324","2.2"
"10","2017","31","Hotel","7","27","44","45","0","0","44","45","4.1666666666667"
"10","2017","31","Hotel","10","23","39","163","0","0","39","163","4"
"10","2017","31","Hotel","9","26","46","74","13","13","59","87","1.5"
"10","2017","31","Otros","8","27","59","71","3","6","62","77","9.4"
"10","2017","31","Otros","10","27","9","9","6","6","15","15","4.84"
"10","2017","31","Otros","11","15","18","32","0","0","18","32","2.3571428571429"
"10","2017","31","Otros","16","20","19","26","0","0","19","26","3.0769230769231"
"10","2017","31","Otros","11","32","65","95","0","0","65","95","1"
"10","2017","31","Otros","16","27","91","91","4","4","95","95","13.818181818182"
"10","2017","31","Otros","9","37","90","102","0","0","90","102","4.5"
"10","2017","31","Hotel","2","29","31","65","44","190","75","255","2"
"10","2017","31","Hotel","2","1","46","134","0","0","46","134","6.4"
"10","2017","31","Otros","5","8","1","1","0","0","1","1","5"
"10","2017","31","Otros","9","37","88","151","41","74","129","225","4.5"
"10","2017","31","Otros","7","38","115","256","0","0","115","256","2.75"
"10","2017","31","Otros","11","32","134","394","4","4","138","398","1"
"10","2017","31","Otros","4","39","93","106","8","19","101","125","2.2222222222222"
"10","2017","31","Hotel","11","36","70","147","46","93","116","240","2.375"
"10","2017","31","Otros","10","23","51","123","18","36","69","159","7"
"10","2017","31","Hotel","15","16","695","1616","206","458","901","2074","2"
"10","2017","31","Otros","2","29","56","115","140","270","196","385","3.28"
"10","2017","31","Hotel","6","12","958","1269","35","49","993","1318","1"
"10","2017","31","Hotel","11","15","409","908","0","0","409","908","1"
"10","2017","31","Otros","4","21","225","332","7","9","232","341","1"
"10","2017","31","Otros","16","19","82","206","0","0","82","206","10.263157894737"
"10","2017","31","","9","37","370","532","2","2","372","534","1"
"10","2017","31","Otros","10","27","87","138","141","240","228","378","4.84"
"10","2017","31","Otros","11","15","70","70","5","5","75","75","2.3571428571429"
"10","2017","31","Hotel","2","29","71","210","74","224","145","434","2"
"10","2017","31","Hotel","10","27","334","338","134","177","468","515","1"
"10","2017","31","Hotel","11","36","127","671","18","42","145","713","2.375"
"10","2017","31","Hotel","9","37","89","123","42","55","131","178","3.4"
"10","2017","31","Otros","14","27","10","20","3","4","13","24","11.833333333333"
"10","2017","31","Otros","7","38","145","206","0","0","145","206","1"
"10","2017","31","Hotel","2","1","6","16","0","0","6","16","6.4"
"10","2017","31","Otros","2","29","18","37","95","217","113","254","3.28"
"10","2017","31","Hotel","6","27","20","88","0","0","20","88","3"
"10","2017","31","Otros","5","9","22","26","0","0","22","26","4.0454545454545"
"10","2017","31","Hotel","2","1","165","199","0","0","165","199","6.4"
"10","2017","31","Hotel","3","7","22","65","93","146","115","211","1"
"10","2017","20","Otros","7","38","30","41","21","21","51","62","2.75"
"10","2017","31","Otros","7","17","20","293","0","0","20","293","17.166666666667"
"10","2017","31","Otros","7","38","22","32","2","4","24","36","2.75"
"10","2017","31","Otros","4","21","21","25","0","0","21","25","4.8333333333333"
"10","2017","31","Otros","2","1","46","46","9","9","55","55","5.5"
"10","2017","31","Otros","12","35","62","102","10","18","72","120","3.5"
"10","2017","31","Otros","12","35","30","40","48","61","78","101","3.5"
"10","2017","31","Otros","4","21","35","41","5","6","40","47","4.8333333333333"
"10","2017","31","Otros","12","24","18","26","10","30","28","56","9.2"
"10","2017","31","Otros","16","19","5","6","0","0","5","6","10.263157894737"
"10","2017","31","Otros","10","11","34","34","2","2","36","36","11.764705882353"
"10","2017","31","Otros","16","19","82","147","0","0","82","147","10.263157894737"
"10","2017","31","Hotel","2","27","33","123","4","9","37","132","1"
"10","2017","31","Otros","6","28","40","60","0","0","40","60","4.65"
"10","2017","31","Otros","10","18","173","468","43","107","216","575","10.25"
"10","2017","31","Otros","14","27","30","64","0","0","30","64","11.833333333333"
"10","2017","31","Hotel","11","32","7","7","0","0","7","7","1"
"10","2017","31","Otros","8","27","22","68","0","0","22","68","9.4"
"10","2017","31","Hotel","12","35","57","95","39","65","96","160","1.7272727272727"
"10","2017","31","Otros","13","14","20","110","0","0","20","110","7.3846153846154"
"10","2017","31","Otros","11","36","24","47","0","0","24","47","5.1904761904762"
"10","2017","31","Otros","16","20","58","81","1","2","59","83","3.0769230769231"
"10","2017","31","Hotel","14","31","108","138","616","803","724","941","7.8"
"10","2017","31","Otros","2","27","115","344","7","13","122","357","3.2"
"10","2017","31","","16","40","292","625","0","0","292","625","3.0555555555556"
"10","2017","31","Hotel","11","36","94","174","31","71","125","245","2.375"
"10","2017","31","Hotel","9","22","27","31","0","0","27","31","2.5555555555556"
"10","2017","31","Otros","2","29","24","52","28","65","52","117","3.28"
"10","2017","31","Hotel","10","27","9","13","82","89","91","102","2.25"
"10","2017","31","Otros","10","27","16","59","0","0","16","59","4.84"
"10","2017","31","Hotel","16","19","26","30","0","0","26","30","4"
"10","2017","15","Otros","2","6","14","22","1","1","15","23","5"
"10","2017","31","Otros","7","27","182","232","0","0","182","232","4.8333333333333"
"10","2017","31","Hotel","2","6","126","996","0","0","126","996","5.5"
"10","2017","31","Hotel","6","28","5","5","3","3","8","8","2.4"
"10","2017","31","Otros","6","10","138","980","0","0","138","980","3.8518518518518"
"10","2017","31","Hotel","6","27","44","66","0","0","44","66","3"
"10","2017","31","Otros","5","5","25","45","4","7","29","52","3.65625"
"10","2017","31","Otros","12","24","89","187","60","74","149","261","9.2"
"10","2017","31","Hotel","8","2","106","174","6","8","112","182","3"
"10","2017","31","Hotel","11","32","11","47","2","2","13","49","1"
"10","2017","31","Otros","10","18","17","76","8","38","25","114","10.25"
"10","2017","31","Hotel","9","37","33","55","15","26","48","81","3.4"
"10","2017","31","Otros","5","9","50","54","77","91","127","145","4.0454545454545"
"10","2017","31","Otros","12","24","20","49","26","55","46","104","9.2"
"10","2017","31","Otros","9","22","15","15","0","0","15","15","7.6428571428571"
"10","2017","31","Otros","2","29","11","37","26","70","37","107","3.28"
"10","2017","31","Otros","10","23","11","71","4","4","15","75","7"
"10","2017","31","Otros","10","27","44","161","28","196","72","357","4.84"
"10","2017","31","Otros","10","11","68","68","0","0","68","68","11.764705882353"
"10","2017","31","Otros","8","3","30","96","0","0","30","96","10"
"10","2017","31","Otros","14","31","75","241","247","753","322","994","20.2"
"10","2017","31","Otros","2","29","218","511","152","409","370","920","3.28"
"10","2017","0","Otros","6","25","0","0","0","0","0","0","1"
"10","2017","31","Hotel","15","16","28","54","0","0","28","54","7.8"
"10","2017","31","Hotel","15","27","107","141","0","0","107","141","1"
"10","2017","31","Otros","10","27","3","4","3","3","6","7","4.84"
"10","2017","31","Otros","10","23","56","56","0","0","56","56","7"
"10","2017","31","Otros","6","27","14","14","0","0","14","14","3.960088691796"
"10","2017","31","Otros","16","40","128","245","0","0","128","245","28.142857142857"
"10","2017","31","Otros","11","36","129","147","0","0","129","147","5.1904761904762"
"10","2017","31","Otros","8","34","69","114","21","44","90","158","5.75"
"10","2017","31","Otros","6","12","14","226","0","0","14","226","1.8256578947368"
"10","2017","31","Otros","6","10","117","149","11","13","128","162","3.8518518518518"
"10","2017","31","Hotel","4","21","179","359","18","23","197","382","3"
"10","2017","31","Hotel","11","36","127","282","33","47","160","329","2.375"
"10","2017","31","Otros","5","8","91","134","86","106","177","240","5"
"10","2017","31","Hotel","7","17","134","173","0","0","134","173","10"
"10","2017","26","Hotel","11","36","218","397","14","14","232","411","1"
"10","2017","31","Otros","9","30","13","17","0","0","13","17","2.3333333333333"
"10","2017","31","Hotel","12","35","38","57","46","86","84","143","1.7272727272727"
"10","2017","31","Otros","2","1","106","233","14","24","120","257","5.5"
"10","2017","31","Hotel","6","25","88","106","0","0","88","106","1"
"10","2017","31","Otros","5","5","5","21","0","0","5","21","3.65625"
"10","2017","31","Otros","2","29","28","57","97","251","125","308","3.28"
"10","2017","31","Hotel","2","6","18","26","16","16","34","42","5.5"
"10","2017","31","Otros","7","17","16","91","0","0","16","91","17.166666666667"
"10","2017","31","Hotel","8","2","42","76","4","4","46","80","3"
"10","2017","31","Hotel","13","14","32","32","0","0","32","32","1"
"10","2017","31","Otros","7","38","45","95","8","18","53","113","2.75"
"10","2017","31","Hotel","14","31","20","24","100","220","120","244","24"
"10","2017","31","Hotel","5","5","51","89","0","0","51","89","2.1428571428571"
"10","2017","31","Otros","2","27","4","4","12","12","16","16","3.2"
"10","2017","31","Otros","5","8","4","5","0","0","4","5","5"
"10","2017","31","Otros","3","4","8","22","0","0","8","22","12.2"
"10","2017","31","Otros","13","14","4","4","0","0","4","4","7.3846153846154"
"10","2017","31","Otros","9","37","17","51","0","0","17","51","4.5"
"10","2017","31","Hotel","10","23","979","1241","59","80","1038","1321","1"
"10","2017","31","Otros","11","32","15","15","2","2","17","17","2.2857142857143"
"10","2017","31","Otros","11","15","18","30","0","0","18","30","2.3571428571429"
"10","2017","31","Otros","8","3","6","10","0","0","6","10","10"
"10","2017","31","Otros","16","20","62","141","4","8","66","149","3.0769230769231"
"10","2017","31","Otros","8","3","10","20","0","0","10","20","10"
"10","2017","31","Otros","16","27","48","96","0","0","48","96","2"
"10","2017","31","Hotel","16","19","19","27","3","9","22","36","4"
"10","2017","31","Hotel","16","27","47","86","0","0","47","86","5.8571428571429"
"10","2017","31","Otros","9","26","26","89","3","3","29","92","3.8888888888889"
"10","2017","31","Otros","5","5","9","9","2","4","11","13","3.65625"
"10","2017","31","Otros","14","27","5","25","0","0","5","25","11.833333333333"
"10","2017","31","Hotel","5","5","16","72","5","25","21","97","2.1428571428571"
"10","2017","31","Hotel","12","24","118","309","112","236","230","545","3"
"10","2017","31","Otros","16","27","34","94","0","0","34","94","13.818181818182"
"10","2017","31","Otros","8","3","21","65","6","6","27","71","1"
"10","2017","31","Otros","13","27","181","219","5","11","186","230","12.2"
"10","2017","31","Hotel","16","40","44","61","32","61","76","122","16.333333333333"
"10","2017","31","Otros","11","36","80","187","0","0","80","187","1"
"10","2017","31","Otros","10","27","60","60","20","25","80","85","4.84"
"10","2017","31","Otros","9","22","28","41","0","0","28","41","7.6428571428571"
"10","2017","31","Hotel","5","5","42","78","13","19","55","97","2.1428571428571"
"10","2017","31","Otros","2","29","42","124","64","156","106","280","3.28"
"10","2017","31","Otros","2","29","15","28","6","16","21","44","3.28"
"10","2017","31","Hotel","13","14","22","22","0","0","22","22","1"
"10","2017","31","Otros","6","25","5","5","0","0","5","5","2.3846153846154"
"10","2017","31","Otros","2","1","22","32","0","0","22","32","5.5"
"10","2017","31","Hotel","12","27","25","25","23","31","48","56","1"
"10","2017","31","Hotel","13","27","7","11","2","4","9","15","4.2"
"10","2017","31","Otros","6","12","67","260","0","0","67","260","1.8256578947368"
"10","2017","31","Otros","6","27","2","3","0","0","2","3","3.960088691796"
"10","2017","31","Otros","6","25","9","16","0","0","9","16","2.3846153846154"
"10","2017","31","Hotel","6","28","20","52","0","0","20","52","2.5833333333333"
"10","2017","31","Otros","5","5","1","1","0","0","1","1","3.65625"
"10","2017","31","Otros","5","9","17","24","3","5","20","29","4.0454545454545"
"10","2017","31","Otros","5","8","2","2","3","3","5","5","5"
"10","2017","31","Hotel","2","29","149","366","220","518","369","884","1"
"10","2017","31","Otros","5","5","90","189","20","38","110","227","3.65625"
"10","2017","31","Hotel","9","26","19","20","3","6","22","26","1.5"
"10","2017","31","Otros","9","30","8","9","0","0","8","9","2.3333333333333"
"10","2017","31","Otros","11","15","27","47","5","5","32","52","2.3571428571429"
"10","2017","31","Hotel","16","27","3","4","2","2","5","6","5.8571428571429"
"10","2017","31","Otros","9","30","10","14","2","2","12","16","2.3333333333333"
"10","2017","31","Otros","2","29","31","82","20","80","51","162","3.28"
"10","2017","31","Otros","7","38","45","97","14","27","59","124","2.75"
"10","2017","31","Otros","4","21","58","172","7","19","65","191","4.8333333333333"
"10","2017","31","Otros","9","22","36","58","0","0","36","58","7.6428571428571"
"10","2017","31","Otros","9","22","105","158","0","0","105","158","7.6428571428571"
"10","2017","31","Otros","13","27","30","58","0","0","30","58","12.2"
"10","2017","31","Hotel","11","36","2146","2208","59","89","2205","2297","1"
"10","2017","31","Otros","13","33","13","25","4","8","17","33","5.125"
"10","2017","31","Otros","11","36","100","226","49","122","149","348","5.1904761904762"
"10","2017","31","Otros","12","35","53","85","179","283","232","368","3.5"
"10","2017","31","Otros","12","35","4","8","5","7","9","15","3.5"
"10","2017","31","Otros","10","11","46","90","6","12","52","102","11.764705882353"
"10","2017","31","Otros","12","24","7","33","25","50","32","83","9.2"
"10","2017","31","Otros","16","20","30","69","0","0","30","69","3.0769230769231"
"10","2017","31","Hotel","7","27","56","61","7","9","63","70","1"
"10","2017","31","Otros","6","12","4","6","11","36","15","42","1.8256578947368"
"10","2017","31","Otros","11","32","46","109","13","28","59","137","2.2857142857143"
"10","2017","31","Otros","6","28","76","675","0","0","76","675","4.65"
"10","2017","31","Otros","8","34","2","2","0","0","2","2","5.75"
"10","2017","31","Otros","16","27","102","186","0","0","102","186","13.818181818182"
"10","2017","31","Otros","10","11","5","5","0","0","5","5","11.764705882353"
"10","2017","31","Otros","6","10","11","36","0","0","11","36","3.8518518518518"
"10","2017","31","Otros","8","3","120","221","4","5","124","226","10"
"10","2017","31","Hotel","16","20","96","306","0","0","96","306","1"
"10","2017","31","Hotel","11","32","94","104","0","0","94","104","1"
"10","2017","31","Otros","8","27","21","227","8","8","29","235","9.4"
"10","2017","31","Otros","12","27","41","163","2","4","43","167","3.4285714285714"
"10","2017","31","Otros","6","10","46","62","0","0","46","62","3.8518518518518"
"10","2017","31","Otros","6","10","28","128","0","0","28","128","3.8518518518518"
"10","2017","31","Otros","5","8","16","16","12","12","28","28","5"
"10","2017","31","Otros","5","8","27","27","13","13","40","40","5"
"10","2017","31","Hotel","9","26","53","91","3","5","56","96","1.5"
"10","2017","31","Hotel","13","14","34","38","0","0","34","38","1"
"10","2017","31","Otros","10","18","72","162","35","139","107","301","10.25"
"10","2017","31","Otros","8","2","34","37","33","35","67","72","6.4285714285714"
"10","2017","31","Otros","7","27","17","22","0","0","17","22","4.8333333333333"
"10","2017","31","Otros","2","29","45","133","29","90","74","223","3.28"
"10","2017","31","Otros","11","32","1","1","0","0","1","1","2.2857142857143"
"10","2017","31","Otros","9","30","25","33","0","0","25","33","2.3333333333333"
"10","2017","31","Otros","2","29","19","61","9","21","28","82","3.28"
"10","2017","31","Otros","5","5","3","9","0","0","3","9","3.65625"
"10","2017","31","Otros","11","15","26","39","1","1","27","40","2.3571428571429"
"10","2017","31","Otros","10","23","4","4","0","0","4","4","7"
"10","2017","31","Otros","11","36","84","158","23","30","107","188","5.1904761904762"
"10","2017","31","Hotel","3","7","24","33","56","94","80","127","1"
"10","2017","31","Otros","10","27","4","16","0","0","4","16","4.84"
"10","2017","31","Otros","2","27","11","11","2","2","13","13","3.2"
"10","2017","31","Otros","12","35","12","37","10","28","22","65","3.5"
"10","2017","31","Otros","10","27","2","4","8","8","10","12","4.84"
"10","2017","31","Otros","16","40","39","80","143","398","182","478","28.142857142857"
"10","2017","31","Hotel","8","3","312","649","112","218","424","867","4.1111111111111"
"10","2017","31","Otros","9","22","56","56","2","2","58","58","7.6428571428571"
"10","2017","31","Otros","13","14","16","31","0","0","16","31","7.3846153846154"
"10","2017","31","Otros","5","9","10","14","0","0","10","14","4.0454545454545"
"10","2017","31","Otros","10","18","24","53","20","29","44","82","10.25"
"10","2017","31","Otros","6","25","345","663","0","0","345","663","2.3846153846154"
"10","2017","31","Otros","9","22","30","74","0","0","30","74","7.6428571428571"
"10","2017","31","Otros","10","27","42","53","10","18","52","71","4.84"
"10","2017","31","Otros","16","20","43","64","8","16","51","80","3.0769230769231"
"10","2017","31","Hotel","7","17","109","212","0","0","109","212","10"
"10","2017","31","Otros","15","27","50","61","0","0","50","61","1.4222222222222"
"10","2017","31","Otros","12","35","13","13","5","5","18","18","3.5"
"10","2017","31","Otros","12","35","10","16","82","111","92","127","3.5"
"10","2017","31","Otros","3","7","11","11","2","2","13","13","2"
"10","2017","31","Otros","10","11","4","4","2","4","6","8","11.764705882353"
"10","2017","31","Otros","12","24","0","0","3","3","3","3","9.2"
"10","2017","31","Otros","10","23","14","22","0","0","14","22","7"
"10","2017","31","Otros","7","27","9","15","0","0","9","15","4.8333333333333"
"10","2017","31","","10","18","2","8","0","0","2","8","1"
"10","2017","31","Otros","16","27","0","0","4","4","4","4","13.818181818182"
"10","2017","31","Hotel","2","29","25","46","21","79","46","125","1"
"10","2017","31","Otros","14","27","43","43","0","0","43","43","11.833333333333"
"10","2017","31","Otros","11","32","70","83","0","0","70","83","2.2857142857143"
"10","2017","31","Otros","16","19","18","60","0","0","18","60","1"
"10","2017","31","Otros","16","27","12","16","4","4","16","20","13.818181818182"
"10","2017","31","Otros","8","3","37","718","6","20","43","738","10"
"10","2017","31","Otros","16","27","64","112","0","0","64","112","13.818181818182"
"10","2017","31","Otros","16","20","53","93","0","0","53","93","3.0769230769231"
"10","2017","31","Otros","16","40","196","361","33","60","229","421","28.142857142857"
"10","2017","31","Hotel","11","36","50","102","16","43","66","145","2.375"
"10","2017","31","Otros","6","10","54","116","0","0","54","116","3.8518518518518"
"10","2017","31","Otros","7","38","126","353","7","25","133","378","2.75"
"10","2017","31","Otros","13","14","5","5","0","0","5","5","7.3846153846154"
"10","2017","31","Otros","9","30","56","77","2","2","58","79","2.3333333333333"
"10","2017","31","Otros","13","27","51","335","0","0","51","335","12.2"
"10","2017","31","Otros","10","27","34","34","31","31","65","65","4.84"
"10","2017","31","Otros","6","25","36","44","13","17","49","61","2.3846153846154"
"10","2017","31","Otros","9","26","9","20","0","0","9","20","3.8888888888889"
"10","2017","31","Otros","10","18","46","76","17","35","63","111","10.25"
"10","2017","27","Otros","2","29","29","92","0","0","29","92","3.28"
"10","2017","31","Otros","6","25","2","2","0","0","2","2","2.3846153846154"
"10","2017","31","Otros","5","9","2","4","1","1","3","5","4.0454545454545"
"10","2017","31","Otros","5","9","8","24","6","10","14","34","4.0454545454545"
"10","2017","31","Hotel","9","37","54","84","3","24","57","108","3.4"
"10","2017","31","Hotel","7","38","236","269","8","16","244","285","1"
"10","2017","31","Otros","7","27","41","52","0","0","41","52","4.8333333333333"
"10","2017","31","Otros","5","9","16","18","5","5","21","23","4.0454545454545"
"10","2017","31","Otros","10","27","6","6","1","1","7","7","4.84"
"10","2017","31","Otros","7","27","26","26","0","0","26","26","4.8333333333333"
"10","2017","31","Otros","16","40","53","100","28","84","81","184","28.142857142857"
"10","2017","31","Otros","10","23","35","35","0","0","35","35","7"
"10","2017","31","Otros","15","16","95","324","3","5","98","329","9"
"10","2017","31","Otros","3","7","7","20","83","207","90","227","2"
"10","2017","31","Otros","7","17","33","69","0","0","33","69","17.166666666667"
"10","2017","31","Otros","8","27","80","175","9","17","89","192","9.4"
"10","2017","31","Otros","9","22","20","60","0","0","20","60","7.6428571428571"
"10","2017","31","Otros","16","19","10","20","0","0","10","20","10.263157894737"
"10","2017","0","","15","27","0","0","0","0","0","0","1"
"10","2017","31","Hotel","10","11","14","14","12","22","26","36","5.6666666666667"
"10","2017","31","Otros","2","27","5","5","0","0","5","5","3.2"
"10","2017","31","Otros","8","2","60","76","24","32","84","108","6.4285714285714"
"10","2017","31","Otros","5","5","5","6","1","1","6","7","3.65625"
"10","2017","31","Otros","12","35","7","10","8","13","15","23","3.5"
"10","2017","31","Otros","8","3","9","17","5","11","14","28","10"
"10","2017","31","Otros","12","24","0","0","88","130","88","130","9.2"
"10","2017","31","Otros","11","32","25","54","4","12","29","66","2.2857142857143"
"10","2017","31","Otros","10","27","21","55","52","80","73","135","4.84"
"10","2017","31","Otros","11","15","13","19","0","0","13","19","2.3571428571429"
"10","2017","31","Otros","5","8","12","12","3","3","15","15","5"
"10","2017","31","Otros","14","27","18","18","0","0","18","18","11.833333333333"
"10","2017","31","Otros","13","27","375","857","0","0","375","857","12.2"
"10","2017","31","Hotel","10","18","51","51","147","147","198","198","3.2"
"10","2017","31","Otros","10","27","14","14","15","15","29","29","4.84"
"10","2017","31","Otros","11","32","12","17","0","0","12","17","1"
"10","2017","31","Otros","9","37","37","106","0","0","37","106","4.5"
"10","2017","31","Otros","12","35","46","62","165","233","211","295","3.5"
"10","2017","31","Otros","8","34","120","189","47","88","167","277","5.75"
"10","2017","31","Hotel","16","40","26","32","68","134","94","166","16.333333333333"
"10","2017","31","Hotel","10","11","36","90","32","73","68","163","5.6666666666667"
"10","2017","31","Otros","7","27","5","9","0","0","5","9","4.8333333333333"
"10","2017","31","Hotel","7","38","22","44","0","0","22","44","1"
"10","2017","31","Otros","6","27","21","47","0","0","21","47","3.960088691796"
"10","2017","31","Otros","6","10","39","82","0","0","39","82","3.8518518518518"
"10","2017","31","Otros","6","25","67","96","0","0","67","96","1"
"10","2017","31","Otros","6","25","11","15","2","2","13","17","2.3846153846154"
"10","2017","31","Otros","6","27","29","59","0","0","29","59","3.960088691796"
"10","2017","31","Otros","6","27","94","264","0","0","94","264","3.960088691796"
"10","2017","31","Otros","5","5","15","21","5","13","20","34","3.65625"
"10","2017","31","Otros","5","5","15","34","0","0","15","34","3.65625"
"10","2017","31","Otros","3","4","18","27","4","4","22","31","12.2"
"10","2017","31","Otros","10","23","7","15","0","0","7","15","7"
"10","2017","31","Otros","8","3","1","1","0","0","1","1","10"
"10","2017","31","Otros","5","5","11","34","12","28","23","62","3.65625"
"10","2017","31","Otros","5","8","22","37","2","2","24","39","5"
"10","2017","31","Otros","6","10","32","61","4","8","36","69","3.8518518518518"
"10","2017","31","Otros","16","19","18","36","0","0","18","36","10.263157894737"
"10","2017","31","Otros","11","15","17","33","0","0","17","33","2.3571428571429"
"10","2017","31","Otros","7","38","40","48","0","0","40","48","2.75"
"10","2017","31","Otros","11","32","37","69","28","306","65","375","2.2857142857143"
"10","2017","31","Otros","8","2","30","57","0","0","30","57","6.4285714285714"
"10","2017","31","Otros","10","27","24","41","15","19","39","60","4.84"
"10","2017","31","Otros","6","27","13","17","0","0","13","17","3.960088691796"
"10","2017","31","Otros","11","32","28","44","11","15","39","59","2.2857142857143"
"10","2017","20","Otros","8","34","7","7","7","14","14","21","5.75"
"10","2017","31","Otros","11","32","10","10","0","0","10","10","2.2857142857143"
"10","2017","31","Otros","10","11","9","19","0","0","9","19","11.764705882353"
"10","2017","10","Otros","11","32","2","2","0","0","2","2","2.2857142857143"
"10","2017","31","Otros","14","31","0","0","23","44","23","44","20.2"
"10","2017","31","Hotel","14","31","192","432","606","2044","798","2476","17.4"
"10","2017","31","Otros","11","36","162","325","19","39","181","364","5.1904761904762"
"10","2017","31","Hotel","15","16","829","1356","170","278","999","1634","2"
"10","2017","31","Otros","15","27","8","15","0","0","8","15","1.4222222222222"
"10","2017","19","Otros","5","5","7","22","0","0","7","22","3.65625"
"10","2017","31","Otros","8","34","16","27","2","2","18","29","5.75"
"10","2017","31","Otros","7","27","26","30","0","0","26","30","4.8333333333333"
"10","2017","31","Otros","12","35","15","19","15","17","30","36","3.5"
"10","2017","31","Otros","5","5","66","134","1","1","67","135","3.65625"
"10","2017","31","Otros","10","11","3","3","0","0","3","3","11.764705882353"
"10","2017","31","Otros","10","11","3","3","0","0","3","3","11.764705882353"
"10","2017","31","Otros","9","30","7","158","0","0","7","158","2.3333333333333"
"10","2017","31","Otros","8","2","18","38","0","0","18","38","6.4285714285714"
"10","2017","31","Otros","10","27","51","60","52","56","103","116","4.84"
"10","2017","31","Otros","5","9","16","18","5","5","21","23","4.0454545454545"
"10","2017","31","Otros","6","27","20","38","0","0","20","38","3.960088691796"
"10","2017","31","Otros","6","10","65","108","11","20","76","128","3.8518518518518"
"10","2017","31","Otros","6","10","47","94","0","0","47","94","3.8518518518518"
"10","2017","31","Otros","6","27","27","27","0","0","27","27","3.960088691796"
"10","2017","31","Otros","6","12","5","52","0","0","5","52","1.8256578947368"
"10","2017","31","Otros","6","10","52","104","0","0","52","104","3.8518518518518"
"10","2017","31","Otros","6","10","23","42","0","0","23","42","3.8518518518518"
"10","2017","31","Otros","6","27","12","12","0","0","12","12","3.960088691796"
"10","2017","31","Otros","6","12","37","53","0","0","37","53","1.8256578947368"
"10","2017","31","Otros","6","10","18","30","0","0","18","30","3.8518518518518"
"10","2017","31","Hotel","6","25","53","103","0","0","53","103","1"
"10","2017","1","Otros","6","27","1","1","0","0","1","1","3.960088691796"
"10","2017","31","Otros","5","9","15","25","0","0","15","25","4.0454545454545"
"10","2017","31","Otros","5","5","24","89","9","23","33","112","3.65625"
"10","2017","31","Otros","5","5","8","11","0","0","8","11","3.65625"
"10","2017","31","Otros","5","5","59","107","2","4","61","111","3.65625"
"10","2017","31","Otros","11","36","76","194","0","0","76","194","5.1904761904762"
"10","2017","31","Hotel","6","10","774","1615","43","106","817","1721","1"
"10","2017","31","Otros","5","9","16","18","5","5","21","23","4.0454545454545"
"10","2017","31","Otros","5","8","25","25","20","20","45","45","5"
"10","2017","0","Hotel","15","27","0","0","0","0","0","0","1"
"10","2017","31","Hotel","3","4","367","2344","8","16","375","2360","3"
"10","2017","31","Otros","3","7","26","26","9","9","35","35","1"
"10","2017","31","Otros","7","38","86","239","1","1","87","240","2.75"
"10","2017","31","Hotel","10","27","34","49","0","0","34","49","1"
"10","2017","31","Hotel","12","35","36","59","44","79","80","138","1.7272727272727"
"10","2017","31","Hotel","10","27","6","8","0","0","6","8","2.25"
"10","2017","31","Hotel","7","17","588","968","96","197","684","1165","4"
"10","2017","31","Hotel","16","19","9","9","0","0","9","9","4"
"10","2017","31","Hotel","2","6","198","404","0","0","198","404","2.2"
"10","2017","31","Otros","5","5","70","254","21","126","91","380","3.65625"
"10","2017","31","Otros","12","24","31","42","65","113","96","155","9.2"
"10","2017","31","Otros","5","8","14","14","1","1","15","15","5"
"10","2017","31","Otros","4","13","139","171","11","11","150","182","1"
"10","2017","31","Otros","10","11","97","97","0","0","97","97","11.764705882353"
"10","2017","31","Otros","12","35","23","30","34","55","57","85","3.5"
"10","2017","31","Otros","10","23","84","85","1","1","85","86","7"
"10","2017","31","Otros","11","36","576","893","64","169","640","1062","5.1904761904762"
"10","2017","31","Otros","12","35","55","101","142","169","197","270","3.5"
"10","2017","31","Otros","11","36","74","160","6","12","80","172","5.1904761904762"
"10","2017","31","Otros","8","2","25","67","6","17","31","84","6.4285714285714"
"10","2017","31","Otros","9","30","22","40","0","0","22","40","2.3333333333333"
"10","2017","31","Otros","11","36","55","150","0","0","55","150","5.1904761904762"
"10","2017","31","Otros","6","10","35","55","0","0","35","55","3.8518518518518"
"10","2017","31","Otros","10","18","35","51","0","0","35","51","10.25"
"10","2017","31","Otros","7","27","21","85","1","1","22","86","4.8333333333333"
"10","2017","31","Otros","16","20","9","18","0","0","9","18","1"
"10","2017","31","Otros","9","22","26","36","0","0","26","36","7.6428571428571"
"10","2017","31","Otros","5","5","216","284","18","30","234","314","3.65625"
"10","2017","31","Otros","12","35","30","40","48","61","78","101","3.5"
"10","2017","31","Otros","10","11","12","12","6","8","18","20","11.764705882353"
"10","2017","31","Otros","10","11","3","4","0","0","3","4","11.764705882353"
"10","2017","24","Otros","5","9","34","87","4","6","38","93","4.0454545454545"
"10","2017","31","Otros","5","5","20","36","13","30","33","66","3.65625"
"10","2017","13","Otros","12","35","6","6","12","12","18","18","3.5"
"10","2017","31","Otros","7","38","117","255","12","34","129","289","2.75"
"10","2017","31","Hotel","12","35","7","27","125","305","132","332","1.7272727272727"
"10","2017","31","Otros","13","14","82","121","0","0","82","121","1"
"10","2017","31","Otros","5","5","10","20","0","0","10","20","3.65625"
"10","2017","31","Hotel","9","26","7","11","2","4","9","15","1.5"
"10","2017","31","Hotel","16","19","16","17","0","0","16","17","1"
"10","2017","31","Otros","16","19","45","266","0","0","45","266","10.263157894737"
"10","2017","31","Otros","9","30","32","48","1","1","33","49","2.3333333333333"
"10","2017","31","Otros","16","19","6","8","0","0","6","8","10.263157894737"
"10","2017","31","Otros","16","19","61","141","0","0","61","141","10.263157894737"
"10","2017","31","Otros","9","26","7","7","0","0","7","7","3.8888888888889"
"10","2017","31","Otros","16","40","1","1","0","0","1","1","28.142857142857"
"10","2017","31","Hotel","16","27","12","12","0","0","12","12","5.8571428571429"
"10","2017","31","Otros","16","19","16","31","0","0","16","31","10.263157894737"
"10","2017","31","Otros","16","19","48","65","0","0","48","65","10.263157894737"
"10","2017","31","","9","30","239","406","2","2","241","408","1"
"10","2017","31","Otros","16","19","18","20","0","0","18","20","10.263157894737"
"10","2017","31","Otros","10","11","1","1","0","0","1","1","11.764705882353"
"10","2017","31","Otros","11","36","17","17","0","0","17","17","5.1904761904762"
"10","2017","31","Otros","16","19","19","38","0","0","19","38","10.263157894737"
"10","2017","31","Otros","16","19","154","199","0","0","154","199","1.3333333333333"
"10","2017","31","Otros","16","19","15","25","0","0","15","25","10.263157894737"
"10","2017","31","Otros","10","18","21","41","44","86","65","127","10.25"
"10","2017","31","Otros","16","19","27","68","0","0","27","68","10.263157894737"
"10","2017","31","Otros","16","19","1","1","0","0","1","1","1.3333333333333"
"10","2017","31","","9","26","395","2043","0","0","395","2043","1"
"10","2017","31","Otros","16","19","22","30","0","0","22","30","10.263157894737"
"10","2017","31","Otros","16","19","35","44","5","10","40","54","10.263157894737"
"10","2017","31","Hotel","8","2","819","1573","128","327","947","1900","1"
"10","2017","31","Otros","6","10","4","4","2","2","6","6","3.8518518518518"
"10","2017","31","Otros","6","12","38","38","0","0","38","38","1.8256578947368"
"10","2017","31","Hotel","16","19","24","41","5","7","29","48","1"
"10","2017","31","Otros","3","7","30","30","74","74","104","104","2"
"10","2017","31","Hotel","2","6","876","3144","146","487","1022","3631","1"
"10","2017","31","Hotel","3","4","747","1049","100","160","847","1209","2.6"
"10","2017","31","Hotel","16","40","2192","3427","1831","2990","4023","6417","1"
"10","2017","31","Otros","16","27","123","182","0","0","123","182","13.818181818182"
"10","2017","30","Hotel","6","28","237","346","6","12","243","358","2.4"
"10","2017","31","Hotel","8","34","836","946","365","423","1201","1369","1"
"10","2017","31","Otros","9","30","4","4","0","0","4","4","2.3333333333333"
"10","2017","31","Hotel","10","18","86","86","327","327","413","413","1"
"10","2017","31","Hotel","9","30","87","459","1","22","88","481","1"
"10","2017","31","Hotel","15","27","9","14","6","18","15","32","1"
"10","2017","31","Hotel","9","22","10","12","0","0","10","12","2.5555555555556"
"10","2017","31","","11","15","10","12","0","0","10","12","1"
"10","2017","31","Otros","6","12","48","69","0","0","48","69","1.8256578947368"
"10","2017","31","Hotel","15","27","30","930","0","0","30","930","1"
"10","2017","31","Otros","15","27","61","82","0","0","61","82","1.4222222222222"
"10","2017","31","Otros","15","27","9","9","0","0","9","9","1.4222222222222"
"10","2017","31","Otros","2","1","24","24","7","7","31","31","1"
"10","2017","31","Otros","12","24","4","5","3","3","7","8","9.2"
"10","2017","31","Otros","5","5","21","59","28","57","49","116","3.65625"
"10","2017","31","Hotel","7","27","131","146","11","11","142","157","1"
"10","2017","31","Otros","16","20","49","66","0","0","49","66","3.0769230769231"
"10","2017","0","","10","11","0","0","0","0","0","0","1"
"10","2017","31","Hotel","16","40","42","55","26","63","68","118","16.333333333333"
"10","2017","31","Otros","12","35","7","17","3","3","10","20","3.5"
"10","2017","31","Hotel","6","27","23","23","2","2","25","25","3"
"10","2017","31","Otros","5","5","3","3","0","0","3","3","3.65625"
"10","2017","31","Hotel","6","27","50","50","0","0","50","50","3"
"10","2017","31","Otros","6","25","23","25","0","0","23","25","2.3846153846154"
"10","2017","0","Hotel","15","27","0","0","0","0","0","0","1"
"10","2017","31","Otros","5","9","51","62","38","43","89","105","4.0454545454545"
"10","2017","31","Hotel","15","27","90","180","0","0","90","180","1"
"10","2017","31","Hotel","5","9","10","10","0","0","10","10","1"
"10","2017","31","Hotel","8","34","58","98","0","0","58","98","2.5714285714286"
"10","2017","31","Hotel","15","27","0","0","0","0","0","0","1"
"10","2017","31","Hotel","6","27","285","579","26","48","311","627","3"
"10","2017","0","Otros","6","27","0","0","0","0","0","0","1"
"10","2017","31","Otros","12","27","3","3","27","27","30","30","3.4285714285714"
"10","2017","31","Hotel","2","27","321","792","128","573","449","1365","1"
"10","2017","29","Hotel","2","6","90","90","0","0","90","90","1"
"10","2017","31","Otros","2","6","20","49","0","0","20","49","1"
"10","2017","31","Hotel","4","39","88","88","0","0","88","88","1"
"10","2017","31","Hotel","6","10","542","863","11","15","553","878","1"
"10","2017","31","Otros","5","8","8","8","22","22","30","30","5"
"10","2017","0","Hotel","13","33","0","0","0","0","0","0","1"
"10","2017","31","Hotel","13","33","152","304","39","84","191","388","1"
"10","2017","31","Otros","11","32","145","265","18","34","163","299","2.2857142857143"
"10","2017","31","Hotel","9","26","321","853","422","621","743","1474","1"
"10","2017","31","Hotel","16","20","82","115","0","0","82","115","1"
"10","2017","31","Otros","16","20","48","82","1","1","49","83","3.0769230769231"
"10","2017","31","","16","40","940","1977","4","4","944","1981","1"
"10","2017","31","Hotel","15","16","1748","3740","264","589","2012","4329","1"
"10","2017","31","Hotel","5","9","1","4","22","34","23","38","1"
"10","2017","31","Otros","7","38","145","363","0","0","145","363","2.75"
"10","2017","31","Otros","2","6","2385","2385","0","0","2385","2385","1"
"10","2017","31","Otros","2","6","144","325","0","0","144","325","1"
"10","2017","31","Hotel","15","27","257","926","32","34","289","960","1"
"10","2017","31","Otros","7","38","77","137","0","0","77","137","2.75"
"10","2017","31","Otros","2","1","11","28","8","16","19","44","1"
"10","2017","31","Otros","8","3","61","240","4","5","65","245","10"
"10","2017","31","Otros","11","36","15","34","0","0","15","34","5.1904761904762"
"10","2017","31","Otros","16","20","37","78","0","0","37","78","3.0769230769231"
"10","2017","31","Otros","8","3","346","605","0","0","346","605","1"
"10","2017","31","Otros","4","39","81","85","2","8","83","93","2.2222222222222"
"10","2017","31","Otros","5","5","18","57","3","11","21","68","3.65625"
"10","2017","31","Otros","12","27","3","3","14","14","17","17","3.4285714285714"
"10","2017","31","Otros","7","27","64","233","0","0","64","233","1"
"10","2017","31","Hotel","2","6","292","528","32","59","324","587","1"
"10","2017","31","Hotel","14","27","333","1414","61","77","394","1491","1"
"10","2017","31","Hotel","16","19","593","945","0","0","593","945","1"
"10","2017","31","","2","1","17","238","0","0","17","238","1"
"10","2017","31","Hotel","2","27","87","167","6","11","93","178","1"
"10","2017","31","Otros","16","20","177","232","2","4","179","236","1"
"10","2017","0","Otros","13","14","0","0","0","0","0","0","1"
"10","2017","31","Hotel","11","36","107","152","5","5","112","157","2.375"
"10","2017","31","Otros","13","14","2","32","0","0","2","32","7.3846153846154"
"10","2017","31","Otros","12","27","13","14","2","2","15","16","3.4285714285714"
"10","2017","31","Hotel","2","6","194","292","0","0","194","292","2.2"
"10","2017","31","Otros","2","6","218","953","0","0","218","953","1"
"10","2017","31","Otros","10","27","4","12","0","0","4","12","4.84"
"10","2017","31","Otros","12","27","24","36","2","2","26","38","3.4285714285714"
"10","2017","31","Otros","13","14","137","137","0","0","137","137","7.3846153846154"
"10","2017","31","Otros","6","12","130","223","37","62","167","285","1.8256578947368"
"10","2017","31","Otros","2","6","820","1084","42","101","862","1185","1"
"10","2017","31","Hotel","12","35","20","32","2","2","22","34","1.7272727272727"
"10","2017","31","Otros","5","5","14","23","0","0","14","23","3.65625"
"10","2017","31","Otros","9","30","0","0","8","248","8","248","2.3333333333333"
"10","2017","31","Hotel","8","2","5","150","0","0","5","150","1"
"10","2017","31","Otros","9","30","20","84","0","0","20","84","2.3333333333333"
"10","2017","31","Hotel","15","27","38","56","0","0","38","56","1"
"10","2017","31","Hotel","3","7","44","45","3","3","47","48","1"
"10","2017","31","Otros","6","12","496","769","0","0","496","769","1.8256578947368"
"10","2017","31","Otros","12","27","39","51","10","10","49","61","3.4285714285714"
"10","2017","30","Otros","2","6","17","49","0","0","17","49","5"
"10","2017","31","Otros","6","27","22","24","0","0","22","24","3.960088691796"
"10","2017","0","Hotel","10","11","0","0","0","0","0","0","1"
"10","2017","31","Otros","2","1","13","75","0","0","13","75","1"
"10","2017","20","Otros","11","36","5","5","0","0","5","5","5.1904761904762"
"10","2017","31","Hotel","11","32","0","0","0","0","0","0","1"
"10","2017","31","Otros","2","27","8","120","0","0","8","120","1"
"10","2017","31","Otros","12","27","13","13","0","0","13","13","3.4285714285714"
"10","2017","31","Hotel","8","2","49","85","0","0","49","85","3"
"10","2017","31","Hotel","16","20","28","28","0","0","28","28","1"
"10","2017","31","Otros","12","35","0","0","80","122","80","122","3.5"
"10","2017","31","Otros","13","14","21","34","3","3","24","37","1"
"10","2017","31","Otros","2","27","42","270","0","0","42","270","3.2"
"10","2017","31","Hotel","6","27","17","17","0","0","17","17","3"
"10","2017","31","Hotel","8","3","90","178","31","86","121","264","4.1111111111111"
"10","2017","0","Hotel","15","27","0","0","0","0","0","0","1"
"10","2017","31","Otros","8","3","64","240","4","5","68","245","10"
"10","2017","31","Hotel","16","20","13","33","6","12","19","45","1"
"10","2017","31","Hotel","6","28","102","151","5","6","107","157","2.4"
"10","2017","31","Otros","2","1","31","101","6","12","37","113","5.5"
"10","2017","31","Hotel","11","36","103","218","74","114","177","332","2.375"
"10","2017","31","Otros","4","13","292","2174","0","0","292","2174","1"
"10","2017","0","Otros","2","6","0","0","0","0","0","0","1"
"10","2017","31","Otros","8","34","147","255","175","297","322","552","5.75"
"10","2017","31","Hotel","11","15","8","16","0","0","8","16","1"
"10","2017","31","Otros","15","27","3","4","0","0","3","4","1.4222222222222"
"10","2017","31","Hotel","13","14","112","178","12","26","124","204","1"
"10","2017","31","Hotel","13","14","196","364","15","21","211","385","1"
"10","2017","31","Hotel","9","30","61","95","12","21","73","116","1"
"10","2017","31","Hotel","4","13","219","375","54","77","273","452","5.4"
"10","2017","31","Otros","6","27","13","31","0","0","13","31","3.960088691796"
"10","2017","0","Hotel","15","27","0","0","0","0","0","0","1"
"10","2017","31","Hotel","2","29","21","79","74","276","95","355","2"
"10","2017","31","Hotel","13","33","10","14","0","0","10","14","2"
"10","2017","31","Hotel","12","35","12","26","23","48","35","74","1.7272727272727"
"10","2017","31","Hotel","13","14","243","346","24","36","267","382","1"
"10","2017","31","Otros","6","25","38","76","0","0","38","76","2.3846153846154"
"10","2017","31","Hotel","8","2","11","24","9","25","20","49","3"
"10","2017","31","Otros","4","39","147","329","0","0","147","329","2.2222222222222"
"10","2017","31","Otros","6","12","127","155","17","50","144","205","1.8256578947368"
"10","2017","31","Otros","13","33","98","128","6","8","104","136","5.125"
"10","2017","31","Hotel","4","13","85","129","0","0","85","129","5.4"
"10","2017","31","Hotel","7","27","174","279","24","24","198","303","4.1666666666667"
"10","2017","31","Hotel","4","13","800","2295","109","193","909","2488","1"
"10","2017","0","","5","8","0","0","0","0","0","0","1"
"10","2017","31","Otros","8","2","16","16","0","0","16","16","6.4285714285714"
"10","2017","31","Otros","2","6","6","6","18","18","24","24","1"
"10","2017","31","","6","10","38","76","0","0","38","76","1"
"10","2017","31","Hotel","2","29","90","123","95","140","185","263","2"
"10","2017","31","","14","31","127","274","452","1732","579","2006","1"
"10","2017","31","Hotel","16","27","3998","15992","0","0","3998","15992","1"
"10","2017","31","Hotel","12","35","56","122","59","107","115","229","1.7272727272727"
"10","2017","31","","12","35","708","789","2137","2342","2845","3131","1"
"10","2017","31","","9","26","125","138","9","11","134","149","1"
"10","2017","31","Otros","11","32","88","175","0","0","88","175","2.2857142857143"
"10","2017","31","Otros","12","24","46","100","38","68","84","168","9.2"
"10","2017","31","Hotel","6","25","31","71","0","0","31","71","1"
"10","2017","31","Otros","11","32","7","9","2","2","9","11","2.2857142857143"
"10","2017","31","Hotel","16","19","41","58","0","0","41","58","4"
"10","2017","31","Otros","13","33","15","25","12","20","27","45","5.125"
"10","2017","31","Otros","16","27","23","64","3","38","26","102","13.818181818182"
"10","2017","31","Otros","6","12","47","49","4","4","51","53","1.8256578947368"
"10","2017","31","Otros","2","29","24","70","4","16","28","86","3.28"
"10","2017","31","Hotel","14","27","260","331","161","222","421","553","1"
"10","2017","31","Otros","2","1","80","1120","0","0","80","1120","1"
"10","2017","31","Otros","11","32","18","18","4","4","22","22","2.2857142857143"
"10","2017","31","Otros","2","27","106","106","10","70","116","176","1"
"10","2017","31","Hotel","2","29","217","762","34","51","251","813","1"
"10","2017","30","Hotel","4","13","25","359","0","0","25","359","3.2"
"10","2017","31","Hotel","4","21","33","91","11","15","44","106","3"
"10","2017","31","Otros","7","27","151","223","3","4","154","227","4.8333333333333"
"10","2017","31","","3","4","57","136","23","58","80","194","1"
"10","2017","31","Hotel","6","27","10","12","20","29","30","41","3"
"10","2017","31","Otros","16","19","44","71","0","0","44","71","10.263157894737"
"10","2017","31","Otros","11","32","2","2","0","0","2","2","2.2857142857143"
"10","2017","31","Otros","3","7","28","31","39","57","67","88","2"
"10","2017","31","Otros","5","5","11","17","0","0","11","17","3.65625"
"10","2017","24","Otros","15","27","678","978","0","0","678","978","1.4222222222222"
"10","2017","31","Otros","6","25","50","92","0","0","50","92","2.3846153846154"
"10","2017","31","","10","27","30","37","14","14","44","51","1"
"10","2017","31","Otros","2","29","45","90","154","251","199","341","3.28"
"10","2017","31","Otros","12","35","1","1","20","34","21","35","3.5"
"10","2017","31","Otros","16","19","19","28","0","0","19","28","10.263157894737"
"10","2017","31","Otros","9","26","95","139","10","11","105","150","3.8888888888889"
"10","2017","31","Hotel","13","33","48","48","11","11","59","59","2"
"10","2017","31","Otros","11","32","2","4","0","0","2","4","2.2857142857143"
"10","2017","31","Otros","9","22","11","22","0","0","11","22","7.6428571428571"
"10","2017","31","Otros","6","27","11","149","0","0","11","149","3.960088691796"
"10","2017","31","Otros","15","27","7","12","0","0","7","12","1.4222222222222"
"10","2017","31","Otros","11","32","62","69","10","10","72","79","2.2857142857143"
"10","2017","31","Otros","11","15","30","30","0","0","30","30","2.3571428571429"
"10","2017","31","Otros","9","37","24","99","0","0","24","99","4.5"
"10","2017","31","Otros","5","9","13","13","2","4","15","17","4.0454545454545"
"10","2017","31","Hotel","10","27","13","325","0","0","13","325","2.25"
"10","2017","31","Otros","6","28","45","523","1","1","46","524","4.65"
"10","2017","31","Otros","4","13","52","63","27","38","79","101","3.4"
"10","2017","31","Otros","2","1","1","1","0","0","1","1","1"
"10","2017","31","Otros","2","29","69","142","44","103","113","245","3.28"
"10","2017","31","Hotel","8","3","58","111","7","7","65","118","4.1111111111111"
"10","2017","31","Otros","16","19","126","360","0","0","126","360","1.3333333333333"
"10","2017","31","Otros","12","35","26","53","65","86","91","139","3.5"
"10","2017","31","Hotel","12","35","14","42","58","89","72","131","1.7272727272727"
"10","2017","31","Otros","12","35","72","72","19","19","91","91","3.5"
"10","2017","31","Otros","2","29","32","76","35","73","67","149","3.28"
"10","2017","31","Hotel","7","27","106","157","5","6","111","163","1"
"10","2017","31","Hotel","9","22","51","61","0","0","51","61","2.5555555555556"
"10","2017","31","Hotel","12","35","37","73","117","184","154","257","1.7272727272727"
"10","2017","31","Otros","15","16","83","167","18","77","101","244","2"
"10","2017","31","Hotel","15","27","22","44","2","4","24","48","1"
"10","2017","31","Otros","4","13","35","73","0","0","35","73","3.4"
"10","2017","31","Hotel","8","34","128","215","48","109","176","324","2.5714285714286"
"10","2017","31","Hotel","16","20","75","300","0","0","75","300","1"
"10","2017","31","Hotel","6","28","177","235","39","54","216","289","2.4"
"10","2017","31","Hotel","15","27","102","325","5","5","107","330","1"
"10","2017","31","Otros","12","35","124","241","75","209","199","450","3.5"
"10","2017","31","Otros","11","15","22","36","0","0","22","36","2.3571428571429"
"10","2017","31","Otros","11","15","57","130","0","0","57","130","2.3571428571429"
"10","2017","31","Otros","11","36","127","287","67","120","194","407","5.1904761904762"
"10","2017","31","Hotel","11","36","56","100","12","20","68","120","2.375"
"10","2017","31","Hotel","6","12","50","111","0","0","50","111","5"
"10","2017","31","Otros","8","3","33","43","34","47","67","90","10"
"10","2017","31","Otros","10","27","20","31","16","18","36","49","4.84"
"10","2017","31","Otros","8","3","10","20","2","4","12","24","10"
"10","2017","31","Otros","6","25","6","12","0","0","6","12","2.3846153846154"
"10","2017","31","Hotel","2","27","61","116","0","0","61","116","1"
"10","2017","31","Hotel","10","18","0","0","169","432","169","432","3.2"
"10","2017","31","Otros","11","32","30","44","10","24","40","68","1"
"10","2017","31","Hotel","6","10","1370","1634","335","443","1705","2077","1"
"10","2017","31","Otros","11","32","32","90","5","15","37","105","2.2857142857143"
"10","2017","0","Otros","2","27","0","0","0","0","0","0","1"
"10","2017","0","","12","24","0","0","0","0","0","0","1"
"10","2017","31","Hotel","16","27","572","698","4","20","576","718","5.8571428571429"
"10","2017","31","Hotel","7","38","44","100","0","0","44","100","1"
"10","2017","31","Hotel","6","12","3784","3784","54","54","3838","3838","1"
"11","2017","30","Hotel","14","31","3028","5007","8861","11152","11889","16159","1"
"11","2017","30","Hotel","14","31","704","1009","3532","10588","4236","11597","1"
"11","2017","30","Hotel","14","31","710","883","965","3387","1675","4270","1"
"11","2017","30","Hotel","11","32","42","288","54","107","96","395","1"
"11","2017","30","Hotel","14","27","4067","5521","833","1130","4900","6651","1"
"11","2017","30","Otros","11","32","89","166","0","0","89","166","2.2857142857143"
"11","2017","30","Hotel","14","31","293","427","3860","4880","4153","5307","5.4"
"11","2017","30","Hotel","15","16","949","2696","111","192","1060","2888","1"
"11","2017","30","Hotel","14","31","922","1741","1568","5099","2490","6840","5.4"
"11","2017","30","Hotel","12","24","3108","4638","2647","3994","5755","8632","1"
"11","2017","30","Hotel","16","40","1865","3191","660","1349","2525","4540","1"
"11","2017","30","Hotel","6","12","1217","1574","170","463","1387","2037","1"
"11","2017","30","Hotel","10","23","2712","3229","299","620","3011","3849","1"
"11","2017","30","Hotel","14","31","1587","4015","325","822","1912","4837","5.4"
"11","2017","30","Hotel","3","4","880","2333","340","2378","1220","4711","1"
"11","2017","30","","11","32","424","553","191","343","615","896","1"
"11","2017","30","Hotel","6","12","970","1979","42","122","1012","2101","1"
"11","2017","30","Hotel","6","12","2522","3109","491","580","3013","3689","1"
"11","2017","30","Hotel","9","26","3166","6245","99","198","3265","6443","1"
"11","2017","30","Hotel","2","1","1030","3117","43","459","1073","3576","1"
"11","2017","30","Hotel","9","26","1419","2491","265","1024","1684","3515","1"
"11","2017","30","Hotel","6","12","1028","1657","192","391","1220","2048","1"
"11","2017","30","Hotel","14","31","91","113","4339","8415","4430","8528","5.4"
"11","2017","30","Hotel","11","32","227","288","44","82","271","370","1"
"11","2017","30","Hotel","2","6","1432","2089","177","451","1609","2540","1"
"11","2017","30","Hotel","16","40","1806","2928","1080","1886","2886","4814","1"
"11","2017","30","Hotel","14","27","1555","3698","914","2733","2469","6431","1"
"11","2017","30","Otros","11","36","244","734","0","0","244","734","1"
"11","2017","30","Hotel","10","23","1060","1693","1248","2192","2308","3885","1"
"11","2017","30","Hotel","14","31","527","1551","731","2997","1258","4548","7.8"
"11","2017","30","Hotel","7","17","658","1110","100","272","758","1382","1"
"11","2017","30","Hotel","2","1","1943","3294","0","0","1943","3294","2"
"11","2017","30","Hotel","2","1","2036","3089","292","598","2328","3687","2"
"11","2017","30","Hotel","4","13","766","1297","332","585","1098","1882","1"
"11","2017","30","Hotel","2","1","1135","2017","180","208","1315","2225","2"
"11","2017","30","Hotel","10","27","1464","2974","1191","2173","2655","5147","1"
"11","2017","30","Hotel","14","27","1359","1634","1828","2149","3187","3783","1"
"11","2017","30","Hotel","14","27","1989","2918","1105","2152","3094","5070","1"
"11","2017","30","Hotel","6","12","2132","2365","95","160","2227","2525","1"
"11","2017","30","Hotel","6","12","1996","2598","783","905","2779","3503","1"
"11","2017","30","Hotel","13","27","1762","3377","3","6","1765","3383","1"
"11","2017","30","Hotel","14","31","331","1076","557","2178","888","3254","7.8"
"11","2017","30","Hotel","6","12","1845","3135","379","642","2224","3777","1"
"11","2017","30","Hotel","16","27","2178","3967","166","294","2344","4261","1"
"11","2017","30","","10","27","10","47","0","0","10","47","1"
"11","2017","30","Hotel","10","18","708","1370","706","1638","1414","3008","1"
"11","2017","30","Hotel","9","37","1713","2740","589","1118","2302","3858","1"
"11","2017","30","Hotel","16","27","1235","3707","0","0","1235","3707","1"
"11","2017","30","Hotel","15","16","1009","1795","85","183","1094","1978","2"
"11","2017","30","Hotel","2","1","1385","2286","283","468","1668","2754","2"
"11","2017","30","Hotel","3","4","658","1550","219","431","877","1981","1"
"11","2017","30","Hotel","16","40","1751","2284","1188","1619","2939","3903","1"
"11","2017","30","Hotel","7","17","3182","3757","445","520","3627","4277","1"
"11","2017","30","Hotel","12","24","1027","1689","2226","3045","3253","4734","1"
"11","2017","30","Hotel","12","35","627","1196","2317","3771","2944","4967","1"
"11","2017","30","Hotel","2","6","383","949","12","16","395","965","1"
"11","2017","30","Hotel","13","33","502","826","333","959","835","1785","1"
"11","2017","30","Hotel","10","27","1482","2263","734","874","2216","3137","1"
"11","2017","30","Hotel","10","23","1517","2703","312","553","1829","3256","1"
"11","2017","30","Hotel","11","36","1176","1999","312","659","1488","2658","1"
"11","2017","30","Hotel","8","34","1550","2348","50","150","1600","2498","1"
"11","2017","30","Hotel","2","6","1850","2048","65","120","1915","2168","1"
"11","2017","30","Hotel","14","31","807","1077","1502","1915","2309","2992","7.8"
"11","2017","30","Hotel","11","36","2198","3146","219","378","2417","3524","1"
"11","2017","30","","10","27","546","2183","137","984","683","3167","1"
"11","2017","30","Hotel","14","31","2191","3077","2753","7759","4944","10836","5.4"
"11","2017","30","Hotel","4","13","2919","2935","3","6","2922","2941","1"
"11","2017","30","Hotel","6","28","1292","1562","165","211","1457","1773","1"
"11","2017","30","Otros","14","31","68","128","411","568","479","696","2.8"
"11","2017","30","Otros","16","27","50","100","0","0","50","100","2"
"11","2017","30","Hotel","2","1","947","1625","73","185","1020","1810","2"
"11","2017","30","Hotel","10","18","1289","2906","694","1026","1983","3932","1"
"11","2017","30","Hotel","7","17","1236","1965","152","246","1388","2211","1"
"11","2017","30","Hotel","12","24","737","2100","675","1920","1412","4020","1"
"11","2017","30","Hotel","10","18","1421","2245","404","640","1825","2885","1"
"11","2017","30","Hotel","2","1","2222","2805","32","53","2254","2858","1"
"11","2017","30","Hotel","10","18","374","1241","434","979","808","2220","1"
"11","2017","30","Hotel","6","28","1619","2007","1021","1201","2640","3208","1"
"11","2017","30","Hotel","5","5","1604","1906","386","852","1990","2758","1"
"11","2017","30","Hotel","4","13","562","1052","29","55","591","1107","1"
"11","2017","30","Hotel","10","18","1011","1655","1010","1654","2021","3309","1"
"11","2017","30","Hotel","16","40","1552","2222","124","147","1676","2369","1"
"11","2017","30","Hotel","8","3","2061","3603","554","1062","2615","4665","1"
"11","2017","30","Hotel","15","16","833","1322","179","269","1012","1591","2"
"11","2017","30","Hotel","14","31","110","228","489","2188","599","2416","7.8"
"11","2017","30","Hotel","13","33","621","927","372","435","993","1362","1"
"11","2017","30","Hotel","15","16","1280","2049","292","494","1572","2543","2"
"11","2017","30","Otros","4","21","664","1177","0","0","664","1177","1"
"11","2017","30","Hotel","6","10","834","1186","0","0","834","1186","1"
"11","2017","30","Hotel","16","19","229","281","31","31","260","312","1"
"11","2017","30","Hotel","16","27","560","1492","3","3","563","1495","1"
"11","2017","30","Hotel","10","11","1285","2091","1739","2791","3024","4882","1"
"11","2017","30","Otros","10","23","418","986","12","33","430","1019","1"
"11","2017","30","Hotel","12","35","107","215","734","1357","841","1572","1"
"11","2017","30","Hotel","11","36","642","1197","558","1008","1200","2205","1"
"11","2017","30","Hotel","14","31","95","306","389","1965","484","2271","17.4"
"11","2017","30","Hotel","10","18","569","1178","905","1861","1474","3039","3.2"
"11","2017","30","Hotel","4","13","386","459","65","183","451","642","1"
"11","2017","30","Hotel","6","12","325","550","204","368","529","918","5"
"11","2017","30","Hotel","6","10","1076","1444","60","274","1136","1718","1"
"11","2017","30","Otros","5","5","249","600","179","283","428","883","3.65625"
"11","2017","30","Hotel","12","24","981","1168","1315","1985","2296","3153","1"
"11","2017","30","Hotel","8","3","1022","1794","470","820","1492","2614","1"
"11","2017","30","Hotel","13","27","539","1059","0","0","539","1059","2.75"
"11","2017","30","Hotel","15","16","113","986","30","112","143","1098","4"
"11","2017","30","Otros","15","16","174","582","118","470","292","1052","2"
"11","2017","30","Otros","16","20","213","315","0","0","213","315","1"
"11","2017","30","Hotel","3","4","1010","3150","36","78","1046","3228","1"
"11","2017","30","Hotel","11","36","110","135","0","0","110","135","1"
"11","2017","30","Hotel","2","6","290","1300","71","421","361","1721","1"
"11","2017","30","Hotel","8","34","927","1480","190","302","1117","1782","1"
"11","2017","30","Hotel","4","13","18","34","0","0","18","34","3.2"
"11","2017","30","Hotel","13","27","604","1307","0","0","604","1307","2.75"
"11","2017","30","Hotel","2","29","278","893","655","2242","933","3135","1"
"11","2017","30","Otros","11","36","58","91","2","2","60","93","1"
"11","2017","30","","10","11","5","5","2","28","7","33","1"
"11","2017","30","Hotel","4","13","940","1399","71","275","1011","1674","1"
"11","2017","30","Hotel","16","40","1692","2543","1008","1512","2700","4055","5.6666666666667"
"11","2017","30","Hotel","10","23","801","1325","579","1440","1380","2765","2.8"
"11","2017","30","Hotel","8","34","548","893","359","650","907","1543","1"
"11","2017","30","Hotel","5","5","552","1009","99","380","651","1389","1"
"11","2017","30","Hotel","3","4","115","245","45","97","160","342","3"
"11","2017","30","Hotel","9","26","59","154","11","34","70","188","1"
"11","2017","30","Hotel","8","34","528","805","319","596","847","1401","1"
"11","2017","30","Hotel","7","17","312","478","69","94","381","572","4"
"11","2017","30","Hotel","4","13","208","362","3","3","211","365","3.2"
"11","2017","30","Hotel","12","35","29","87","626","2292","655","2379","1"
"11","2017","30","Hotel","16","40","1126","2114","1947","3867","3073","5981","1"
"11","2017","30","Hotel","9","26","404","866","76","227","480","1093","1"
"11","2017","30","","6","27","289","758","28","128","317","886","1"
"11","2017","30","Hotel","9","26","82","166","4","7","86","173","1"
"11","2017","30","Hotel","4","13","125","229","44","63","169","292","3.2"
"11","2017","30","Hotel","6","28","504","647","44","56","548","703","1"
"11","2017","30","","2","29","55","131","767","2204","822","2335","1"
"11","2017","30","Hotel","13","33","1497","1975","134","221","1631","2196","1"
"11","2017","30","Hotel","8","3","132","240","134","266","266","506","1"
"11","2017","30","Hotel","14","27","343","343","1628","1839","1971","2182","1"
"11","2017","30","Hotel","16","40","469","829","2","4","471","833","5.6666666666667"
"11","2017","30","Hotel","12","24","616","855","706","948","1322","1803","1"
"11","2017","30","Hotel","10","18","814","1880","169","410","983","2290","3.2"
"11","2017","30","Otros","15","16","176","186","21","21","197","207","9"
"11","2017","30","Hotel","6","10","762","833","5","5","767","838","1"
"11","2017","30","Hotel","10","11","594","1137","352","605","946","1742","1"
"11","2017","30","Otros","6","10","64","448","0","0","64","448","3.8518518518518"
"11","2017","30","Otros","10","23","154","463","0","0","154","463","1"
"11","2017","30","Hotel","10","23","457","686","697","1632","1154","2318","2.8"
"11","2017","30","Hotel","6","12","289","398","9","11","298","409","5"
"11","2017","30","Hotel","6","27","114","202","2","2","116","204","3"
"11","2017","30","Hotel","10","23","505","777","478","1088","983","1865","2.8"
"11","2017","30","","4","39","85","154","0","0","85","154","1"
"11","2017","30","Hotel","8","34","228","399","341","570","569","969","1"
"11","2017","30","Hotel","8","34","577","845","335","444","912","1289","1"
"11","2017","30","Otros","4","39","4","4","0","0","4","4","2.2222222222222"
"11","2017","30","Otros","13","14","140","288","0","0","140","288","1"
"11","2017","30","Hotel","10","23","239","322","63","94","302","416","2.8"
"11","2017","30","Otros","13","14","800","1680","0","0","800","1680","1"
"11","2017","30","Hotel","12","24","611","894","529","819","1140","1713","1"
"11","2017","30","","6","25","153","475","0","0","153","475","1"
"11","2017","30","Hotel","15","27","619","948","25","45","644","993","1"
"11","2017","30","Hotel","12","35","139","489","863","2235","1002","2724","1"
"11","2017","30","Hotel","16","40","25","25","995","3205","1020","3230","1"
"11","2017","30","Hotel","16","27","193","333","29","59","222","392","1"
"11","2017","30","Hotel","9","30","163","351","0","0","163","351","1"
"11","2017","30","Hotel","4","13","316","676","2","16","318","692","3.2"
"11","2017","30","Hotel","2","29","51","156","366","1275","417","1431","1"
"11","2017","30","Hotel","16","20","826","920","157","160","983","1080","1"
"11","2017","30","Hotel","5","5","514","783","276","320","790","1103","1"
"11","2017","30","Hotel","13","33","509","801","59","110","568","911","1"
"11","2017","30","Otros","16","19","115","151","2","4","117","155","1.3333333333333"
"11","2017","30","Hotel","12","24","143","346","349","731","492","1077","1"
"11","2017","30","","8","2","305","513","106","165","411","678","1"
"11","2017","30","Hotel","12","35","6","34","280","1926","286","1960","1"
"11","2017","30","Hotel","16","27","80","83","354","476","434","559","2.5"
"11","2017","30","Otros","16","27","523","905","38","62","561","967","2"
"11","2017","30","Hotel","8","34","646","887","225","256","871","1143","1"
"11","2017","30","Otros","8","3","513","1566","6","12","519","1578","1"
"11","2017","30","Hotel","7","27","265","435","78","173","343","608","1"
"11","2017","30","Hotel","4","39","196","324","6","23","202","347","1"
"11","2017","30","Hotel","15","16","210","420","19","38","229","458","4"
"11","2017","30","Hotel","4","39","76","217","2","4","78","221","1"
"11","2017","30","Hotel","4","39","154","282","77","314","231","596","1"
"11","2017","30","Hotel","15","16","237","1124","7","7","244","1131","4"
"11","2017","30","Hotel","14","31","21","46","253","735","274","781","17.4"
"11","2017","30","Hotel","8","34","389","772","191","250","580","1022","1"
"11","2017","30","Hotel","6","28","266","404","49","85","315","489","1"
"11","2017","30","Hotel","7","17","732","1050","100","386","832","1436","4"
"11","2017","30","Otros","7","27","29","238","0","0","29","238","1"
"11","2017","30","Hotel","11","36","1113","1339","54","81","1167","1420","1"
"11","2017","30","Otros","4","21","246","406","245","532","491","938","1"
"11","2017","30","Otros","15","16","147","149","64","64","211","213","2"
"11","2017","30","Otros","7","17","263","496","11","28","274","524","3"
"11","2017","30","Hotel","7","38","28","34","6","12","34","46","1"
"11","2017","30","Hotel","16","27","656","786","124","160","780","946","2.5"
"11","2017","30","Hotel","2","6","51","73","0","0","51","73","2.2"
"11","2017","30","Hotel","11","36","369","665","146","280","515","945","1"
"11","2017","30","Hotel","6","28","45","60","9","12","54","72","1"
"11","2017","30","Hotel","6","12","98","175","0","0","98","175","5"
"11","2017","30","Otros","9","22","36","56","0","0","36","56","1"
"11","2017","30","","13","14","409","585","12","12","421","597","2"
"11","2017","30","Hotel","2","29","80","214","631","1377","711","1591","1"
"11","2017","30","Hotel","2","29","56","89","82","312","138","401","1"
"11","2017","30","Otros","4","13","393","419","21","21","414","440","1"
"11","2017","30","Hotel","15","16","59","179","31","86","90","265","4"
"11","2017","30","Hotel","2","1","154","352","3","7","157","359","6.4"
"11","2017","30","Otros","7","27","283","545","0","0","283","545","1"
"11","2017","30","Otros","13","33","15","15","0","0","15","15","5.125"
"11","2017","30","","4","21","567","674","0","0","567","674","1"
"11","2017","30","Hotel","6","10","368","368","5","5","373","373","1"
"11","2017","30","Hotel","11","36","84","171","4","12","88","183","1"
"11","2017","30","Otros","14","31","102","190","223","484","325","674","2.8"
"11","2017","30","Hotel","7","27","165","294","18","82","183","376","1"
"11","2017","30","Otros","6","10","26","409","0","0","26","409","3.8518518518518"
"11","2017","30","Hotel","4","39","10","20","2","2","12","22","2.6"
"11","2017","30","Otros","8","2","15","23","39","76","54","99","6.4285714285714"
"11","2017","30","Otros","11","36","44","99","8","16","52","115","5.1904761904762"
"11","2017","30","Hotel","13","33","380","780","0","0","380","780","1"
"11","2017","30","","3","4","70","90","39","47","109","137","1"
"11","2017","30","Hotel","7","17","243","572","44","97","287","669","4"
"11","2017","30","Hotel","8","2","123","166","15","15","138","181","1"
"11","2017","30","Otros","15","16","180","245","16","27","196","272","2"
"11","2017","30","Hotel","10","11","660","822","12","17","672","839","1"
"11","2017","30","Hotel","16","19","323","609","0","0","323","609","1"
"11","2017","30","Hotel","10","23","84","121","69","125","153","246","4"
"11","2017","30","","7","38","215","297","47","75","262","372","1"
"11","2017","30","Hotel","7","27","421","708","0","0","421","708","1"
"11","2017","30","Hotel","11","36","435","973","88","204","523","1177","1"
"11","2017","30","Hotel","16","40","185","306","10","27","195","333","16.333333333333"
"11","2017","30","Hotel","16","19","49","61","0","0","49","61","1"
"11","2017","30","Hotel","16","19","8","12","0","0","8","12","1"
"11","2017","0","Hotel","16","20","0","0","0","0","0","0","1"
"11","2017","30","Hotel","10","11","189","249","39","61","228","310","1"
"11","2017","30","Otros","7","27","79","108","11","17","90","125","4.8333333333333"
"11","2017","30","Otros","7","27","24","98","0","0","24","98","1"
"11","2017","30","Hotel","7","27","41","50","1","1","42","51","4.1666666666667"
"11","2017","30","Otros","13","14","54","70","0","0","54","70","1"
"11","2017","30","Otros","11","15","48","54","0","0","48","54","2.3571428571429"
"11","2017","30","Otros","10","27","30","67","29","62","59","129","4.84"
"11","2017","30","Otros","14","31","172","172","2561","2561","2733","2733","2.8"
"11","2017","30","Otros","11","36","17","20","6","11","23","31","5.1904761904762"
"11","2017","30","Hotel","16","19","42","42","2","2","44","44","1"
"11","2017","30","","14","27","280","426","8","12","288","438","2.6666666666667"
"11","2017","30","Hotel","16","40","123","135","6","6","129","141","5.6666666666667"
"11","2017","30","Hotel","10","27","10","41","0","0","10","41","2.25"
"11","2017","30","Otros","2","29","87","214","322","735","409","949","3.28"
"11","2017","30","Hotel","13","27","0","0","28","64","28","64","1"
"11","2017","30","Otros","9","22","18","20","0","0","18","20","1"
"11","2017","30","Hotel","2","27","145","332","18","80","163","412","1"
"11","2017","30","Hotel","8","34","442","882","202","330","644","1212","1"
"11","2017","30","Hotel","7","27","306","462","0","0","306","462","1"
"11","2017","30","Hotel","15","16","248","492","33","62","281","554","4"
"11","2017","0","Hotel","16","20","0","0","0","0","0","0","1"
"11","2017","30","Otros","4","13","82","488","3","15","85","503","1"
"11","2017","30","Hotel","2","1","166","377","15","17","181","394","6.4"
"11","2017","30","Otros","11","32","9","13","0","0","9","13","2.2857142857143"
"11","2017","30","Hotel","2","29","12","59","255","1439","267","1498","1"
"11","2017","30","Hotel","16","27","113","116","120","122","233","238","2.5"
"11","2017","30","Hotel","10","18","84","204","42","126","126","330","3.2"
"11","2017","30","Otros","11","36","438","808","48","81","486","889","1"
"11","2017","30","Otros","13","14","45","626","0","0","45","626","1"
"11","2017","30","Hotel","7","27","116","172","0","0","116","172","1"
"11","2017","30","Otros","7","17","111","185","28","107","139","292","3"
"11","2017","30","Otros","14","31","242","407","303","746","545","1153","2.8"
"11","2017","30","Hotel","2","29","257","740","278","1006","535","1746","1"
"11","2017","30","Hotel","8","3","141","514","193","406","334","920","1"
"11","2017","30","Hotel","8","34","355","541","115","193","470","734","2.5714285714286"
"11","2017","30","Hotel","8","34","310","404","199","473","509","877","2.5714285714286"
"11","2017","30","Hotel","12","35","55","67","87","113","142","180","1"
"11","2017","30","Hotel","11","32","93","166","116","231","209","397","1"
"11","2017","30","Hotel","13","33","333","566","29","34","362","600","2"
"11","2017","30","Hotel","10","23","242","341","65","115","307","456","2.8"
"11","2017","30","Hotel","12","35","257","858","17","22","274","880","1"
"11","2017","30","","16","40","338","479","74","155","412","634","3.0555555555556"
"11","2017","30","Otros","16","19","11","27","0","0","11","27","1.3333333333333"
"11","2017","30","Otros","16","20","32","128","0","0","32","128","1"
"11","2017","30","Hotel","6","12","170","436","10","24","180","460","5"
"11","2017","30","Hotel","16","19","145","171","0","0","145","171","4"
"11","2017","30","Hotel","12","24","197","430","123","257","320","687","1"
"11","2017","30","Hotel","12","24","226","421","290","347","516","768","3"
"11","2017","30","Hotel","8","3","40","280","60","240","100","520","1"
"11","2017","30","Hotel","5","9","2","2","13","13","15","15","1"
"11","2017","30","Hotel","16","27","208","364","28","75","236","439","2.5"
"11","2017","30","Otros","10","23","36","36","0","0","36","36","7"
"11","2017","30","Otros","13","14","87","217","2","2","89","219","7.3846153846154"
"11","2017","30","Otros","2","6","36","96","9","24","45","120","1"
"11","2017","30","Hotel","15","16","22","22","110","138","132","160","7.8"
"11","2017","30","Hotel","8","3","200","994","0","0","200","994","1"
"11","2017","30","Hotel","8","34","453","833","200","330","653","1163","1"
"11","2017","30","Hotel","8","3","122","188","95","271","217","459","1"
"11","2017","30","","2","29","95","298","54","181","149","479","1"
"11","2017","30","Hotel","2","1","439","608","29","32","468","640","6.4"
"11","2017","30","Hotel","7","17","167","222","0","0","167","222","4"
"11","2017","30","Otros","7","17","215","596","0","0","215","596","3"
"11","2017","30","Hotel","16","40","157","244","90","193","247","437","5.6666666666667"
"11","2017","30","Hotel","12","24","244","462","481","569","725","1031","1"
"11","2017","30","Hotel","14","31","274","456","315","1100","589","1556","17.4"
"11","2017","0","Hotel","9","26","0","0","0","0","0","0","1"
"11","2017","30","Hotel","6","12","42","42","0","0","42","42","5"
"11","2017","30","Otros","5","9","39","39","21","21","60","60","4.0454545454545"
"11","2017","30","Otros","5","9","3","3","1","1","4","4","4.0454545454545"
"11","2017","30","Otros","15","27","57","91","0","0","57","91","1.4222222222222"
"11","2017","30","Hotel","8","34","17","21","5","5","22","26","2.5714285714286"
"11","2017","30","Hotel","10","18","262","574","200","474","462","1048","7.75"
"11","2017","30","Hotel","15","16","246","557","62","139","308","696","7.8"
"11","2017","30","Hotel","2","29","49","123","518","1442","567","1565","1"
"11","2017","30","Hotel","4","39","79","334","29","117","108","451","2.6"
"11","2017","30","Otros","4","39","131","189","1","1","132","190","2.2222222222222"
"11","2017","30","Hotel","4","13","102","205","16","118","118","323","5.4"
"11","2017","30","Otros","10","23","140","179","0","0","140","179","7"
"11","2017","30","Otros","14","31","86","130","461","973","547","1103","20.2"
"11","2017","30","Hotel","3","4","60","89","0","0","60","89","2.6"
"11","2017","30","Hotel","10","23","147","342","46","113","193","455","4"
"11","2017","30","Otros","9","22","250","907","0","0","250","907","1"
"11","2017","30","Hotel","12","24","209","320","381","513","590","833","3"
"11","2017","30","Hotel","13","14","4","6","0","0","4","6","1"
"11","2017","30","Hotel","12","35","101","169","271","374","372","543","1.7272727272727"
"11","2017","30","Hotel","6","28","359","564","0","0","359","564","1"
"11","2017","30","","6","28","98","135","0","0","98","135","1"
"11","2017","30","Hotel","12","24","333","657","139","288","472","945","3"
"11","2017","30","Otros","5","9","10","10","0","0","10","10","4.0454545454545"
"11","2017","30","Hotel","16","20","27","30","1","1","28","31","1"
"11","2017","30","Hotel","4","21","143","229","29","29","172","258","3"
"11","2017","30","Otros","10","11","28","59","0","0","28","59","11.764705882353"
"11","2017","30","Otros","13","14","20","50","0","0","20","50","7.3846153846154"
"11","2017","15","Otros","16","27","18","20","0","0","18","20","13.818181818182"
"11","2017","30","Hotel","9","26","144","288","0","0","144","288","1"
"11","2017","30","Hotel","16","27","523","655","402","581","925","1236","2.5"
"11","2017","30","Hotel","3","4","1094","2638","142","296","1236","2934","3"
"11","2017","30","Otros","16","27","10","20","34","165","44","185","2"
"11","2017","30","Otros","16","19","716","1430","0","0","716","1430","1.3333333333333"
"11","2017","30","Hotel","6","12","654","891","23","23","677","914","5"
"11","2017","30","Hotel","2","1","229","448","4","6","233","454","6.4"
"11","2017","30","Hotel","10","11","379","685","47","72","426","757","1"
"11","2017","30","Otros","10","23","82","82","0","0","82","82","1"
"11","2017","30","Otros","10","27","909","1006","177","225","1086","1231","4.84"
"11","2017","30","Hotel","16","27","203","294","59","216","262","510","2.5"
"11","2017","30","Hotel","6","28","179","247","24","28","203","275","1"
"11","2017","30","Hotel","4","13","69","134","14","33","83","167","5.4"
"11","2017","30","Hotel","14","27","607","777","38","50","645","827","8.5"
"11","2017","30","Hotel","10","27","179","283","397","533","576","816","1"
"11","2017","30","Hotel","13","27","135","207","70","98","205","305","4.2"
"11","2017","30","Hotel","3","4","533","796","25","42","558","838","3"
"11","2017","30","Otros","4","13","64","102","7","20","71","122","3.4"
"11","2017","30","Otros","11","15","1","2","0","0","1","2","2.3571428571429"
"11","2017","6","Otros","6","10","96","192","0","0","96","192","3.8518518518518"
"11","2017","30","Otros","2","1","35","58","2","4","37","62","1"
"11","2017","30","","6","12","44","286","1","1","45","287","1"
"11","2017","30","Otros","10","23","236","785","45","113","281","898","1"
"11","2017","30","Hotel","16","19","19","24","0","0","19","24","4"
"11","2017","30","Hotel","10","11","16","96","0","0","16","96","5.6666666666667"
"11","2017","30","Hotel","10","23","33","33","1","1","34","34","4"
"11","2017","30","Otros","14","31","61","172","251","616","312","788","2.8"
"11","2017","30","Otros","13","27","10","10","0","0","10","10","12.2"
"11","2017","30","Hotel","2","1","236","806","0","0","236","806","6.4"
"11","2017","8","Hotel","16","19","32","32","0","0","32","32","4"
"11","2017","30","Otros","12","35","35","62","15","23","50","85","3.5"
"11","2017","30","Otros","15","16","23","60","16","30","39","90","2"
"11","2017","30","Otros","9","22","322","644","53","106","375","750","1"
"11","2017","30","Hotel","10","27","346","571","462","521","808","1092","1"
"11","2017","30","Hotel","2","27","52","66","6","18","58","84","3.6"
"11","2017","30","Hotel","16","20","54","102","54","128","108","230","1"
"11","2017","30","Hotel","10","18","136","269","110","190","246","459","7.75"
"11","2017","30","Hotel","6","12","287","287","0","0","287","287","5"
"11","2017","30","Hotel","2","27","100","162","10","20","110","182","3.6"
"11","2017","30","Hotel","15","16","35","50","10","13","45","63","7.8"
"11","2017","30","Hotel","10","23","88","88","22","22","110","110","4"
"11","2017","30","Hotel","11","32","18","18","3","3","21","21","1"
"11","2017","30","Hotel","14","27","153","345","57","194","210","539","8.5"
"11","2017","30","Otros","10","11","14","18","0","0","14","18","11.764705882353"
"11","2017","30","Hotel","2","27","98","126","10","14","108","140","3.6"
"11","2017","30","Otros","13","14","200","321","9","12","209","333","7.3846153846154"
"11","2017","30","Hotel","2","1","146","168","6","12","152","180","6.4"
"11","2017","30","Otros","7","17","224","579","12","36","236","615","17.166666666667"
"11","2017","30","Otros","10","23","19","102","0","0","19","102","7"
"11","2017","30","Hotel","13","27","204","204","6","6","210","210","2.75"
"11","2017","30","Otros","10","18","64","186","8","16","72","202","10.25"
"11","2017","30","Otros","5","9","48","246","0","0","48","246","4.0454545454545"
"11","2017","30","Hotel","4","39","116","205","5","6","121","211","2.6"
"11","2017","30","Otros","16","27","89","434","29","78","118","512","13.818181818182"
"11","2017","30","Hotel","14","27","45","68","77","238","122","306","8.5"
"11","2017","30","Hotel","10","11","199","335","55","100","254","435","5.6666666666667"
"11","2017","30","Hotel","10","18","96","359","0","0","96","359","7.75"
"11","2017","30","Otros","14","31","141","225","87","179","228","404","20.2"
"11","2017","30","Otros","11","32","14","26","0","0","14","26","2.2857142857143"
"11","2017","30","Otros","5","5","74","86","2","4","76","90","3.65625"
"11","2017","30","Otros","6","25","64","440","0","0","64","440","2.3846153846154"
"11","2017","30","Hotel","3","4","54","106","3","9","57","115","2.6"
"11","2017","30","Otros","7","27","178","272","2","2","180","274","4.8333333333333"
"11","2017","30","Otros","2","29","65","188","85","223","150","411","3.28"
"11","2017","30","Hotel","2","29","78","207","178","535","256","742","1"
"11","2017","30","Otros","4","21","188","349","12","27","200","376","1"
"11","2017","30","Hotel","7","27","260","298","0","0","260","298","4.1666666666667"
"11","2017","30","Otros","5","5","14","31","0","0","14","31","3.65625"
"11","2017","30","Otros","11","36","17","37","94","169","111","206","5.1904761904762"
"11","2017","30","Hotel","7","27","668","668","0","0","668","668","4.1666666666667"
"11","2017","0","Hotel","16","20","0","0","0","0","0","0","1"
"11","2017","30","Hotel","12","24","116","210","402","531","518","741","3"
"11","2017","30","Hotel","9","26","136","248","2","8","138","256","1.5"
"11","2017","30","Hotel","7","17","263","442","11","29","274","471","10"
"11","2017","30","Hotel","9","37","305","414","50","94","355","508","3.4"
"11","2017","30","Hotel","5","5","447","705","109","127","556","832","2.1428571428571"
"11","2017","30","Otros","6","27","127","254","10","20","137","274","3.960088691796"
"11","2017","30","Hotel","9","37","114","254","8","8","122","262","3.4"
"11","2017","30","Otros","10","27","66","110","0","0","66","110","4.84"
"11","2017","30","Otros","8","3","130","258","27","65","157","323","10"
"11","2017","30","Otros","16","20","17","20","3","3","20","23","3.0769230769231"
"11","2017","30","Otros","9","22","7","16","0","0","7","16","7.6428571428571"
"11","2017","30","Otros","10","27","206","310","64","64","270","374","4.84"
"11","2017","30","Otros","10","23","46","73","7","7","53","80","7"
"11","2017","30","Otros","2","6","512","512","178","178","690","690","1"
"11","2017","30","Otros","4","39","13","13","0","0","13","13","2.2222222222222"
"11","2017","30","Hotel","2","27","62","73","32","38","94","111","1"
"11","2017","30","Hotel","14","31","50","123","134","758","184","881","24"
"11","2017","30","Otros","2","29","126","352","120","280","246","632","3.28"
"11","2017","30","Otros","8","3","264","792","0","0","264","792","10"
"11","2017","30","","13","14","32","45","2","2","34","47","1"
"11","2017","30","Hotel","6","10","275","366","21","21","296","387","6.6"
"11","2017","30","Hotel","8","34","98","109","61","83","159","192","2.5714285714286"
"11","2017","30","Hotel","9","22","221","1200","0","0","221","1200","2.5555555555556"
"11","2017","30","Hotel","2","6","122","255","28","40","150","295","2.2"
"11","2017","30","Hotel","10","27","142","233","185","224","327","457","2.25"
"11","2017","30","Otros","14","27","208","208","0","0","208","208","11.833333333333"
"11","2017","30","Otros","6","12","373","581","16","40","389","621","1.8256578947368"
"11","2017","30","Hotel","6","27","104","162","0","0","104","162","3"
"11","2017","30","Hotel","5","5","13","23","5","10","18","33","2.1428571428571"
"11","2017","30","Hotel","5","5","84","88","36","46","120","134","2.1428571428571"
"11","2017","30","Hotel","13","27","271","271","0","0","271","271","4.2"
"11","2017","30","Hotel","2","27","180","438","0","0","180","438","3.6"
"11","2017","30","Hotel","8","3","40","40","53","53","93","93","4.1111111111111"
"11","2017","30","Otros","11","36","90","279","5","21","95","300","5.1904761904762"
"11","2017","30","Otros","9","30","142","379","0","0","142","379","2.3333333333333"
"11","2017","30","Otros","16","19","5","16","0","0","5","16","10.263157894737"
"11","2017","30","Hotel","14","31","77","123","332","955","409","1078","17.4"
"11","2017","30","Hotel","2","1","232","341","5","6","237","347","6.4"
"11","2017","30","Hotel","16","40","886","1356","738","972","1624","2328","5.6666666666667"
"11","2017","30","Otros","7","17","346","592","6","9","352","601","17.166666666667"
"11","2017","30","Hotel","13","27","414","523","181","314","595","837","2.75"
"11","2017","30","Hotel","14","31","458","742","287","410","745","1152","24"
"11","2017","30","Otros","3","4","35","85","7","25","42","110","12.2"
"11","2017","30","Otros","8","34","224","295","177","287","401","582","5.75"
"11","2017","30","Hotel","9","22","52","60","0","0","52","60","2.5555555555556"
"11","2017","30","Hotel","4","21","42","49","3","3","45","52","3"
"11","2017","30","Hotel","6","27","73","96","0","0","73","96","3"
"11","2017","30","Hotel","12","35","55","73","236","309","291","382","1.7272727272727"
"11","2017","30","Hotel","2","29","27","61","219","422","246","483","2"
"11","2017","30","Otros","10","11","87","113","8","12","95","125","11.764705882353"
"11","2017","30","Hotel","6","10","106","167","0","0","106","167","6.6"
"11","2017","10","Hotel","13","14","33","33","0","0","33","33","2"
"11","2017","8","Otros","16","27","51","57","0","0","51","57","13.818181818182"
"11","2017","30","Otros","6","27","24","24","3","3","27","27","3.960088691796"
"11","2017","30","Hotel","16","40","180","360","494","948","674","1308","5.6666666666667"
"11","2017","30","Otros","6","10","0","0","6","6","6","6","3.8518518518518"
"11","2017","30","Otros","10","23","4","8","2","2","6","10","7"
"11","2017","30","Hotel","6","28","214","226","19","23","233","249","1"
"11","2017","30","Otros","7","38","186","317","12","16","198","333","2.75"
"11","2017","30","Hotel","6","12","255","369","0","0","255","369","5"
"11","2017","30","Hotel","13","27","217","295","15","28","232","323","4.2"
"11","2017","30","Otros","4","21","15","32","0","0","15","32","4.8333333333333"
"11","2017","30","Hotel","16","27","56","176","7","12","63","188","5.8571428571429"
"11","2017","30","Hotel","5","5","57","77","51","61","108","138","2.1428571428571"
"11","2017","30","Otros","12","24","56","103","86","124","142","227","9.2"
"11","2017","30","Otros","15","16","79","127","24","40","103","167","9"
"11","2017","30","Hotel","8","27","77","77","0","0","77","77","4.5"
"11","2017","30","Hotel","9","22","2","4","0","0","2","4","2.5555555555556"
"11","2017","30","Hotel","10","11","189","283","47","73","236","356","5.6666666666667"
"11","2017","30","Hotel","8","3","79","207","29","63","108","270","4.1111111111111"
"11","2017","30","Hotel","6","10","299","445","2","2","301","447","6.6"
"11","2017","30","Otros","9","26","28","93","13","222","41","315","3.8888888888889"
"11","2017","30","Hotel","4","39","84","227","17","64","101","291","2.6"
"11","2017","30","Otros","6","27","28","81","0","0","28","81","3.960088691796"
"11","2017","30","Otros","6","12","144","200","0","0","144","200","1.8256578947368"
"11","2017","30","Hotel","6","27","90","160","0","0","90","160","3"
"11","2017","30","Otros","5","9","66","98","24","26","90","124","4.0454545454545"
"11","2017","30","Hotel","2","27","145","145","19","19","164","164","3.6"
"11","2017","30","Hotel","2","29","87","261","248","744","335","1005","1"
"11","2017","30","Hotel","4","13","232","320","5","5","237","325","5.4"
"11","2017","30","","11","15","50","284","0","0","50","284","1"
"11","2017","30","Hotel","6","10","411","411","7","7","418","418","6.6"
"11","2017","30","Otros","6","12","25","53","0","0","25","53","1.8256578947368"
"11","2017","30","Otros","10","18","50","54","12","12","62","66","10.25"
"11","2017","30","Otros","9","22","80","105","5","9","85","114","7.6428571428571"
"11","2017","30","","14","27","300","300","10","10","310","310","1"
"11","2017","30","Hotel","16","27","84","132","3","3","87","135","5.8571428571429"
"11","2017","30","Otros","2","29","16","45","12","21","28","66","3.28"
"11","2017","30","Otros","13","33","73","83","1","1","74","84","5.125"
"11","2017","30","Otros","13","33","43","61","0","0","43","61","5.125"
"11","2017","30","Otros","6","10","161","577","0","0","161","577","3.8518518518518"
"11","2017","30","Hotel","10","18","65","118","86","168","151","286","7.75"
"11","2017","30","Hotel","14","31","136","294","76","277","212","571","24"
"11","2017","30","Hotel","4","21","84","84","6","6","90","90","3"
"11","2017","30","Hotel","3","4","36","45","1","9","37","54","2.6"
"11","2017","30","Otros","8","27","78","171","27","130","105","301","1"
"11","2017","30","Otros","6","27","20","55","0","0","20","55","3.960088691796"
"11","2017","30","Hotel","6","25","203","615","0","0","203","615","1"
"11","2017","30","Otros","6","12","416","606","0","0","416","606","1.8256578947368"
"11","2017","30","Hotel","6","27","19","21","0","0","19","21","3"
"11","2017","30","Otros","6","27","12","24","0","0","12","24","3.960088691796"
"11","2017","30","Otros","6","10","20","30","0","0","20","30","3.8518518518518"
"11","2017","30","Otros","6","12","116","368","0","0","116","368","1.8256578947368"
"11","2017","30","Otros","5","5","19","26","6","10","25","36","3.65625"
"11","2017","30","Hotel","12","24","113","500","36","148","149","648","3"
"11","2017","30","Hotel","15","16","192","225","1","1","193","226","7.8"
"11","2017","30","Otros","4","13","74","118","1","2","75","120","3.4"
"11","2017","30","Hotel","2","29","208","643","114","303","322","946","1"
"11","2017","30","Hotel","4","21","17","45","0","0","17","45","3"
"11","2017","30","Hotel","10","27","120","211","423","542","543","753","2.25"
"11","2017","30","Hotel","8","3","188","281","60","121","248","402","4.1111111111111"
"11","2017","30","Hotel","12","27","58","112","87","98","145","210","1"
"11","2017","30","Otros","5","5","140","409","0","0","140","409","3.65625"
"11","2017","30","Otros","13","14","12","12","0","0","12","12","7.3846153846154"
"11","2017","30","Otros","10","11","171","531","58","67","229","598","11.764705882353"
"11","2017","30","Otros","16","40","383","489","7","12","390","501","28.142857142857"
"11","2017","30","Hotel","11","36","351","985","31","82","382","1067","1"
"11","2017","30","Otros","8","34","78","159","39","65","117","224","5.75"
"11","2017","30","Hotel","7","17","59","88","4","8","63","96","10"
"11","2017","30","Otros","12","35","246","423","9","14","255","437","3.5"
"11","2017","30","Otros","5","9","13","26","30","48","43","74","4.0454545454545"
"11","2017","30","Hotel","9","22","42","52","0","0","42","52","2.5555555555556"
"11","2017","30","Otros","2","29","37","69","73","154","110","223","3.28"
"11","2017","30","Otros","2","29","60","146","43","105","103","251","3.28"
"11","2017","30","Hotel","10","27","102","345","59","95","161","440","2.25"
"11","2017","30","Hotel","16","19","160","233","97","151","257","384","4"
"11","2017","30","Hotel","16","40","143","397","36","112","179","509","16.333333333333"
"11","2017","30","Hotel","8","27","177","311","38","39","215","350","4.5"
"11","2017","30","Otros","13","14","21","26","0","0","21","26","7.3846153846154"
"11","2017","30","Hotel","7","27","56","59","0","0","56","59","4.1666666666667"
"11","2017","30","Otros","2","6","1","1","0","0","1","1","5"
"11","2017","30","Hotel","7","17","354","663","6","11","360","674","10"
"11","2017","30","Hotel","3","4","101","220","100","181","201","401","2.6"
"11","2017","30","Otros","6","12","12","166","0","0","12","166","1.8256578947368"
"11","2017","30","Otros","6","10","9","9","0","0","9","9","3.8518518518518"
"11","2017","30","Hotel","16","40","68","116","10","20","78","136","16.333333333333"
"11","2017","30","Otros","4","39","16","46","2","4","18","50","2.2222222222222"
"11","2017","30","Otros","13","14","4","8","0","0","4","8","7.3846153846154"
"11","2017","30","Otros","7","38","74","106","10","20","84","126","2.75"
"11","2017","30","Hotel","11","32","49","85","0","0","49","85","1"
"11","2017","30","Otros","11","36","177","305","15","27","192","332","5.1904761904762"
"11","2017","30","Hotel","4","21","113","173","0","0","113","173","3"
"11","2017","30","Otros","3","4","21","41","0","0","21","41","12.2"
"11","2017","30","Otros","5","9","74","111","20","34","94","145","4.0454545454545"
"11","2017","30","Hotel","8","27","82","97","6","14","88","111","4.5"
"11","2017","30","","7","17","461","1461","0","0","461","1461","1"
"11","2017","30","Otros","16","20","127","164","0","0","127","164","3.0769230769231"
"11","2017","30","Otros","4","21","7","69","2","2","9","71","4.8333333333333"
"11","2017","30","Otros","13","33","115","127","24","25","139","152","5.125"
"11","2017","30","","12","35","0","0","361","1453","361","1453","1"
"11","2017","30","Hotel","13","33","1","1","0","0","1","1","2"
"11","2017","30","Otros","4","39","20","40","0","0","20","40","2.2222222222222"
"11","2017","30","Otros","10","18","35","122","12","46","47","168","10.25"
"11","2017","30","Otros","6","27","80","116","4","4","84","120","3.960088691796"
"11","2017","30","Hotel","4","39","73","293","0","0","73","293","2.6"
"11","2017","30","Otros","14","31","58","106","109","215","167","321","20.2"
"11","2017","30","Hotel","2","29","43","115","312","667","355","782","2"
"11","2017","30","Hotel","9","26","234","376","1","1","235","377","1.5"
"11","2017","30","Otros","12","35","7","10","6","8","13","18","3.5"
"11","2017","30","Hotel","14","27","175","218","36","44","211","262","8.5"
"11","2017","20","Otros","11","36","34","77","8","20","42","97","5.1904761904762"
"11","2017","30","Otros","16","20","199","372","32","88","231","460","3.0769230769231"
"11","2017","30","Otros","4","39","3","10","0","0","3","10","2.2222222222222"
"11","2017","30","Otros","7","27","130","146","5","9","135","155","4.8333333333333"
"11","2017","30","Otros","6","27","109","125","3","5","112","130","3.960088691796"
"11","2017","30","Otros","5","8","10","300","0","0","10","300","5"
"11","2017","30","Otros","9","37","128","224","35","77","163","301","4.5"
"11","2017","30","Hotel","2","6","42","148","0","0","42","148","5.5"
"11","2017","30","Hotel","10","27","255","395","132","158","387","553","2.25"
"11","2017","30","Hotel","9","30","150","247","66","104","216","351","1"
"11","2017","30","Otros","4","13","57","91","5","6","62","97","3.4"
"11","2017","30","Hotel","5","5","370","370","0","0","370","370","1"
"11","2017","30","Otros","7","38","64","112","11","32","75","144","2.75"
"11","2017","30","Hotel","13","14","102","398","0","0","102","398","1"
"11","2017","30","Otros","5","9","5","5","35","35","40","40","4.0454545454545"
"11","2017","30","Otros","5","8","21","27","1","1","22","28","5"
"11","2017","30","Otros","10","27","17","510","0","0","17","510","4.84"
"11","2017","30","Hotel","13","14","5","13","0","0","5","13","1"
"11","2017","30","Otros","11","15","23","35","0","0","23","35","2.3571428571429"
"11","2017","30","Hotel","9","22","127","218","0","0","127","218","2.5555555555556"
"11","2017","30","Otros","11","36","102","155","11","11","113","166","5.1904761904762"
"11","2017","30","Hotel","10","18","1321","2444","2079","4076","3400","6520","1"
"11","2017","30","Hotel","6","12","103","144","0","0","103","144","5"
"11","2017","30","","2","29","297","612","965","2489","1262","3101","1"
"11","2017","30","Hotel","16","27","1045","2134","49","128","1094","2262","1"
"11","2017","30","","14","31","374","755","574","2071","948","2826","1"
"11","2017","30","Hotel","8","3","22","44","25","82","47","126","4.1111111111111"
"11","2017","30","Otros","13","33","59","84","46","63","105","147","5.125"
"11","2017","30","","14","27","312","528","10","16","322","544","2.6666666666667"
"11","2017","30","Otros","9","22","83","458","0","0","83","458","7.6428571428571"
"11","2017","30","Hotel","10","11","22","24","7","15","29","39","5.6666666666667"
"11","2017","30","Otros","6","12","15","48","0","0","15","48","1.8256578947368"
"11","2017","30","Hotel","8","3","108","180","83","112","191","292","4.1111111111111"
"11","2017","30","Otros","6","12","250","535","0","0","250","535","1.8256578947368"
"11","2017","30","Hotel","8","27","267","267","0","0","267","267","4.5"
"11","2017","30","Hotel","6","28","177","202","16","21","193","223","2.4"
"11","2017","30","Otros","6","25","46","320","0","0","46","320","2.3846153846154"
"11","2017","30","Otros","6","25","60","97","0","0","60","97","2.3846153846154"
"11","2017","30","Hotel","11","36","435","1557","0","0","435","1557","1"
"11","2017","30","Otros","2","6","35","119","204","569","239","688","5"
"11","2017","30","Hotel","14","31","63","105","138","395","201","500","24"
"11","2017","30","Otros","4","21","9","12","8","10","17","22","4.8333333333333"
"11","2017","30","Otros","7","38","16","20","0","0","16","20","2.75"
"11","2017","30","Otros","13","14","20","24","0","0","20","24","7.3846153846154"
"11","2017","30","Otros","2","29","29","29","101","288","130","317","3.28"
"11","2017","30","Otros","3","4","100","100","27","27","127","127","12.2"
"11","2017","30","Hotel","3","4","396","751","58","125","454","876","3"
"11","2017","30","Otros","7","27","132","146","23","25","155","171","1"
"11","2017","30","Otros","7","17","147","164","0","0","147","164","3"
"11","2017","30","Hotel","12","27","226","469","14","14","240","483","1"
"11","2017","30","Otros","5","5","32","58","24","53","56","111","3.65625"
"11","2017","30","Hotel","6","10","208","348","6","6","214","354","6.6"
"11","2017","30","Otros","10","18","46","162","16","47","62","209","10.25"
"11","2017","30","Otros","8","27","42","71","0","0","42","71","9.4"
"11","2017","30","Otros","8","3","12","38","13","25","25","63","10"
"11","2017","30","Hotel","16","27","32","44","2","4","34","48","5.8571428571429"
"11","2017","30","Otros","6","10","127","271","0","0","127","271","3.8518518518518"
"11","2017","30","Hotel","2","6","39","58","3","3","42","61","5.5"
"11","2017","30","Hotel","8","3","12","22","2","12","14","34","4.1111111111111"
"11","2017","30","Otros","10","11","43","397","14","31","57","428","11.764705882353"
"11","2017","30","Otros","6","27","69","88","0","0","69","88","3.960088691796"
"11","2017","30","Otros","15","16","6","11","0","0","6","11","9"
"11","2017","30","Otros","5","5","10","10","28","34","38","44","3.65625"
"11","2017","30","Otros","10","27","193","294","24","31","217","325","4.84"
"11","2017","30","Hotel","7","38","34","48","27","34","61","82","1"
"11","2017","30","Hotel","13","27","4","68","0","0","4","68","4.2"
"11","2017","30","Hotel","16","20","136","201","0","0","136","201","1"
"11","2017","30","Otros","10","27","70","99","150","195","220","294","4.84"
"11","2017","30","Hotel","3","7","98","211","32","51","130","262","1"
"11","2017","30","Otros","2","29","10","22","0","0","10","22","3.28"
"11","2017","30","Otros","10","18","2","20","0","0","2","20","10.25"
"11","2017","30","Otros","9","22","76","400","0","0","76","400","7.6428571428571"
"11","2017","30","Otros","15","27","63","63","4","4","67","67","1.4222222222222"
"11","2017","30","Otros","11","36","9","18","3","6","12","24","5.1904761904762"
"11","2017","30","Otros","5","5","26","41","5","6","31","47","3.65625"
"11","2017","30","Otros","2","29","20","50","65","170","85","220","3.28"
"11","2017","30","Hotel","9","22","138","198","18","18","156","216","2.5555555555556"
"11","2017","30","Otros","11","32","6","6","2","2","8","8","2.2857142857143"
"11","2017","30","Hotel","10","27","302","469","146","183","448","652","1"
"11","2017","30","Otros","16","27","78","111","4","4","82","115","2"
"11","2017","30","Hotel","16","20","16","32","0","0","16","32","1"
"11","2017","30","Otros","11","15","57","97","1","1","58","98","2.3571428571429"
"11","2017","30","Otros","7","17","180","710","0","0","180","710","3"
"11","2017","30","Otros","5","8","22","30","0","0","22","30","5"
"11","2017","30","Hotel","13","33","146","185","12","17","158","202","2"
"11","2017","30","Otros","5","9","49","101","8","16","57","117","4.0454545454545"
"11","2017","30","Otros","10","27","66","107","35","50","101","157","4.84"
"11","2017","30","Otros","9","22","16","22","0","0","16","22","7.6428571428571"
"11","2017","30","Otros","16","40","108","160","0","0","108","160","28.142857142857"
"11","2017","30","Hotel","16","40","67","75","18","20","85","95","1"
"11","2017","30","Otros","15","16","27","107","0","0","27","107","9"
"11","2017","30","Hotel","8","2","10","10","4","4","14","14","3"
"11","2017","30","Otros","8","3","52","107","0","0","52","107","10"
"11","2017","30","Otros","7","17","59","111","0","0","59","111","17.166666666667"
"11","2017","30","Otros","16","20","110","152","0","0","110","152","3.0769230769231"
"11","2017","30","Otros","6","27","30","58","0","0","30","58","3.960088691796"
"11","2017","30","Otros","12","35","30","64","219","378","249","442","3.5"
"11","2017","30","Otros","6","28","131","570","3","5","134","575","4.65"
"11","2017","30","Otros","6","28","295","996","20","42","315","1038","4.65"
"11","2017","30","Hotel","8","34","121","229","115","175","236","404","2.5714285714286"
"11","2017","30","Hotel","16","20","2075","2333","5","7","2080","2340","1"
"11","2017","30","Hotel","2","6","47","76","0","0","47","76","2.2"
"11","2017","30","Hotel","7","27","26","26","0","0","26","26","4.1666666666667"
"11","2017","30","Hotel","10","23","56","61","0","0","56","61","4"
"11","2017","30","Hotel","9","26","71","71","29","116","100","187","1.5"
"11","2017","30","Otros","8","27","11","11","4","4","15","15","9.4"
"11","2017","30","Otros","10","27","73","73","1","1","74","74","4.84"
"11","2017","30","Otros","11","15","18","30","11","35","29","65","2.3571428571429"
"11","2017","30","Otros","16","20","42","44","4","20","46","64","3.0769230769231"
"11","2017","30","Otros","11","32","69","82","0","0","69","82","1"
"11","2017","30","Otros","16","27","113","113","6","6","119","119","13.818181818182"
"11","2017","30","Otros","9","37","56","56","0","0","56","56","4.5"
"11","2017","30","Hotel","2","29","24","48","45","207","69","255","2"
"11","2017","30","Hotel","2","1","26","220","2","12","28","232","6.4"
"11","2017","30","Otros","5","8","1","1","26","28","27","29","5"
"11","2017","30","Otros","9","37","89","169","41","72","130","241","4.5"
"11","2017","30","Otros","7","38","144","224","0","0","144","224","2.75"
"11","2017","30","Otros","11","32","124","254","0","0","124","254","1"
"11","2017","30","Otros","4","39","96","115","3","5","99","120","2.2222222222222"
"11","2017","30","Hotel","11","36","102","180","39","85","141","265","2.375"
"11","2017","30","Otros","10","23","26","54","7","18","33","72","7"
"11","2017","30","Hotel","15","16","715","1617","116","339","831","1956","2"
"11","2017","30","Otros","2","29","8","13","197","478","205","491","3.28"
"11","2017","30","Hotel","6","12","1120","1578","37","53","1157","1631","1"
"11","2017","30","Hotel","11","15","328","355","0","0","328","355","1"
"11","2017","30","Otros","4","21","179","261","3","3","182","264","1"
"11","2017","30","Otros","16","19","54","138","0","0","54","138","10.263157894737"
"11","2017","30","","9","37","559","792","7","8","566","800","1"
"11","2017","30","Otros","10","27","142","209","111","171","253","380","4.84"
"11","2017","30","Otros","11","15","32","102","0","0","32","102","2.3571428571429"
"11","2017","30","Hotel","2","29","42","138","124","368","166","506","2"
"11","2017","30","Hotel","10","27","326","346","141","153","467","499","1"
"11","2017","30","Hotel","11","36","105","480","4","10","109","490","2.375"
"11","2017","30","Hotel","9","37","145","169","47","82","192","251","3.4"
"11","2017","30","Otros","14","27","6","12","3","6","9","18","11.833333333333"
"11","2017","30","Otros","7","38","84","106","0","0","84","106","1"
"11","2017","30","Hotel","2","1","19","24","0","0","19","24","6.4"
"11","2017","30","Otros","2","29","10","30","56","189","66","219","3.28"
"11","2017","30","Hotel","6","27","15","35","0","0","15","35","3"
"11","2017","30","Otros","5","9","14","14","0","0","14","14","4.0454545454545"
"11","2017","30","Hotel","2","1","162","214","0","0","162","214","6.4"
"11","2017","30","Hotel","3","7","6","8","171","254","177","262","1"
"11","2017","30","Otros","7","38","13","22","9","9","22","31","2.75"
"11","2017","30","Otros","7","17","14","54","0","0","14","54","17.166666666667"
"11","2017","30","Otros","7","38","6","10","2","2","8","12","2.75"
"11","2017","30","Otros","4","21","25","31","2","2","27","33","4.8333333333333"
"11","2017","30","Otros","2","1","53","53","2","2","55","55","5.5"
"11","2017","30","Otros","12","35","85","166","29","56","114","222","3.5"
"11","2017","30","Otros","12","35","26","34","93","113","119","147","3.5"
"11","2017","30","Otros","4","21","41","54","9","11","50","65","4.8333333333333"
"11","2017","30","Otros","12","24","25","85","40","130","65","215","9.2"
"11","2017","30","Otros","16","19","4","6","0","0","4","6","10.263157894737"
"11","2017","30","Otros","10","11","33","33","0","0","33","33","11.764705882353"
"11","2017","30","Otros","16","19","53","93","0","0","53","93","10.263157894737"
"11","2017","30","Hotel","2","27","28","114","4","7","32","121","1"
"11","2017","30","Otros","6","28","20","20","0","0","20","20","4.65"
"11","2017","30","Otros","10","18","246","436","72","194","318","630","10.25"
"11","2017","30","Otros","14","27","64","162","0","0","64","162","11.833333333333"
"11","2017","30","Hotel","11","32","5","12","3","6","8","18","1"
"11","2017","30","Otros","8","27","1","1","0","0","1","1","9.4"
"11","2017","30","Hotel","12","35","60","124","67","128","127","252","1.7272727272727"
"11","2017","30","Otros","13","14","16","18","6","6","22","24","7.3846153846154"
"11","2017","30","Otros","11","36","38","57","0","0","38","57","5.1904761904762"
"11","2017","30","Otros","16","20","34","35","2","2","36","37","3.0769230769231"
"11","2017","30","Hotel","14","31","115","182","533","787","648","969","7.8"
"11","2017","30","Otros","2","27","107","375","16","16","123","391","3.2"
"11","2017","30","","16","40","271","480","0","0","271","480","3.0555555555556"
"11","2017","30","Hotel","11","36","107","142","25","42","132","184","2.375"
"11","2017","30","Hotel","9","22","17","19","0","0","17","19","2.5555555555556"
"11","2017","30","Otros","2","29","42","90","57","120","99","210","3.28"
"11","2017","30","Hotel","10","27","23","33","82","100","105","133","2.25"
"11","2017","30","Otros","10","27","15","72","0","0","15","72","4.84"
"11","2017","30","Hotel","16","19","19","25","0","0","19","25","4"
"11","2017","30","Otros","2","6","20","359","0","0","20","359","5"
"11","2017","30","Otros","7","27","195","235","2","4","197","239","4.8333333333333"
"11","2017","30","Hotel","2","6","123","912","0","0","123","912","5.5"
"11","2017","30","Hotel","6","28","6","6","5","5","11","11","2.4"
"11","2017","30","Otros","6","10","156","466","0","0","156","466","3.8518518518518"
"11","2017","30","Hotel","6","27","24","39","1","1","25","40","3"
"11","2017","30","Otros","5","5","26","41","5","6","31","47","3.65625"
"11","2017","30","Otros","12","24","72","154","57","74","129","228","9.2"
"11","2017","30","Hotel","8","2","71","142","12","24","83","166","3"
"11","2017","30","Hotel","11","32","10","54","4","4","14","58","1"
"11","2017","30","Otros","10","18","47","99","54","96","101","195","10.25"
"11","2017","30","Hotel","9","37","44","74","19","32","63","106","3.4"
"11","2017","30","Otros","5","9","73","99","74","86","147","185","4.0454545454545"
"11","2017","30","Otros","12","24","20","54","27","43","47","97","9.2"
"11","2017","30","Otros","9","22","10","12","0","0","10","12","7.6428571428571"
"11","2017","30","Otros","2","29","13","28","22","85","35","113","3.28"
"11","2017","30","Otros","10","23","15","23","2","2","17","25","7"
"11","2017","30","Otros","10","27","38","174","8","24","46","198","4.84"
"11","2017","30","Otros","10","11","124","124","0","0","124","124","11.764705882353"
"11","2017","30","Otros","8","3","52","94","0","0","52","94","10"
"11","2017","30","Otros","14","31","142","304","255","501","397","805","20.2"
"11","2017","30","Otros","2","29","209","463","184","466","393","929","3.28"
"11","2017","0","Otros","6","25","0","0","0","0","0","0","1"
"11","2017","30","Hotel","15","16","15","31","0","0","15","31","7.8"
"11","2017","30","Hotel","15","27","46","61","5","25","51","86","1"
"11","2017","30","Otros","10","27","7","12","5","5","12","17","4.84"
"11","2017","30","Otros","10","23","96","96","8","8","104","104","7"
"11","2017","30","Otros","6","27","65","155","0","0","65","155","3.960088691796"
"11","2017","30","Otros","16","40","184","335","0","0","184","335","28.142857142857"
"11","2017","30","Otros","11","36","122","205","2","4","124","209","5.1904761904762"
"11","2017","30","Otros","8","34","47","59","9","16","56","75","5.75"
"11","2017","30","Otros","6","12","20","112","0","0","20","112","1.8256578947368"
"11","2017","30","Otros","6","10","39","49","0","0","39","49","3.8518518518518"
"11","2017","30","Hotel","4","21","147","316","10","12","157","328","3"
"11","2017","30","Hotel","11","36","112","218","38","105","150","323","2.375"
"11","2017","30","Otros","5","8","88","104","130","165","218","269","5"
"11","2017","30","Hotel","7","17","116","132","4","7","120","139","10"
"11","2017","26","Hotel","11","36","326","382","22","32","348","414","1"
"11","2017","30","Otros","9","30","1","1","0","0","1","1","2.3333333333333"
"11","2017","30","Hotel","12","35","17","34","153","233","170","267","1.7272727272727"
"11","2017","30","Otros","2","1","51","171","12","41","63","212","5.5"
"11","2017","30","Hotel","6","25","70","73","2","2","72","75","1"
"11","2017","30","Otros","5","5","15","32","6","12","21","44","3.65625"
"11","2017","30","Otros","2","29","31","95","85","349","116","444","3.28"
"11","2017","30","Hotel","2","6","14","17","15","17","29","34","5.5"
"11","2017","30","Otros","7","17","10","27","2","3","12","30","17.166666666667"
"11","2017","30","Hotel","8","2","51","96","0","0","51","96","3"
"11","2017","30","Hotel","13","14","19","47","5","66","24","113","1"
"11","2017","30","Otros","7","38","49","85","9","13","58","98","2.75"
"11","2017","30","Hotel","14","31","24","32","153","330","177","362","24"
"11","2017","30","Hotel","5","5","67","101","6","12","73","113","2.1428571428571"
"11","2017","30","Otros","2","27","7","7","17","17","24","24","3.2"
"11","2017","30","Otros","5","8","8","11","0","0","8","11","5"
"11","2017","30","Otros","3","4","99","285","0","0","99","285","12.2"
"11","2017","30","Otros","13","14","4","4","0","0","4","4","7.3846153846154"
"11","2017","30","Otros","9","37","23","140","0","0","23","140","4.5"
"11","2017","30","Hotel","10","23","1150","1626","63","141","1213","1767","1"
"11","2017","30","Otros","11","32","13","13","2","2","15","15","2.2857142857143"
"11","2017","30","Otros","11","15","8","11","0","0","8","11","2.3571428571429"
"11","2017","30","Otros","8","3","509","1542","0","0","509","1542","10"
"11","2017","30","Otros","16","20","50","57","0","0","50","57","3.0769230769231"
"11","2017","30","Otros","8","3","90","198","0","0","90","198","10"
"11","2017","30","Otros","16","27","65","65","0","0","65","65","2"
"11","2017","30","Hotel","16","19","17","19","0","0","17","19","4"
"11","2017","30","Hotel","16","27","60","124","0","0","60","124","5.8571428571429"
"11","2017","30","Otros","9","26","23","58","2","2","25","60","3.8888888888889"
"11","2017","30","Otros","5","5","19","20","4","4","23","24","3.65625"
"11","2017","30","Otros","14","27","16","16","0","0","16","16","11.833333333333"
"11","2017","30","Hotel","5","5","23","68","5","24","28","92","2.1428571428571"
"11","2017","30","Hotel","12","24","105","286","191","381","296","667","3"
"11","2017","30","Otros","16","27","32","42","0","0","32","42","13.818181818182"
"11","2017","30","Otros","8","3","9","15","0","0","9","15","1"
"11","2017","30","Otros","13","27","243","245","0","0","243","245","12.2"
"11","2017","30","Hotel","16","40","39","69","33","80","72","149","16.333333333333"
"11","2017","30","Otros","11","36","71","301","0","0","71","301","1"
"11","2017","30","Otros","10","27","61","94","20","20","81","114","4.84"
"11","2017","30","Otros","9","22","16","27","0","0","16","27","7.6428571428571"
"11","2017","30","Hotel","5","5","21","27","93","154","114","181","2.1428571428571"
"11","2017","30","Otros","2","29","73","218","54","163","127","381","3.28"
"11","2017","30","Otros","2","29","15","19","4","5","19","24","3.28"
"11","2017","30","Hotel","13","14","20","20","0","0","20","20","1"
"11","2017","30","Otros","6","25","2","3","3","3","5","6","2.3846153846154"
"11","2017","30","Otros","2","1","24","27","0","0","24","27","5.5"
"11","2017","30","Hotel","12","27","32","44","56","63","88","107","1"
"11","2017","30","Hotel","13","27","3","22","1","2","4","24","4.2"
"11","2017","30","Otros","6","12","59","148","0","0","59","148","1.8256578947368"
"11","2017","30","Otros","6","27","22","27","0","0","22","27","3.960088691796"
"11","2017","30","Otros","6","25","26","28","2","2","28","30","2.3846153846154"
"11","2017","30","Hotel","6","28","14","64","2","4","16","68","2.5833333333333"
"11","2017","30","Otros","5","5","3","3","0","0","3","3","3.65625"
"11","2017","30","Otros","5","9","24","39","3","6","27","45","4.0454545454545"
"11","2017","30","Otros","5","8","10","16","5","11","15","27","5"
"11","2017","30","Hotel","2","29","152","323","183","467","335","790","1"
"11","2017","30","Otros","5","5","69","118","73","94","142","212","3.65625"
"11","2017","30","Hotel","9","26","19","24","4","7","23","31","1.5"
"11","2017","30","Otros","9","30","7","8","0","0","7","8","2.3333333333333"
"11","2017","30","Otros","11","15","21","21","8","8","29","29","2.3571428571429"
"11","2017","30","Hotel","16","27","1","1","9","15","10","16","5.8571428571429"
"11","2017","30","Otros","9","30","22","22","0","0","22","22","2.3333333333333"
"11","2017","30","Otros","2","29","14","45","22","74","36","119","3.28"
"11","2017","30","Otros","7","38","33","69","21","39","54","108","2.75"
"11","2017","30","Otros","4","21","52","144","15","69","67","213","4.8333333333333"
"11","2017","30","Otros","9","22","28","32","0","0","28","32","7.6428571428571"
"11","2017","30","Otros","9","22","112","224","0","0","112","224","7.6428571428571"
"11","2017","30","Otros","13","27","10","10","0","0","10","10","12.2"
"11","2017","30","Hotel","11","36","2226","2316","118","274","2344","2590","1"
"11","2017","30","Otros","13","33","41","59","4","4","45","63","5.125"
"11","2017","30","Otros","11","36","114","242","44","111","158","353","5.1904761904762"
"11","2017","30","Otros","12","35","48","69","278","415","326","484","3.5"
"11","2017","30","Otros","12","35","10","14","22","56","32","70","3.5"
"11","2017","30","Otros","10","11","45","83","21","32","66","115","11.764705882353"
"11","2017","30","Otros","12","24","4","16","18","54","22","70","9.2"
"11","2017","30","Otros","16","20","40","123","0","0","40","123","3.0769230769231"
"11","2017","30","Hotel","7","27","50","69","0","0","50","69","1"
"11","2017","30","Otros","6","12","12","18","6","17","18","35","1.8256578947368"
"11","2017","30","Otros","11","32","49","115","9","22","58","137","2.2857142857143"
"11","2017","30","Otros","6","28","34","34","0","0","34","34","4.65"
"11","2017","30","Otros","8","34","6","6","5","7","11","13","5.75"
"11","2017","30","Otros","16","27","15","45","0","0","15","45","13.818181818182"
"11","2017","30","Otros","10","11","7","7","0","0","7","7","11.764705882353"
"11","2017","30","Otros","6","10","6","14","0","0","6","14","3.8518518518518"
"11","2017","30","Otros","8","3","2","4","0","0","2","4","10"
"11","2017","30","Hotel","16","20","82","244","14","40","96","284","1"
"11","2017","30","Hotel","11","32","65","121","24","36","89","157","1"
"11","2017","30","Otros","8","27","26","204","4","4","30","208","9.4"
"11","2017","30","Otros","12","27","52","126","28","34","80","160","3.4285714285714"
"11","2017","30","Otros","6","10","10","15","0","0","10","15","3.8518518518518"
"11","2017","30","Otros","6","10","36","121","0","0","36","121","3.8518518518518"
"11","2017","30","Otros","5","8","12","18","10","17","22","35","5"
"11","2017","30","Otros","5","8","18","18","30","36","48","54","5"
"11","2017","30","Hotel","9","26","62","79","9","34","71","113","1.5"
"11","2017","30","Hotel","13","14","27","33","0","0","27","33","1"
"11","2017","30","Otros","10","18","50","81","94","254","144","335","10.25"
"11","2017","30","Otros","8","2","43","45","21","23","64","68","6.4285714285714"
"11","2017","30","Otros","7","27","2","2","0","0","2","2","4.8333333333333"
"11","2017","15","Otros","2","29","3","11","6","20","9","31","3.28"
"11","2017","30","Otros","11","32","1","1","0","0","1","1","2.2857142857143"
"11","2017","30","Otros","9","30","2","2","0","0","2","2","2.3333333333333"
"11","2017","30","Otros","2","29","6","14","13","35","19","49","3.28"
"11","2017","30","Otros","5","5","11","17","0","0","11","17","3.65625"
"11","2017","30","Otros","11","15","23","24","0","0","23","24","2.3571428571429"
"11","2017","30","Otros","10","23","7","7","0","0","7","7","7"
"11","2017","30","Otros","11","36","69","224","7","13","76","237","5.1904761904762"
"11","2017","30","Hotel","3","7","8","19","99","211","107","230","1"
"11","2017","30","Otros","10","27","6","18","0","0","6","18","4.84"
"11","2017","30","Otros","2","27","17","17","0","0","17","17","3.2"
"11","2017","30","Otros","12","35","21","45","47","100","68","145","3.5"
"11","2017","30","Otros","10","27","41","58","2","2","43","60","4.84"
"11","2017","30","Otros","16","40","21","49","165","414","186","463","28.142857142857"
"11","2017","30","Hotel","8","3","212","420","87","175","299","595","4.1111111111111"
"11","2017","30","Otros","9","22","60","123","4","10","64","133","7.6428571428571"
"11","2017","30","Otros","13","14","16","29","0","0","16","29","7.3846153846154"
"11","2017","30","Otros","5","9","18","18","0","0","18","18","4.0454545454545"
"11","2017","30","Otros","10","18","36","52","10","13","46","65","10.25"
"11","2017","30","Otros","6","25","123","241","0","0","123","241","2.3846153846154"
"11","2017","30","Otros","9","22","50","102","0","0","50","102","7.6428571428571"
"11","2017","30","Otros","10","27","54","249","9","11","63","260","4.84"
"11","2017","30","Otros","16","20","13","19","0","0","13","19","3.0769230769231"
"11","2017","30","Hotel","7","17","102","130","0","0","102","130","10"
"11","2017","30","Otros","15","27","32","47","0","0","32","47","1.4222222222222"
"11","2017","30","Otros","12","35","5","5","22","30","27","35","3.5"
"11","2017","30","Otros","12","35","1","1","169","195","170","196","3.5"
"11","2017","30","Otros","3","7","11","22","17","17","28","39","2"
"11","2017","30","Otros","10","11","2","4","3","4","5","8","11.764705882353"
"11","2017","30","Otros","12","24","10","13","14","18","24","31","9.2"
"11","2017","30","Otros","10","23","21","25","0","0","21","25","7"
"11","2017","30","Otros","7","27","15","43","0","0","15","43","4.8333333333333"
"11","2017","30","","10","18","6","9","0","0","6","9","1"
"11","2017","30","Otros","16","27","3","3","2","2","5","5","13.818181818182"
"11","2017","30","Hotel","2","29","9","30","64","198","73","228","1"
"11","2017","30","Otros","14","27","89","145","0","0","89","145","11.833333333333"
"11","2017","30","Otros","11","32","34","45","1","1","35","46","2.2857142857143"
"11","2017","30","Otros","16","19","40","80","0","0","40","80","1"
"11","2017","30","Otros","16","27","20","22","0","0","20","22","13.818181818182"
"11","2017","30","Otros","8","3","75","247","6","24","81","271","10"
"11","2017","30","Otros","16","27","60","72","0","0","60","72","13.818181818182"
"11","2017","30","Otros","16","20","42","69","2","4","44","73","3.0769230769231"
"11","2017","30","Otros","16","40","142","224","31","54","173","278","28.142857142857"
"11","2017","30","Hotel","11","36","65","114","8","15","73","129","2.375"
"11","2017","30","Otros","6","10","92","182","0","0","92","182","3.8518518518518"
"11","2017","30","Otros","7","38","134","271","24","67","158","338","2.75"
"11","2017","30","Otros","13","14","0","0","13","13","13","13","7.3846153846154"
"11","2017","30","Otros","9","30","35","43","0","0","35","43","2.3333333333333"
"11","2017","30","Otros","13","27","89","276","0","0","89","276","12.2"
"11","2017","30","Otros","10","27","28","118","56","56","84","174","4.84"
"11","2017","30","Otros","6","25","31","40","19","27","50","67","2.3846153846154"
"11","2017","30","Otros","9","26","36","46","0","0","36","46","3.8888888888889"
"11","2017","30","Otros","10","18","41","83","32","76","73","159","10.25"
"11","2017","28","Otros","2","29","29","93","0","0","29","93","3.28"
"11","2017","30","Otros","6","25","7","7","0","0","7","7","2.3846153846154"
"11","2017","30","Otros","5","9","10","13","11","17","21","30","4.0454545454545"
"11","2017","30","Otros","5","9","15","36","15","26","30","62","4.0454545454545"
"11","2017","30","Hotel","9","37","40","235","0","0","40","235","3.4"
"11","2017","30","Hotel","7","38","134","270","22","44","156","314","1"
"11","2017","30","Otros","7","27","51","59","0","0","51","59","4.8333333333333"
"11","2017","30","Otros","5","9","0","0","4","4","4","4","4.0454545454545"
"11","2017","30","Otros","10","27","3","3","0","0","3","3","4.84"
"11","2017","30","Otros","7","27","8","8","0","0","8","8","4.8333333333333"
"11","2017","30","Otros","16","40","22","36","29","57","51","93","28.142857142857"
"11","2017","30","Otros","10","23","24","24","3","3","27","27","7"
"11","2017","30","Otros","15","16","63","309","3","38","66","347","9"
"11","2017","30","Otros","3","7","6","12","117","256","123","268","2"
"11","2017","30","Otros","7","17","43","100","0","0","43","100","17.166666666667"
"11","2017","30","Otros","8","27","54","166","2","4","56","170","9.4"
"11","2017","30","Otros","9","22","13","20","0","0","13","20","7.6428571428571"
"11","2017","30","Otros","16","19","15","20","0","0","15","20","10.263157894737"
"11","2017","0","","15","27","0","0","0","0","0","0","1"
"11","2017","30","Hotel","10","11","22","22","8","8","30","30","5.6666666666667"
"11","2017","30","Otros","2","27","14","22","0","0","14","22","3.2"
"11","2017","30","Otros","8","2","16","16","40","46","56","62","6.4285714285714"
"11","2017","30","Otros","5","5","7","7","1","1","8","8","3.65625"
"11","2017","30","Otros","12","35","4","4","30","43","34","47","3.5"
"11","2017","30","Otros","8","3","4","9","12","25","16","34","10"
"11","2017","30","Otros","12","24","3","6","207","373","210","379","9.2"
"11","2017","30","Otros","11","32","72","95","4","12","76","107","2.2857142857143"
"11","2017","30","Otros","10","27","22","28","105","178","127","206","4.84"
"11","2017","30","Otros","11","15","50","70","0","0","50","70","2.3571428571429"
"11","2017","30","Otros","5","8","11","21","10","15","21","36","5"
"11","2017","30","Otros","14","27","22","22","1","1","23","23","11.833333333333"
"11","2017","30","Otros","13","27","393","840","0","0","393","840","12.2"
"11","2017","30","Hotel","10","18","96","105","143","147","239","252","3.2"
"11","2017","30","Otros","10","27","23","26","11","11","34","37","4.84"
"11","2017","30","Otros","11","32","42","61","0","0","42","61","1"
"11","2017","30","Otros","9","37","26","127","0","0","26","127","4.5"
"11","2017","30","Otros","12","35","23","39","239","350","262","389","3.5"
"11","2017","30","Otros","8","34","124","202","46","79","170","281","5.75"
"11","2017","30","Hotel","16","40","25","37","70","141","95","178","16.333333333333"
"11","2017","30","Hotel","10","11","36","50","24","58","60","108","5.6666666666667"
"11","2017","30","Otros","7","27","13","15","0","0","13","15","4.8333333333333"
"11","2017","0","Hotel","7","38","0","0","0","0","0","0","1"
"11","2017","30","Otros","6","27","1","1","0","0","1","1","3.960088691796"
"11","2017","30","Otros","6","10","50","200","0","0","50","200","3.8518518518518"
"11","2017","30","Otros","6","25","197","314","0","0","197","314","1"
"11","2017","30","Otros","6","25","22","40","0","0","22","40","2.3846153846154"
"11","2017","30","Otros","6","27","26","61","0","0","26","61","3.960088691796"
"11","2017","30","Otros","6","27","76","215","0","0","76","215","3.960088691796"
"11","2017","30","Otros","5","5","16","32","9","9","25","41","3.65625"
"11","2017","30","Otros","5","5","13","27","0","0","13","27","3.65625"
"11","2017","30","Otros","3","4","27","48","0","0","27","48","12.2"
"11","2017","30","Otros","10","23","4","4","2","2","6","6","7"
"11","2017","30","Otros","8","3","1","1","0","0","1","1","10"
"11","2017","30","Otros","5","5","11","13","6","12","17","25","3.65625"
"11","2017","30","Otros","5","8","31","61","3","6","34","67","5"
"11","2017","30","Otros","6","10","90","324","0","0","90","324","3.8518518518518"
"11","2017","30","Otros","16","19","7","14","0","0","7","14","10.263157894737"
"11","2017","30","Otros","11","15","20","39","1","2","21","41","2.3571428571429"
"11","2017","30","Otros","7","38","38","48","0","0","38","48","2.75"
"11","2017","30","Otros","11","32","69","108","44","92","113","200","2.2857142857143"
"11","2017","30","Otros","8","2","14","26","12","32","26","58","6.4285714285714"
"11","2017","30","Otros","10","27","11","20","9","17","20","37","4.84"
"11","2017","30","Otros","6","27","12","16","0","0","12","16","3.960088691796"
"11","2017","30","Otros","11","32","32","48","8","8","40","56","2.2857142857143"
"11","2017","30","Otros","8","34","28","30","37","54","65","84","5.75"
"11","2017","30","Otros","11","32","6","10","0","0","6","10","2.2857142857143"
"11","2017","30","Otros","10","11","5","21","2","2","7","23","11.764705882353"
"11","2017","30","Otros","11","32","6","6","0","0","6","6","2.2857142857143"
"11","2017","30","Otros","14","31","0","0","23","30","23","30","20.2"
"11","2017","30","Hotel","14","31","302","679","617","2020","919","2699","17.4"
"11","2017","30","Otros","11","36","200","289","20","20","220","309","5.1904761904762"
"11","2017","30","Hotel","15","16","1013","2190","207","448","1220","2638","2"
"11","2017","30","Otros","15","27","11","25","4","8","15","33","1.4222222222222"
"11","2017","30","Otros","5","5","11","18","11","17","22","35","3.65625"
"11","2017","30","Otros","8","34","11","15","4","6","15","21","5.75"
"11","2017","30","Otros","7","27","20","34","0","0","20","34","4.8333333333333"
"11","2017","30","Otros","12","35","12","16","34","34","46","50","3.5"
"11","2017","30","Otros","5","5","48","87","2","2","50","89","3.65625"
"11","2017","30","Otros","10","11","2","5","0","0","2","5","11.764705882353"
"11","2017","30","Otros","10","11","1","1","0","0","1","1","11.764705882353"
"11","2017","30","Otros","9","30","6","120","0","0","6","120","2.3333333333333"
"11","2017","30","Otros","8","2","14","27","0","0","14","27","6.4285714285714"
"11","2017","30","Otros","10","27","93","113","19","19","112","132","4.84"
"11","2017","30","Otros","5","9","14","14","4","4","18","18","4.0454545454545"
"11","2017","30","Otros","6","27","6","12","0","0","6","12","3.960088691796"
"11","2017","30","Otros","6","10","24","37","22","28","46","65","3.8518518518518"
"11","2017","30","Otros","6","10","34","53","0","0","34","53","3.8518518518518"
"11","2017","30","Otros","6","27","21","29","0","0","21","29","3.960088691796"
"11","2017","30","Otros","6","12","5","56","0","0","5","56","1.8256578947368"
"11","2017","18","Otros","6","10","27","40","0","0","27","40","3.8518518518518"
"11","2017","30","Otros","6","10","21","24","0","0","21","24","3.8518518518518"
"11","2017","30","Otros","6","27","18","36","0","0","18","36","3.960088691796"
"11","2017","30","Otros","6","12","52","52","0","0","52","52","1.8256578947368"
"11","2017","30","Otros","6","10","3","6","0","0","3","6","3.8518518518518"
"11","2017","30","Hotel","6","25","66","105","0","0","66","105","1"
"11","2017","4","Otros","6","27","4","4","0","0","4","4","3.960088691796"
"11","2017","30","Otros","5","9","22","56","26","49","48","105","4.0454545454545"
"11","2017","30","Otros","5","5","58","102","29","47","87","149","3.65625"
"11","2017","30","Otros","5","5","14","18","0","0","14","18","3.65625"
"11","2017","30","Otros","5","5","46","85","4","6","50","91","3.65625"
"11","2017","30","Otros","11","36","64","114","6","14","70","128","5.1904761904762"
"11","2017","30","Hotel","6","10","568","1051","20","28","588","1079","1"
"11","2017","30","Otros","5","9","14","14","4","4","18","18","4.0454545454545"
"11","2017","30","Otros","5","8","33","39","0","0","33","39","5"
"11","2017","0","Hotel","15","27","0","0","0","0","0","0","1"
"11","2017","30","Hotel","3","4","371","2354","10","50","381","2404","3"
"11","2017","30","Otros","3","7","4","4","34","34","38","38","1"
"11","2017","30","Otros","7","38","37","52","24","70","61","122","2.75"
"11","2017","30","Hotel","10","27","73","104","127","142","200","246","1"
"11","2017","18","Hotel","12","35","0","0","87","151","87","151","1.7272727272727"
"11","2017","30","Hotel","10","27","11","13","0","0","11","13","2.25"
"11","2017","30","Hotel","7","17","565","1074","68","203","633","1277","4"
"11","2017","2","Hotel","16","19","2","2","0","0","2","2","4"
"11","2017","30","Hotel","2","6","53","537","0","0","53","537","2.2"
"11","2017","30","Otros","5","5","99","345","19","95","118","440","3.65625"
"11","2017","30","Otros","12","24","34","51","65","143","99","194","9.2"
"11","2017","30","Otros","5","8","12","18","8","10","20","28","5"
"11","2017","30","Otros","4","13","167","190","15","15","182","205","1"
"11","2017","30","Otros","10","11","113","113","0","0","113","113","11.764705882353"
"11","2017","30","Otros","12","35","32","60","283","502","315","562","3.5"
"11","2017","30","Otros","10","23","55","59","3","4","58","63","7"
"11","2017","30","Otros","11","36","501","965","75","149","576","1114","5.1904761904762"
"11","2017","30","Otros","12","35","33","47","414","499","447","546","3.5"
"11","2017","30","Otros","11","36","16","24","8","16","24","40","5.1904761904762"
"11","2017","30","Otros","8","2","9","30","0","0","9","30","6.4285714285714"
"11","2017","30","Otros","9","30","58","58","0","0","58","58","2.3333333333333"
"11","2017","30","Otros","11","36","51","62","13","15","64","77","5.1904761904762"
"11","2017","30","Otros","6","10","5","5","2","4","7","9","3.8518518518518"
"11","2017","30","Otros","10","18","31","87","5","25","36","112","10.25"
"11","2017","30","Otros","7","27","3","61","2","2","5","63","4.8333333333333"
"11","2017","30","Otros","16","20","27","84","0","0","27","84","1"
"11","2017","30","Otros","9","22","8","16","0","0","8","16","7.6428571428571"
"11","2017","30","Otros","5","5","140","246","7","11","147","257","3.65625"
"11","2017","30","Otros","12","35","26","34","93","113","119","147","3.5"
"11","2017","30","Otros","10","11","36","82","3","4","39","86","11.764705882353"
"11","2017","30","Otros","10","11","3","7","0","0","3","7","11.764705882353"
"11","2017","25","Otros","5","9","55","108","4","8","59","116","4.0454545454545"
"11","2017","30","Otros","5","5","15","25","0","0","15","25","3.65625"
"11","2017","30","Otros","12","35","3","3","80","139","83","142","3.5"
"11","2017","30","Otros","7","38","95","214","37","95","132","309","2.75"
"11","2017","30","Hotel","12","35","15","15","400","705","415","720","1.7272727272727"
"11","2017","30","Otros","13","14","20","20","2","2","22","22","1"
"11","2017","30","Otros","5","5","27","46","2","4","29","50","3.65625"
"11","2017","30","Hotel","9","26","6","10","0","0","6","10","1.5"
"11","2017","30","Hotel","16","19","14","14","0","0","14","14","1"
"11","2017","30","Otros","16","19","43","216","0","0","43","216","10.263157894737"
"11","2017","30","Otros","9","30","26","38","0","0","26","38","2.3333333333333"
"11","2017","30","Otros","16","19","8","11","0","0","8","11","10.263157894737"
"11","2017","30","Otros","16","19","56","77","0","0","56","77","10.263157894737"
"11","2017","30","Otros","9","26","9","12","0","0","9","12","3.8888888888889"
"11","2017","30","Otros","16","40","1","1","0","0","1","1","28.142857142857"
"11","2017","30","Hotel","16","27","13","42","0","0","13","42","5.8571428571429"
"11","2017","30","Otros","16","19","5","13","0","0","5","13","10.263157894737"
"11","2017","30","Otros","16","19","10","28","0","0","10","28","10.263157894737"
"11","2017","30","","9","30","145","200","26","34","171","234","1"
"11","2017","30","Otros","16","19","31","39","0","0","31","39","10.263157894737"
"11","2017","30","Otros","10","11","2","2","0","0","2","2","11.764705882353"
"11","2017","30","Otros","11","36","15","15","0","0","15","15","5.1904761904762"
"11","2017","30","Otros","16","19","5","11","0","0","5","11","10.263157894737"
"11","2017","30","Otros","16","19","37","48","0","0","37","48","1.3333333333333"
"11","2017","30","Otros","16","19","25","35","0","0","25","35","10.263157894737"
"11","2017","30","Otros","10","18","27","90","47","123","74","213","10.25"
"11","2017","30","Otros","16","19","25","61","0","0","25","61","10.263157894737"
"11","2017","30","Otros","16","19","1","1","0","0","1","1","1.3333333333333"
"11","2017","30","","9","26","397","1873","0","0","397","1873","1"
"11","2017","30","Otros","16","19","12","16","0","0","12","16","10.263157894737"
"11","2017","30","Otros","16","19","46","50","5","7","51","57","10.263157894737"
"11","2017","30","Hotel","8","2","264","490","54","85","318","575","1"
"11","2017","30","Otros","6","10","36","66","2","2","38","68","3.8518518518518"
"11","2017","30","Otros","6","12","158","167","0","0","158","167","1.8256578947368"
"11","2017","30","Hotel","16","19","20","32","32","59","52","91","1"
"11","2017","30","Otros","3","7","30","60","104","112","134","172","2"
"11","2017","30","Hotel","2","6","997","3354","137","455","1134","3809","1"
"11","2017","30","Hotel","3","4","249","725","22","51","271","776","2.6"
"11","2017","30","Hotel","16","40","2522","3626","1498","2354","4020","5980","1"
"11","2017","30","Otros","16","27","176","186","0","0","176","186","13.818181818182"
"11","2017","30","Hotel","6","28","198","270","28","37","226","307","2.4"
"11","2017","30","Hotel","8","34","1635","2238","426","697","2061","2935","1"
"11","2017","30","Otros","9","30","6","12","0","0","6","12","2.3333333333333"
"11","2017","30","Hotel","10","18","33","33","319","319","352","352","1"
"11","2017","30","Hotel","9","30","71","302","0","0","71","302","1"
"11","2017","30","Hotel","15","27","33","39","3","12","36","51","1"
"11","2017","30","Hotel","9","22","120","720","0","0","120","720","2.5555555555556"
"11","2017","30","","11","15","12","15","0","0","12","15","1"
"11","2017","30","Otros","6","12","19","19","0","0","19","19","1.8256578947368"
"11","2017","30","Hotel","15","27","30","900","0","0","30","900","1"
"11","2017","30","Otros","15","27","65","100","0","0","65","100","1.4222222222222"
"11","2017","30","Otros","15","27","11","11","0","0","11","11","1.4222222222222"
"11","2017","30","Otros","2","1","22","22","13","13","35","35","1"
"11","2017","30","Otros","12","24","5","5","3","3","8","8","9.2"
"11","2017","30","Otros","5","5","46","71","11","17","57","88","3.65625"
"11","2017","30","Hotel","7","27","152","197","10","10","162","207","1"
"11","2017","30","Otros","16","20","56","103","0","0","56","103","3.0769230769231"
"11","2017","0","","10","11","0","0","0","0","0","0","1"
"11","2017","30","Hotel","16","40","24","43","30","56","54","99","16.333333333333"
"11","2017","30","Otros","12","35","11","20","0","0","11","20","3.5"
"11","2017","30","Hotel","6","27","42","42","0","0","42","42","3"
"11","2017","30","Otros","5","5","4","5","2","4","6","9","3.65625"
"11","2017","30","Hotel","6","27","36","36","2","2","38","38","3"
"11","2017","30","Otros","6","25","24","30","0","0","24","30","2.3846153846154"
"11","2017","0","Hotel","15","27","0","0","0","0","0","0","1"
"11","2017","30","Otros","5","9","54","60","15","15","69","75","4.0454545454545"
"11","2017","30","Hotel","15","27","120","240","4","4","124","244","1"
"11","2017","30","Hotel","5","9","1","30","0","0","1","30","1"
"11","2017","30","Hotel","8","34","66","194","31","130","97","324","2.5714285714286"
"11","2017","0","Hotel","15","27","0","0","0","0","0","0","1"
"11","2017","30","Hotel","6","27","235","386","0","0","235","386","3"
"11","2017","0","Otros","6","27","0","0","0","0","0","0","1"
"11","2017","30","Otros","12","27","9","9","16","16","25","25","3.4285714285714"
"11","2017","30","Hotel","2","27","533","570","566","609","1099","1179","1"
"11","2017","30","Hotel","2","6","172","172","0","0","172","172","1"
"11","2017","30","Otros","2","6","62","62","0","0","62","62","1"
"11","2017","30","Hotel","4","39","81","81","0","0","81","81","1"
"11","2017","30","Hotel","6","10","372","511","11","14","383","525","1"
"11","2017","30","Otros","5","8","11","11","21","25","32","36","5"
"11","2017","0","Hotel","13","33","0","0","0","0","0","0","1"
"11","2017","30","Hotel","13","33","491","1680","0","0","491","1680","1"
"11","2017","30","Otros","11","32","63","165","58","172","121","337","2.2857142857143"
"11","2017","30","Hotel","9","26","327","599","288","595","615","1194","1"
"11","2017","30","Hotel","16","20","66","89","4","24","70","113","1"
"11","2017","30","Otros","16","20","24","48","0","0","24","48","3.0769230769231"
"11","2017","30","","16","40","423","688","0","0","423","688","1"
"11","2017","30","Hotel","15","16","1678","3378","307","750","1985","4128","1"
"11","2017","30","Hotel","5","9","9","14","59","90","68","104","1"
"11","2017","30","Otros","7","38","98","226","0","0","98","226","2.75"
"11","2017","30","Otros","2","6","2290","2290","0","0","2290","2290","1"
"11","2017","30","Otros","2","6","183","290","0","0","183","290","1"
"11","2017","30","Hotel","15","27","204","1015","18","24","222","1039","1"
"11","2017","30","Otros","7","38","45","55","6","12","51","67","2.75"
"11","2017","30","Otros","2","1","10","29","10","20","20","49","1"
"11","2017","30","Otros","8","3","94","223","4","6","98","229","10"
"11","2017","30","Otros","11","36","25","151","0","0","25","151","5.1904761904762"
"11","2017","30","Otros","16","20","40","140","0","0","40","140","3.0769230769231"
"11","2017","30","Otros","8","3","230","482","15","19","245","501","1"
"11","2017","30","Otros","4","39","46","52","1","10","47","62","2.2222222222222"
"11","2017","30","Otros","5","5","25","56","13","26","38","82","3.65625"
"11","2017","30","Otros","12","27","11","15","26","28","37","43","3.4285714285714"
"11","2017","30","Otros","7","27","22","59","0","0","22","59","1"
"11","2017","30","Hotel","2","6","257","538","51","58","308","596","1"
"11","2017","30","Hotel","14","27","386","1303","61","78","447","1381","1"
"11","2017","30","Hotel","16","19","691","949","0","0","691","949","1"
"11","2017","30","","2","1","15","210","0","0","15","210","1"
"11","2017","30","Hotel","2","27","96","270","5","5","101","275","1"
"11","2017","30","Otros","16","20","127","150","0","0","127","150","1"
"11","2017","0","Otros","13","14","0","0","0","0","0","0","1"
"11","2017","30","Hotel","11","36","102","163","6","10","108","173","2.375"
"11","2017","30","Otros","13","14","4","120","0","0","4","120","7.3846153846154"
"11","2017","30","Otros","12","27","45","69","0","0","45","69","3.4285714285714"
"11","2017","30","Hotel","2","6","167","253","0","0","167","253","2.2"
"11","2017","30","Otros","2","6","251","1179","0","0","251","1179","1"
"11","2017","30","Otros","10","27","9","109","0","0","9","109","4.84"
"11","2017","30","Otros","12","27","7","19","4","4","11","23","3.4285714285714"
"11","2017","30","Otros","13","14","52","104","0","0","52","104","7.3846153846154"
"11","2017","30","Otros","6","12","121","226","18","31","139","257","1.8256578947368"
"11","2017","30","Otros","2","6","719","896","105","208","824","1104","1"
"11","2017","30","Hotel","12","35","16","24","1","4","17","28","1.7272727272727"
"11","2017","30","Otros","5","5","21","42","15","18","36","60","3.65625"
"11","2017","30","Otros","9","30","0","0","8","240","8","240","2.3333333333333"
"11","2017","30","Hotel","8","2","7","7","13","15","20","22","1"
"11","2017","30","Otros","9","30","15","30","0","0","15","30","2.3333333333333"
"11","2017","30","Hotel","15","27","20","22","18","18","38","40","1"
"11","2017","30","Hotel","3","7","42","42","13","13","55","55","1"
"11","2017","30","Otros","6","12","106","171","0","0","106","171","1.8256578947368"
"11","2017","30","Otros","12","27","30","42","17","28","47","70","3.4285714285714"
"11","2017","30","Otros","2","6","10","220","0","0","10","220","5"
"11","2017","30","Otros","6","27","13","15","0","0","13","15","3.960088691796"
"11","2017","30","Hotel","10","11","152","312","11","32","163","344","1"
"11","2017","30","Otros","2","1","14","98","0","0","14","98","1"
"11","2017","30","Otros","11","36","15","18","3","3","18","21","5.1904761904762"
"11","2017","30","Hotel","11","32","2","2","0","0","2","2","1"
"11","2017","30","Otros","2","27","12","176","0","0","12","176","1"
"11","2017","30","Otros","12","27","6","6","7","7","13","13","3.4285714285714"
"11","2017","30","Hotel","8","2","2","2","0","0","2","2","3"
"11","2017","30","Hotel","16","20","10","10","0","0","10","10","1"
"11","2017","30","Otros","12","35","0","0","88","140","88","140","3.5"
"11","2017","30","Otros","13","14","10","18","0","0","10","18","1"
"11","2017","30","Otros","2","27","38","263","0","0","38","263","3.2"
"11","2017","30","Hotel","6","27","20","20","0","0","20","20","3"
"11","2017","30","Hotel","8","3","70","84","17","39","87","123","4.1111111111111"
"11","2017","0","Hotel","15","27","0","0","0","0","0","0","1"
"11","2017","30","Otros","8","3","6","6","0","0","6","6","10"
"11","2017","30","Hotel","16","20","8","8","0","0","8","8","1"
"11","2017","30","Hotel","6","28","120","172","2","18","122","190","2.4"
"11","2017","30","Otros","2","1","34","62","2","4","36","66","5.5"
"11","2017","30","Hotel","11","36","81","157","107","174","188","331","2.375"
"11","2017","30","Otros","4","13","298","1122","0","0","298","1122","1"
"11","2017","30","Otros","2","6","239","1673","0","0","239","1673","1"
"11","2017","30","Otros","8","34","130","183","56","103","186","286","5.75"
"11","2017","30","Hotel","11","15","10","22","0","0","10","22","1"
"11","2017","30","Otros","15","27","4","4","0","0","4","4","1.4222222222222"
"11","2017","30","Hotel","13","14","116","130","7","7","123","137","1"
"11","2017","30","Hotel","13","14","124","206","69","81","193","287","1"
"11","2017","30","Hotel","9","30","43","57","9","24","52","81","1"
"11","2017","30","Hotel","4","13","175","326","31","44","206","370","5.4"
"11","2017","30","Otros","6","27","27","55","0","0","27","55","3.960088691796"
"11","2017","0","Hotel","15","27","0","0","0","0","0","0","1"
"11","2017","30","Hotel","2","29","13","56","62","271","75","327","2"
"11","2017","30","Hotel","13","33","32","47","0","0","32","47","2"
"11","2017","30","Hotel","12","35","65","110","91","99","156","209","1.7272727272727"
"11","2017","30","Hotel","13","14","214","302","79","82","293","384","1"
"11","2017","30","Otros","6","25","10","20","0","0","10","20","2.3846153846154"
"11","2017","30","Hotel","8","2","15","20","5","12","20","32","3"
"11","2017","30","Otros","4","39","66","104","0","0","66","104","2.2222222222222"
"11","2017","30","Otros","6","12","172","255","0","0","172","255","1.8256578947368"
"11","2017","30","Otros","13","33","76","114","18","22","94","136","5.125"
"11","2017","30","Hotel","4","13","91","207","0","0","91","207","5.4"
"11","2017","30","Hotel","7","27","176","284","5","5","181","289","4.1666666666667"
"11","2017","30","Hotel","4","13","833","2362","36","75","869","2437","1"
"11","2017","0","","5","8","0","0","0","0","0","0","1"
"11","2017","30","Otros","8","2","17","25","0","0","17","25","6.4285714285714"
"11","2017","30","Otros","2","6","7","7","3","3","10","10","1"
"11","2017","30","","6","10","9","20","0","0","9","20","1"
"11","2017","30","Hotel","2","29","62","95","101","155","163","250","2"
"11","2017","30","","14","31","134","298","460","1463","594","1761","1"
"11","2017","30","Hotel","16","27","2000","8000","0","0","2000","8000","1"
"11","2017","30","Hotel","12","35","58","130","104","136","162","266","1.7272727272727"
"11","2017","30","","12","35","762","853","4530","5117","5292","5970","1"
"11","2017","30","","9","26","109","139","15","18","124","157","1"
"11","2017","30","Otros","11","32","126","285","0","0","126","285","2.2857142857143"
"11","2017","30","Otros","12","24","56","189","73","111","129","300","9.2"
"11","2017","30","Hotel","6","25","20","25","0","0","20","25","1"
"11","2017","30","Otros","11","32","15","35","0","0","15","35","2.2857142857143"
"11","2017","30","Hotel","16","19","25","31","0","0","25","31","4"
"11","2017","30","Otros","13","33","27","32","15","28","42","60","5.125"
"11","2017","30","Otros","16","27","44","95","2","35","46","130","13.818181818182"
"11","2017","30","Otros","6","12","80","106","3","3","83","109","1.8256578947368"
"11","2017","30","Otros","2","29","13","19","0","0","13","19","3.28"
"11","2017","30","Hotel","14","27","360","444","229","292","589","736","1"
"11","2017","30","Otros","2","1","1","1","0","0","1","1","1"
"11","2017","30","Otros","11","32","16","20","4","4","20","24","2.2857142857143"
"11","2017","30","Otros","2","27","102","102","0","0","102","102","1"
"11","2017","30","Hotel","2","29","221","861","52","140","273","1001","1"
"11","2017","30","Hotel","4","13","32","712","0","0","32","712","3.2"
"11","2017","30","Hotel","4","21","15","26","2","3","17","29","3"
"11","2017","30","Otros","7","27","133","148","7","8","140","156","4.8333333333333"
"11","2017","30","","3","4","58","118","9","9","67","127","1"
"11","2017","30","Hotel","6","27","18","26","7","7","25","33","3"
"11","2017","30","Otros","16","19","20","100","0","0","20","100","10.263157894737"
"11","2017","30","Otros","11","32","1","1","0","0","1","1","2.2857142857143"
"11","2017","30","Otros","3","7","56","81","96","100","152","181","2"
"11","2017","30","Otros","5","5","20","30","0","0","20","30","3.65625"
"11","2017","24","Otros","15","27","999","1550","0","0","999","1550","1.4222222222222"
"11","2017","30","Otros","6","25","129","507","0","0","129","507","2.3846153846154"
"11","2017","30","","10","27","12","20","8","8","20","28","1"
"11","2017","30","Otros","2","29","25","54","61","127","86","181","3.28"
"11","2017","30","Otros","12","35","0","0","67","92","67","92","3.5"
"11","2017","30","Otros","16","19","34","61","0","0","34","61","10.263157894737"
"11","2017","30","Otros","9","26","71","108","5","6","76","114","3.8888888888889"
"11","2017","30","Hotel","13","33","65","105","7","7","72","112","2"
"11","2017","30","Otros","11","32","12","24","0","0","12","24","2.2857142857143"
"11","2017","30","Otros","9","22","6","6","0","0","6","6","7.6428571428571"
"11","2017","30","Otros","6","27","2","60","0","0","2","60","3.960088691796"
"11","2017","30","Otros","15","27","7","7","0","0","7","7","1.4222222222222"
"11","2017","30","Otros","11","32","88","97","4","4","92","101","2.2857142857143"
"11","2017","30","Otros","11","15","23","23","0","0","23","23","2.3571428571429"
"11","2017","30","Otros","9","37","32","122","0","0","32","122","4.5"
"11","2017","16","Otros","5","9","11","17","0","0","11","17","4.0454545454545"
"11","2017","30","Hotel","10","27","9","165","0","0","9","165","2.25"
"11","2017","30","Otros","6","28","37","291","0","0","37","291","4.65"
"11","2017","30","Otros","4","13","42","55","17","23","59","78","3.4"
"11","2017","30","Otros","2","1","1","1","0","0","1","1","1"
"11","2017","30","Otros","2","29","61","83","64","130","125","213","3.28"
"11","2017","30","Hotel","8","3","7","9","6","9","13","18","4.1111111111111"
"11","2017","30","Otros","16","19","188","713","0","0","188","713","1.3333333333333"
"11","2017","30","Otros","12","35","21","21","91","143","112","164","3.5"
"11","2017","30","Hotel","12","35","16","32","269","337","285","369","1.7272727272727"
"11","2017","30","Otros","12","35","11","14","32","57","43","71","3.5"
"11","2017","30","Otros","2","29","38","82","42","85","80","167","3.28"
"11","2017","30","Hotel","7","27","59","103","19","27","78","130","1"
"11","2017","30","Hotel","9","22","20","30","1","3","21","33","2.5555555555556"
"11","2017","30","Hotel","12","35","39","80","224","332","263","412","1.7272727272727"
"11","2017","30","Otros","15","16","69","122","9","32","78","154","2"
"11","2017","30","Hotel","15","27","0","0","0","0","0","0","1"
"11","2017","30","Otros","4","13","34","41","2","2","36","43","3.4"
"11","2017","30","Hotel","8","34","89","185","38","97","127","282","2.5714285714286"
"11","2017","30","Hotel","16","20","120","180","0","0","120","180","1"
"11","2017","30","Hotel","6","28","117","138","19","143","136","281","2.4"
"11","2017","30","Hotel","15","27","114","356","3","3","117","359","1"
"11","2017","30","Otros","12","35","52","95","43","62","95","157","3.5"
"11","2017","30","Otros","11","15","36","46","11","14","47","60","2.3571428571429"
"11","2017","30","Otros","11","15","20","24","0","0","20","24","2.3571428571429"
"11","2017","30","Otros","11","36","74","125","67","104","141","229","5.1904761904762"
"11","2017","30","Hotel","11","36","64","138","8","8","72","146","2.375"
"11","2017","30","Hotel","6","12","147","231","3","3","150","234","5"
"11","2017","30","Otros","8","3","12","38","13","25","25","63","10"
"11","2017","30","Otros","10","27","19","44","12","15","31","59","4.84"
"11","2017","30","Otros","8","3","11","19","0","0","11","19","10"
"11","2017","30","Otros","6","25","11","14","0","0","11","14","2.3846153846154"
"11","2017","30","Hotel","2","27","83","176","0","0","83","176","1"
"11","2017","30","Hotel","10","18","73","101","105","322","178","423","3.2"
"11","2017","30","Otros","11","32","84","268","4","4","88","272","1"
"11","2017","30","Hotel","6","10","1879","2527","236","436","2115","2963","1"
"11","2017","30","Otros","11","32","19","33","2","4","21","37","2.2857142857143"
"11","2017","0","Otros","2","27","0","0","0","0","0","0","1"
"11","2017","30","","12","24","66","137","682","1429","748","1566","1"
"11","2017","30","Hotel","16","27","682","838","5","10","687","848","5.8571428571429"
"11","2017","30","Hotel","7","38","88","267","0","0","88","267","1"
"11","2017","30","Hotel","6","12","3727","4207","69","96","3796","4303","1"
"12","2017","31","Hotel","14","31","3129","5235","6894","9558","10023","14793","1"
"12","2017","31","Hotel","14","31","890","1201","3131","8190","4021","9391","1"
"12","2017","31","Hotel","14","31","919","1127","1367","3971","2286","5098","1"
"12","2017","31","Hotel","11","32","59","96","63","123","122","219","1"
"12","2017","31","Hotel","14","27","3893","5284","796","1081","4689","6365","1"
"12","2017","31","Otros","11","32","140","222","19","38","159","260","2.2857142857143"
"12","2017","31","Hotel","14","31","477","624","3122","5031","3599","5655","5.4"
"12","2017","31","Hotel","15","16","1557","2695","104","221","1661","2916","1"
"12","2017","31","Hotel","14","31","973","1501","1253","3985","2226","5486","5.4"
"12","2017","31","Hotel","12","24","3088","4363","3022","4802","6110","9165","1"
"12","2017","31","Hotel","16","40","1349","1915","431","827","1780","2742","1"
"12","2017","31","Hotel","6","12","997","1272","79","120","1076","1392","1"
"12","2017","31","Hotel","10","23","2309","2997","240","355","2549","3352","1"
"12","2017","31","Hotel","14","31","1265","3197","262","654","1527","3851","5.4"
"12","2017","31","Hotel","3","4","1275","2453","260","495","1535","2948","1"
"12","2017","31","","11","32","553","834","71","124","624","958","1"
"12","2017","31","Hotel","6","12","1027","1761","89","212","1116","1973","1"
"12","2017","31","Hotel","6","12","2213","2984","168","474","2381","3458","1"
"12","2017","31","Hotel","9","26","3779","7516","63","126","3842","7642","1"
"12","2017","31","Hotel","2","1","582","2167","39","289","621","2456","1"
"12","2017","31","Hotel","9","26","1028","1739","201","935","1229","2674","1"
"12","2017","31","Hotel","6","12","667","1024","86","204","753","1228","1"
"12","2017","31","Hotel","14","31","62","77","4294","7703","4356","7780","5.4"
"12","2017","31","Hotel","11","32","351","571","79","127","430","698","1"
"12","2017","31","Hotel","2","6","1454","1872","84","153","1538","2025","1"
"12","2017","31","Hotel","16","40","1353","2715","1647","3088","3000","5803","1"
"12","2017","31","Hotel","14","27","1566","3557","830","2565","2396","6122","1"
"12","2017","31","Otros","11","36","182","430","4","8","186","438","1"
"12","2017","31","Hotel","10","23","680","1198","714","1310","1394","2508","1"
"12","2017","31","Hotel","14","31","378","1161","767","3481","1145","4642","7.8"
"12","2017","31","Hotel","7","17","231","581","92","192","323","773","1"
"12","2017","31","Hotel","2","1","2295","2792","186","229","2481","3021","2"
"12","2017","31","Hotel","2","1","1565","2437","210","494","1775","2931","2"
"12","2017","31","Hotel","4","13","516","715","170","267","686","982","1"
"12","2017","31","Hotel","2","1","808","1445","75","378","883","1823","2"
"12","2017","31","Hotel","10","27","1258","3147","1090","2239","2348","5386","1"
"12","2017","31","Hotel","14","27","971","1377","1268","1821","2239","3198","1"
"12","2017","31","Hotel","14","27","1825","2602","1174","2142","2999","4744","1"
"12","2017","31","Hotel","6","12","1888","1890","69","169","1957","2059","1"
"12","2017","31","Hotel","6","12","1408","2033","518","668","1926","2701","1"
"12","2017","31","Hotel","13","27","1756","3664","2","2","1758","3666","1"
"12","2017","31","Hotel","14","31","96","188","689","2295","785","2483","7.8"
"12","2017","31","Hotel","6","12","1377","4204","283","862","1660","5066","1"
"12","2017","31","Hotel","16","27","2358","4375","105","146","2463","4521","1"
"12","2017","31","","10","27","40","160","34","50","74","210","1"
"12","2017","31","Hotel","10","18","694","1391","714","1609","1408","3000","1"
"12","2017","31","Hotel","9","37","1691","2869","349","586","2040","3455","1"
"12","2017","31","Hotel","16","27","1245","4984","0","0","1245","4984","1"
"12","2017","31","Hotel","15","16","925","1680","168","395","1093","2075","2"
"12","2017","31","Hotel","2","1","1160","1946","237","396","1397","2342","2"
"12","2017","31","Hotel","3","4","504","1503","306","429","810","1932","1"
"12","2017","31","Hotel","16","40","1110","1668","1355","2441","2465","4109","1"
"12","2017","31","Hotel","7","17","3206","4003","511","664","3717","4667","1"
"12","2017","31","Hotel","12","24","878","1182","3368","3987","4246","5169","1"
"12","2017","31","Hotel","12","35","936","1812","1953","3629","2889","5441","1"
"12","2017","31","Hotel","2","6","278","626","32","37","310","663","1"
"12","2017","31","Hotel","13","33","1092","1996","207","402","1299","2398","1"
"12","2017","31","Hotel","10","27","1277","1631","761","1137","2038","2768","1"
"12","2017","31","Hotel","10","23","1415","2522","288","518","1703","3040","1"
"12","2017","31","Hotel","11","36","1290","2027","298","690","1588","2717","1"
"12","2017","31","Hotel","8","34","1250","1800","60","246","1310","2046","1"
"12","2017","31","Hotel","2","6","698","1258","84","120","782","1378","1"
"12","2017","31","Hotel","14","31","587","878","1040","1617","1627","2495","7.8"
"12","2017","31","Hotel","11","36","1841","2921","253","461","2094","3382","1"
"12","2017","31","","10","27","381","1118","144","636","525","1754","1"
"12","2017","31","Hotel","14","31","1836","2917","2369","6913","4205","9830","5.4"
"12","2017","31","Hotel","4","13","3006","3020","4","8","3010","3028","1"
"12","2017","31","Hotel","6","28","1112","1278","105","147","1217","1425","1"
"12","2017","31","Otros","14","31","68","112","378","492","446","604","2.8"
"12","2017","31","Otros","16","27","100","100","5","5","105","105","2"
"12","2017","31","Hotel","2","1","778","1325","58","129","836","1454","2"
"12","2017","31","Hotel","10","18","676","1133","794","1331","1470","2464","1"
"12","2017","31","Hotel","7","17","1309","1778","348","648","1657","2426","1"
"12","2017","31","Hotel","12","24","492","1240","1047","3067","1539","4307","1"
"12","2017","31","Hotel","10","18","902","1763","869","1427","1771","3190","1"
"12","2017","31","Hotel","2","1","2512","3045","39","59","2551","3104","1"
"12","2017","31","Hotel","10","18","323","807","424","1131","747","1938","1"
"12","2017","31","Hotel","6","28","1244","1709","504","729","1748","2438","1"
"12","2017","31","Hotel","5","5","961","1475","500","549","1461","2024","1"
"12","2017","31","Hotel","4","13","349","677","59","138","408","815","1"
"12","2017","31","Hotel","10","18","819","1404","961","1648","1780","3052","1"
"12","2017","31","Hotel","16","40","1094","1868","159","241","1253","2109","1"
"12","2017","31","Hotel","8","3","2166","4992","968","2247","3134","7239","1"
"12","2017","31","Hotel","15","16","732","1092","190","418","922","1510","2"
"12","2017","31","Hotel","14","31","96","196","424","1539","520","1735","7.8"
"12","2017","31","Hotel","13","33","700","844","319","392","1019","1236","1"
"12","2017","31","Hotel","15","16","450","918","69","162","519","1080","2"
"12","2017","31","Otros","4","21","821","1649","1","3","822","1652","1"
"12","2017","14","Hotel","6","10","733","995","0","0","733","995","1"
"12","2017","31","Hotel","16","19","388","631","36","64","424","695","1"
"12","2017","31","Hotel","16","27","643","1863","2","4","645","1867","1"
"12","2017","31","Hotel","10","11","1258","2332","1615","2962","2873","5294","1"
"12","2017","31","Otros","10","23","334","750","8","20","342","770","1"
"12","2017","31","Hotel","12","35","174","207","382","1125","556","1332","1"
"12","2017","31","Hotel","11","36","516","977","72","334","588","1311","1"
"12","2017","31","Hotel","14","31","17","86","120","2583","137","2669","17.4"
"12","2017","31","Hotel","10","18","389","903","705","1726","1094","2629","3.2"
"12","2017","31","Hotel","4","13","405","591","19","83","424","674","1"
"12","2017","31","Hotel","6","12","392","642","70","142","462","784","5"
"12","2017","31","Hotel","6","10","582","886","38","88","620","974","1"
"12","2017","31","Otros","5","5","307","502","156","238","463","740","3.65625"
"12","2017","31","Hotel","12","24","998","1134","1477","1943","2475","3077","1"
"12","2017","31","Hotel","8","3","1155","2237","348","620","1503","2857","1"
"12","2017","31","Hotel","13","27","466","928","0","0","466","928","2.75"
"12","2017","31","Hotel","15","16","500","1000","20","200","520","1200","4"
"12","2017","31","Otros","15","16","261","955","69","271","330","1226","2"
"12","2017","31","Otros","16","20","540","1079","26","80","566","1159","1"
"12","2017","31","Hotel","3","4","679","1346","15","15","694","1361","1"
"12","2017","31","Hotel","11","36","129","151","0","0","129","151","1"
"12","2017","31","Hotel","2","6","170","1084","97","411","267","1495","1"
"12","2017","31","Hotel","8","34","666","1278","137","261","803","1539","1"
"12","2017","31","Hotel","4","13","277","453","13","17","290","470","3.2"
"12","2017","31","Hotel","13","27","679","1535","0","0","679","1535","2.75"
"12","2017","31","Hotel","2","29","221","543","1339","2931","1560","3474","1"
"12","2017","31","Otros","11","36","30","79","0","0","30","79","1"
"12","2017","31","","10","11","1","1","3","3","4","4","1"
"12","2017","31","Hotel","4","13","938","1203","66","205","1004","1408","1"
"12","2017","31","Hotel","16","40","2316","3477","927","1393","3243","4870","5.6666666666667"
"12","2017","31","Hotel","10","23","698","1042","681","1423","1379","2465","2.8"
"12","2017","31","Hotel","8","34","354","399","243","438","597","837","1"
"12","2017","31","Hotel","5","5","1610","2366","100","821","1710","3187","1"
"12","2017","31","Hotel","3","4","116","247","40","80","156","327","3"
"12","2017","31","Hotel","9","26","35","67","8","30","43","97","1"
"12","2017","31","Hotel","8","34","277","424","229","387","506","811","1"
"12","2017","31","Hotel","7","17","217","380","95","226","312","606","4"
"12","2017","31","Hotel","4","13","194","356","13","20","207","376","3.2"
"12","2017","31","Hotel","12","35","68","222","551","2388","619","2610","1"
"12","2017","31","Hotel","16","40","901","1896","1231","2571","2132","4467","1"
"12","2017","31","Hotel","9","26","320","524","83","301","403","825","1"
"12","2017","31","","6","27","232","391","23","44","255","435","1"
"12","2017","31","Hotel","9","26","198","294","6","12","204","306","1"
"12","2017","31","Hotel","4","13","180","249","58","68","238","317","3.2"
"12","2017","31","Hotel","6","28","727","817","60","76","787","893","1"
"12","2017","31","","2","29","134","364","585","1830","719","2194","1"
"12","2017","31","Hotel","13","33","1327","1655","168","253","1495","1908","1"
"12","2017","31","Hotel","8","3","364","816","223","487","587","1303","1"
"12","2017","31","Hotel","14","27","371","371","788","857","1159","1228","1"
"12","2017","31","Hotel","16","40","516","1421","75","293","591","1714","5.6666666666667"
"12","2017","31","Hotel","12","24","437","705","471","604","908","1309","1"
"12","2017","31","Hotel","10","18","931","1672","339","790","1270","2462","3.2"
"12","2017","31","Otros","15","16","164","167","14","14","178","181","9"
"12","2017","31","Hotel","6","10","612","667","12","12","624","679","1"
"12","2017","31","Hotel","10","11","538","900","120","310","658","1210","1"
"12","2017","31","Otros","6","10","98","442","0","0","98","442","3.8518518518518"
"12","2017","31","Otros","10","23","130","344","0","0","130","344","1"
"12","2017","31","Hotel","10","23","425","649","464","899","889","1548","2.8"
"12","2017","31","Hotel","6","12","165","249","27","41","192","290","5"
"12","2017","31","Hotel","6","27","101","201","5","11","106","212","3"
"12","2017","31","Hotel","10","23","398","660","471","1002","869","1662","2.8"
"12","2017","31","","4","39","112","407","0","0","112","407","1"
"12","2017","31","Hotel","8","34","270","344","493","688","763","1032","1"
"12","2017","31","Hotel","8","34","405","615","269","435","674","1050","1"
"12","2017","31","Otros","4","39","12","22","0","0","12","22","2.2222222222222"
"12","2017","31","Otros","13","14","268","553","0","0","268","553","1"
"12","2017","31","Hotel","10","23","162","221","63","102","225","323","2.8"
"12","2017","31","Otros","13","14","280","1000","0","0","280","1000","1"
"12","2017","31","Hotel","12","24","452","663","647","1145","1099","1808","1"
"12","2017","31","","6","25","151","215","0","0","151","215","1"
"12","2017","31","Hotel","15","27","871","1450","1","5","872","1455","1"
"12","2017","31","Hotel","12","35","95","164","820","1556","915","1720","1"
"12","2017","31","Hotel","16","40","217","726","459","1279","676","2005","1"
"12","2017","31","Hotel","16","27","35","41","59","71","94","112","1"
"12","2017","31","Hotel","9","30","76","207","0","0","76","207","1"
"12","2017","31","Hotel","4","13","250","456","69","130","319","586","3.2"
"12","2017","31","Hotel","2","29","105","193","583","1128","688","1321","1"
"12","2017","31","Hotel","16","20","620","709","465","465","1085","1174","1"
"12","2017","31","Hotel","5","5","701","840","255","320","956","1160","1"
"12","2017","31","Hotel","13","33","573","906","62","125","635","1031","1"
"12","2017","31","Otros","16","19","166","296","4","12","170","308","1.3333333333333"
"12","2017","31","Hotel","12","24","144","272","397","828","541","1100","1"
"12","2017","31","","8","2","276","521","67","159","343","680","1"
"12","2017","31","Hotel","12","35","12","76","231","1803","243","1879","1"
"12","2017","31","Hotel","16","27","50","54","316","356","366","410","2.5"
"12","2017","31","Otros","16","27","530","829","28","77","558","906","2"
"12","2017","31","Hotel","8","34","395","522","243","396","638","918","1"
"12","2017","31","Otros","8","3","232","664","12","48","244","712","1"
"12","2017","31","Hotel","7","27","264","353","57","79","321","432","1"
"12","2017","31","Hotel","4","39","141","220","10","35","151","255","1"
"12","2017","31","Hotel","15","16","274","548","28","66","302","614","4"
"12","2017","31","Hotel","4","39","4","16","2","4","6","20","1"
"12","2017","31","Hotel","4","39","182","320","7","22","189","342","1"
"12","2017","16","Hotel","15","16","201","766","1","1","202","767","4"
"12","2017","31","Hotel","14","31","13","25","273","601","286","626","17.4"
"12","2017","31","Hotel","8","34","221","392","187","273","408","665","1"
"12","2017","31","Hotel","6","28","190","305","28","51","218","356","1"
"12","2017","31","Hotel","7","17","907","1264","194","326","1101","1590","4"
"12","2017","31","Otros","7","27","21","215","0","0","21","215","1"
"12","2017","31","Hotel","11","36","1276","1412","83","184","1359","1596","1"
"12","2017","31","Otros","4","21","265","544","172","404","437","948","1"
"12","2017","31","Otros","15","16","161","251","52","89","213","340","2"
"12","2017","31","Otros","7","17","310","622","96","163","406","785","3"
"12","2017","31","Hotel","7","38","91","97","21","23","112","120","1"
"12","2017","31","Hotel","16","27","500","630","25","59","525","689","2.5"
"12","2017","31","Hotel","2","6","35","47","0","0","35","47","2.2"
"12","2017","31","Hotel","11","36","479","623","98","222","577","845","1"
"12","2017","31","Hotel","6","28","26","36","7","17","33","53","1"
"12","2017","31","Hotel","6","12","108","170","0","0","108","170","5"
"12","2017","31","Otros","9","22","79","201","0","0","79","201","1"
"12","2017","26","","13","14","167","223","0","0","167","223","2"
"12","2017","31","Hotel","2","29","125","300","653","1296","778","1596","1"
"12","2017","31","Hotel","2","29","75","243","127","345","202","588","1"
"12","2017","31","Otros","4","13","491","515","27","27","518","542","1"
"12","2017","31","Hotel","15","16","91","230","40","95","131","325","4"
"12","2017","31","Hotel","2","1","148","298","3","7","151","305","6.4"
"12","2017","31","Otros","7","27","91","167","0","0","91","167","1"
"12","2017","31","Otros","13","33","76","77","0","0","76","77","5.125"
"12","2017","31","","4","21","484","567","12","16","496","583","1"
"12","2017","31","Hotel","6","10","258","378","6","6","264","384","1"
"12","2017","31","Hotel","11","36","128","222","0","0","128","222","1"
"12","2017","31","Otros","14","31","130","218","158","284","288","502","2.8"
"12","2017","31","Hotel","7","27","179","288","13","41","192","329","1"
"12","2017","31","Otros","6","10","45","190","0","0","45","190","3.8518518518518"
"12","2017","31","Hotel","4","39","30","48","17","30","47","78","2.6"
"12","2017","31","Otros","8","2","47","77","55","135","102","212","6.4285714285714"
"12","2017","31","Otros","11","36","29","61","8","12","37","73","5.1904761904762"
"12","2017","31","Hotel","13","33","103","143","0","0","103","143","1"
"12","2017","31","","3","4","60","104","55","75","115","179","1"
"12","2017","31","Hotel","7","17","257","475","47","109","304","584","4"
"12","2017","23","Hotel","8","2","110","151","4","4","114","155","1"
"12","2017","31","Otros","15","16","168","220","23","27","191","247","2"
"12","2017","28","Hotel","10","11","398","583","12","12","410","595","1"
"12","2017","31","Hotel","16","19","248","286","0","0","248","286","1"
"12","2017","31","Hotel","10","23","103","137","52","68","155","205","4"
"12","2017","31","","7","38","290","347","51","57","341","404","1"
"12","2017","31","Hotel","7","27","407","713","0","0","407","713","1"
"12","2017","31","Hotel","11","36","1195","1634","144","328","1339","1962","1"
"12","2017","31","Hotel","16","40","157","255","22","44","179","299","16.333333333333"
"12","2017","31","Hotel","16","19","95","131","0","0","95","131","1"
"12","2017","31","Hotel","16","19","10","12","0","0","10","12","1"
"12","2017","0","Hotel","16","20","0","0","0","0","0","0","1"
"12","2017","31","Hotel","10","11","166","221","19","25","185","246","1"
"12","2017","31","Otros","7","27","61","152","4","11","65","163","4.8333333333333"
"12","2017","31","Otros","7","27","50","68","0","0","50","68","1"
"12","2017","31","Hotel","7","27","19","21","0","0","19","21","4.1666666666667"
"12","2017","31","Otros","13","14","201","377","4","40","205","417","1"
"12","2017","31","Otros","11","15","60","64","0","0","60","64","2.3571428571429"
"12","2017","31","Otros","10","27","44","77","30","61","74","138","4.84"
"12","2017","31","Otros","14","31","77","77","1500","1500","1577","1577","2.8"
"12","2017","31","Otros","11","36","5","8","0","0","5","8","5.1904761904762"
"12","2017","31","Hotel","16","19","61","70","8","10","69","80","1"
"12","2017","27","","14","27","270","418","12","18","282","436","2.6666666666667"
"12","2017","31","Hotel","16","40","98","102","4","4","102","106","5.6666666666667"
"12","2017","31","Hotel","10","27","9","23","0","0","9","23","2.25"
"12","2017","31","Otros","2","29","171","421","275","836","446","1257","3.28"
"12","2017","31","Hotel","13","27","3","6","31","34","34","40","1"
"12","2017","31","Otros","9","22","57","63","2","2","59","65","1"
"12","2017","31","Hotel","2","27","104","164","16","35","120","199","1"
"12","2017","31","Hotel","8","34","332","410","126","150","458","560","1"
"12","2017","31","Hotel","7","27","245","376","0","0","245","376","1"
"12","2017","31","Hotel","15","16","178","332","123","238","301","570","4"
"12","2017","17","Hotel","16","20","30","43","6","6","36","49","1"
"12","2017","31","Otros","4","13","75","436","0","0","75","436","1"
"12","2017","31","Hotel","2","1","184","458","2","3","186","461","6.4"
"12","2017","15","Otros","11","32","13","21","0","0","13","21","2.2857142857143"
"12","2017","31","Hotel","2","29","15","79","189","1453","204","1532","1"
"12","2017","31","Hotel","16","27","181","192","78","96","259","288","2.5"
"12","2017","31","Hotel","10","18","375","1102","1","5","376","1107","3.2"
"12","2017","31","Otros","11","36","278","386","49","59","327","445","1"
"12","2017","31","Otros","13","14","53","97","0","0","53","97","1"
"12","2017","31","Hotel","7","27","89","151","0","0","89","151","1"
"12","2017","31","Otros","7","17","164","357","0","0","164","357","3"
"12","2017","31","Otros","14","31","216","408","200","468","416","876","2.8"
"12","2017","31","Hotel","2","29","282","805","342","1012","624","1817","1"
"12","2017","31","Hotel","8","3","102","268","154","357","256","625","1"
"12","2017","31","Hotel","8","34","275","377","126","242","401","619","2.5714285714286"
"12","2017","31","Hotel","8","34","242","306","176","412","418","718","2.5714285714286"
"12","2017","31","Hotel","12","35","89","97","154","181","243","278","1"
"12","2017","31","Hotel","11","32","245","418","23","51","268","469","1"
"12","2017","31","Hotel","13","33","183","381","20","31","203","412","2"
"12","2017","31","Hotel","10","23","278","386","100","164","378","550","2.8"
"12","2017","31","Hotel","12","35","156","678","77","144","233","822","1"
"12","2017","31","","16","40","320","513","62","163","382","676","3.0555555555556"
"12","2017","31","Otros","16","19","7","11","0","0","7","11","1.3333333333333"
"12","2017","31","Otros","16","20","60","240","0","0","60","240","1"
"12","2017","31","Hotel","6","12","153","328","16","35","169","363","5"
"12","2017","31","Hotel","16","19","219","301","0","0","219","301","4"
"12","2017","31","Hotel","12","24","135","256","312","541","447","797","1"
"12","2017","31","Hotel","12","24","179","332","397","542","576","874","3"
"12","2017","31","Hotel","8","3","230","920","0","0","230","920","1"
"12","2017","31","Hotel","5","9","3","3","52","670","55","673","1"
"12","2017","31","Hotel","16","27","241","428","29","50","270","478","2.5"
"12","2017","27","Otros","10","23","44","44","0","0","44","44","7"
"12","2017","31","Otros","13","14","126","178","1","8","127","186","7.3846153846154"
"12","2017","31","Otros","2","6","36","104","9","26","45","130","1"
"12","2017","30","Hotel","15","16","13","13","92","109","105","122","7.8"
"12","2017","31","Hotel","8","3","128","502","0","0","128","502","1"
"12","2017","31","Hotel","8","34","155","297","330","519","485","816","1"
"12","2017","31","Hotel","8","3","89","138","52","95","141","233","1"
"12","2017","31","","2","29","87","205","83","299","170","504","1"
"12","2017","31","Hotel","2","1","301","413","33","50","334","463","6.4"
"12","2017","31","Hotel","7","17","110","176","3","4","113","180","4"
"12","2017","31","Otros","7","17","147","525","83","456","230","981","3"
"12","2017","31","Hotel","16","40","179","220","76","104","255","324","5.6666666666667"
"12","2017","31","Hotel","12","24","284","477","600","859","884","1336","1"
"12","2017","31","Hotel","14","31","191","292","274","1051","465","1343","17.4"
"12","2017","0","Hotel","9","26","0","0","0","0","0","0","1"
"12","2017","31","Hotel","6","12","20","20","20","20","40","40","5"
"12","2017","31","Otros","5","9","9","9","7","7","16","16","4.0454545454545"
"12","2017","31","Otros","5","9","3","3","3","3","6","6","4.0454545454545"
"12","2017","31","Otros","15","27","35","46","0","0","35","46","1.4222222222222"
"12","2017","31","Hotel","8","34","8","8","3","3","11","11","2.5714285714286"
"12","2017","31","Hotel","10","18","308","577","258","497","566","1074","7.75"
"12","2017","31","Hotel","15","16","174","504","44","126","218","630","7.8"
"12","2017","31","Hotel","2","29","51","181","416","1266","467","1447","1"
"12","2017","31","Hotel","4","39","52","134","6","30","58","164","2.6"
"12","2017","31","Otros","4","39","101","182","5","5","106","187","2.2222222222222"
"12","2017","31","Hotel","4","13","109","181","20","53","129","234","5.4"
"12","2017","31","Otros","10","23","92","95","0","0","92","95","7"
"12","2017","31","Otros","14","31","71","105","475","933","546","1038","20.2"
"12","2017","31","Hotel","3","4","46","78","30","47","76","125","2.6"
"12","2017","31","Hotel","10","23","106","373","55","161","161","534","4"
"12","2017","31","Otros","9","22","186","685","0","0","186","685","1"
"12","2017","31","Hotel","12","24","159","339","447","668","606","1007","3"
"12","2017","0","Hotel","13","14","0","0","0","0","0","0","1"
"12","2017","31","Hotel","12","35","155","296","175","257","330","553","1.7272727272727"
"12","2017","31","Hotel","6","28","333","538","0","0","333","538","1"
"12","2017","31","","6","28","47","62","0","0","47","62","1"
"12","2017","31","Hotel","12","24","317","675","189","558","506","1233","3"
"12","2017","31","Otros","5","9","8","8","4","4","12","12","4.0454545454545"
"12","2017","31","Hotel","16","20","54","70","0","0","54","70","1"
"12","2017","31","Hotel","4","21","203","385","54","86","257","471","3"
"12","2017","31","Otros","10","11","25","30","5","6","30","36","11.764705882353"
"12","2017","31","Otros","13","14","20","32","0","0","20","32","7.3846153846154"
"12","2017","31","Otros","16","27","69","137","0","0","69","137","13.818181818182"
"12","2017","31","Hotel","9","26","230","340","0","0","230","340","1"
"12","2017","31","Hotel","16","27","698","732","491","588","1189","1320","2.5"
"12","2017","31","Hotel","3","4","1034","1865","140","285","1174","2150","3"
"12","2017","31","Otros","16","27","40","45","0","0","40","45","2"
"12","2017","31","Otros","16","19","1074","2861","0","0","1074","2861","1.3333333333333"
"12","2017","31","Hotel","6","12","497","730","37","37","534","767","5"
"12","2017","31","Hotel","2","1","159","316","19","22","178","338","6.4"
"12","2017","31","Hotel","10","11","286","504","65","107","351","611","1"
"12","2017","31","Otros","10","23","85","85","5","5","90","90","1"
"12","2017","31","Otros","10","27","899","1006","130","154","1029","1160","4.84"
"12","2017","31","Hotel","16","27","297","440","84","199","381","639","2.5"
"12","2017","31","Hotel","6","28","112","148","16","16","128","164","1"
"12","2017","31","Hotel","4","13","95","193","2","2","97","195","5.4"
"12","2017","31","Hotel","14","27","447","594","43","469","490","1063","8.5"
"12","2017","31","Hotel","10","27","75","121","475","595","550","716","1"
"12","2017","31","Hotel","13","27","121","148","68","85","189","233","4.2"
"12","2017","31","Hotel","3","4","478","749","21","38","499","787","3"
"12","2017","31","Otros","4","13","89","217","12","24","101","241","3.4"
"12","2017","31","Otros","11","15","9","14","5","6","14","20","2.3571428571429"
"12","2017","31","Otros","6","10","106","195","0","0","106","195","3.8518518518518"
"12","2017","31","Otros","2","1","38","47","8","9","46","56","1"
"12","2017","31","","6","12","62","348","0","0","62","348","1"
"12","2017","31","Otros","10","23","271","609","121","319","392","928","1"
"12","2017","31","Hotel","16","19","153","177","0","0","153","177","4"
"12","2017","31","Hotel","10","11","37","222","0","0","37","222","5.6666666666667"
"12","2017","31","Hotel","10","23","84","87","22","24","106","111","4"
"12","2017","31","Otros","14","31","35","117","292","813","327","930","2.8"
"12","2017","31","Otros","13","27","4","4","0","0","4","4","12.2"
"12","2017","31","Hotel","2","1","188","560","0","0","188","560","6.4"
"12","2017","8","Hotel","16","19","74","89","0","0","74","89","4"
"12","2017","31","Otros","12","35","28","45","5","5","33","50","3.5"
"12","2017","31","Otros","15","16","75","162","77","217","152","379","2"
"12","2017","31","Otros","9","22","203","406","17","34","220","440","1"
"12","2017","31","Hotel","10","27","216","334","563","662","779","996","1"
"12","2017","31","Hotel","2","27","82","122","11","20","93","142","3.6"
"12","2017","31","Hotel","16","20","39","95","45","75","84","170","1"
"12","2017","31","Hotel","10","18","155","300","101","211","256","511","7.75"
"12","2017","31","Hotel","6","12","232","332","0","0","232","332","5"
"12","2017","31","Hotel","2","27","104","199","3","14","107","213","3.6"
"12","2017","31","Hotel","15","16","120","181","6","8","126","189","7.8"
"12","2017","31","Hotel","10","23","64","64","16","16","80","80","4"
"12","2017","31","Hotel","11","32","11","11","2","2","13","13","1"
"12","2017","31","Hotel","14","27","136","305","30","127","166","432","8.5"
"12","2017","31","Otros","10","11","22","41","11","15","33","56","11.764705882353"
"12","2017","31","Hotel","2","27","93","170","18","26","111","196","3.6"
"12","2017","31","Otros","13","14","189","331","12","40","201","371","7.3846153846154"
"12","2017","31","Hotel","2","1","143","154","9","9","152","163","6.4"
"12","2017","31","Otros","7","17","265","867","22","77","287","944","17.166666666667"
"12","2017","31","Otros","10","23","19","72","0","0","19","72","7"
"12","2017","31","Hotel","13","27","175","175","3","3","178","178","2.75"
"12","2017","31","Otros","10","18","170","565","16","38","186","603","10.25"
"12","2017","31","Otros","5","9","27","343","0","0","27","343","4.0454545454545"
"12","2017","27","Hotel","4","39","63","63","3","3","66","66","2.6"
"12","2017","31","Otros","16","27","48","315","0","0","48","315","13.818181818182"
"12","2017","31","Hotel","14","27","19","27","45","94","64","121","8.5"
"12","2017","31","Hotel","10","11","84","153","71","123","155","276","5.6666666666667"
"12","2017","31","Hotel","10","18","79","166","92","188","171","354","7.75"
"12","2017","31","Otros","14","31","114","151","87","178","201","329","20.2"
"12","2017","31","Otros","11","32","20","44","4","30","24","74","2.2857142857143"
"12","2017","31","Otros","5","5","45","70","20","37","65","107","3.65625"
"12","2017","31","Otros","6","25","43","317","0","0","43","317","2.3846153846154"
"12","2017","31","Hotel","3","4","50","112","9","22","59","134","2.6"
"12","2017","31","Otros","7","27","105","171","19","25","124","196","4.8333333333333"
"12","2017","31","Otros","2","29","81","227","133","318","214","545","3.28"
"12","2017","31","Hotel","2","29","78","207","178","535","256","742","1"
"12","2017","31","Otros","4","21","164","265","21","63","185","328","1"
"12","2017","31","Hotel","7","27","173","178","0","0","173","178","4.1666666666667"
"12","2017","31","Otros","5","5","12","22","5","7","17","29","3.65625"
"12","2017","31","Otros","11","36","53","71","43","90","96","161","5.1904761904762"
"12","2017","31","Hotel","7","27","300","300","0","0","300","300","4.1666666666667"
"12","2017","0","Hotel","16","20","0","0","0","0","0","0","1"
"12","2017","31","Hotel","12","24","57","146","316","371","373","517","3"
"12","2017","26","Hotel","9","26","112","182","5","8","117","190","1.5"
"12","2017","31","Hotel","7","17","276","642","95","273","371","915","10"
"12","2017","31","Hotel","9","37","243","446","53","141","296","587","3.4"
"12","2017","31","Hotel","5","5","262","414","125","192","387","606","2.1428571428571"
"12","2017","31","Otros","6","27","129","258","6","12","135","270","3.960088691796"
"12","2017","31","Hotel","9","37","110","164","8","8","118","172","3.4"
"12","2017","31","Otros","10","27","38","45","0","0","38","45","4.84"
"12","2017","31","Otros","8","3","176","334","9","14","185","348","10"
"12","2017","31","Otros","16","20","33","43","2","2","35","45","3.0769230769231"
"12","2017","31","Otros","9","22","10","17","0","0","10","17","7.6428571428571"
"12","2017","31","Otros","10","27","184","237","67","83","251","320","4.84"
"12","2017","31","Otros","10","23","30","41","4","4","34","45","7"
"12","2017","31","Otros","2","6","310","310","182","182","492","492","1"
"12","2017","31","Otros","4","39","4","5","0","0","4","5","2.2222222222222"
"12","2017","31","Hotel","2","27","75","97","23","35","98","132","1"
"12","2017","31","Hotel","14","31","54","140","112","795","166","935","24"
"12","2017","31","Otros","2","29","98","212","118","420","216","632","3.28"
"12","2017","31","Otros","8","3","138","690","0","0","138","690","10"
"12","2017","31","","13","14","24","50","8","12","32","62","1"
"12","2017","31","Hotel","6","10","167","225","33","33","200","258","6.6"
"12","2017","31","Hotel","8","34","144","187","124","182","268","369","2.5714285714286"
"12","2017","31","Hotel","9","22","71","433","0","0","71","433","2.5555555555556"
"12","2017","31","Hotel","2","6","93","222","42","45","135","267","2.2"
"12","2017","31","Hotel","10","27","102","163","201","238","303","401","2.25"
"12","2017","31","Otros","14","27","167","167","0","0","167","167","11.833333333333"
"12","2017","31","Otros","6","12","376","547","8","13","384","560","1.8256578947368"
"12","2017","31","Hotel","6","27","83","119","0","0","83","119","3"
"12","2017","31","Hotel","5","5","19","50","27","31","46","81","2.1428571428571"
"12","2017","24","Hotel","5","5","98","121","55","136","153","257","2.1428571428571"
"12","2017","31","Hotel","13","27","41","41","0","0","41","41","4.2"
"12","2017","31","Hotel","2","27","250","337","1","6","251","343","3.6"
"12","2017","31","Hotel","8","3","60","60","50","50","110","110","4.1111111111111"
"12","2017","31","Otros","11","36","55","216","7","23","62","239","5.1904761904762"
"12","2017","31","Otros","9","30","122","259","0","0","122","259","2.3333333333333"
"12","2017","31","Otros","16","19","28","84","0","0","28","84","10.263157894737"
"12","2017","31","Hotel","14","31","65","104","293","789","358","893","17.4"
"12","2017","31","Hotel","2","1","247","326","5","5","252","331","6.4"
"12","2017","31","Hotel","16","40","913","1707","591","1024","1504","2731","5.6666666666667"
"12","2017","31","Otros","7","17","281","621","25","154","306","775","17.166666666667"
"12","2017","31","Hotel","13","27","360","451","148","580","508","1031","2.75"
"12","2017","31","Hotel","14","31","182","227","362","503","544","730","24"
"12","2017","31","Otros","3","4","19","40","19","31","38","71","12.2"
"12","2017","31","Otros","8","34","246","295","160","193","406","488","5.75"
"12","2017","31","Hotel","9","22","141","185","3","3","144","188","2.5555555555556"
"12","2017","31","Hotel","4","21","84","163","4","9","88","172","3"
"12","2017","31","Hotel","6","27","47","63","0","0","47","63","3"
"12","2017","31","Hotel","12","35","61","109","167","272","228","381","1.7272727272727"
"12","2017","31","Hotel","2","29","43","101","181","352","224","453","2"
"12","2017","31","Otros","10","11","52","73","7","9","59","82","11.764705882353"
"12","2017","31","Hotel","6","10","52","77","0","0","52","77","6.6"
"12","2017","31","Hotel","13","14","11","18","5","5","16","23","2"
"12","2017","10","Otros","16","27","65","109","0","0","65","109","13.818181818182"
"12","2017","31","Otros","6","27","19","27","0","0","19","27","3.960088691796"
"12","2017","31","Hotel","16","40","117","218","607","1400","724","1618","5.6666666666667"
"12","2017","31","Otros","6","10","91","173","0","0","91","173","3.8518518518518"
"12","2017","31","Otros","10","23","15","29","8","11","23","40","7"
"12","2017","31","Hotel","6","28","197","244","17","17","214","261","1"
"12","2017","31","Otros","7","38","249","450","97","192","346","642","2.75"
"12","2017","31","Hotel","6","12","292","465","0","0","292","465","5"
"12","2017","31","Hotel","13","27","220","305","9","11","229","316","4.2"
"12","2017","31","Otros","4","21","18","41","0","0","18","41","4.8333333333333"
"12","2017","31","Hotel","16","27","69","164","12","12","81","176","5.8571428571429"
"12","2017","31","Hotel","5","5","79","201","67","67","146","268","2.1428571428571"
"12","2017","31","Otros","12","24","49","140","88","102","137","242","9.2"
"12","2017","31","Otros","15","16","64","112","24","34","88","146","9"
"12","2017","31","Hotel","8","27","95","95","14","14","109","109","4.5"
"12","2017","31","Hotel","9","22","12","34","0","0","12","34","2.5555555555556"
"12","2017","31","Hotel","10","11","127","199","44","78","171","277","5.6666666666667"
"12","2017","31","Hotel","8","3","76","129","60","115","136","244","4.1111111111111"
"12","2017","31","Hotel","6","10","216","292","12","20","228","312","6.6"
"12","2017","31","Otros","9","26","40","169","9","11","49","180","3.8888888888889"
"12","2017","31","Hotel","4","39","71","139","14","52","85","191","2.6"
"12","2017","31","Otros","6","27","7","14","0","0","7","14","3.960088691796"
"12","2017","31","Otros","6","12","137","174","0","0","137","174","1.8256578947368"
"12","2017","31","Hotel","6","27","102","177","3","5","105","182","3"
"12","2017","31","Otros","5","9","61","61","17","29","78","90","4.0454545454545"
"12","2017","31","Hotel","2","27","122","122","23","23","145","145","3.6"
"12","2017","31","Hotel","2","29","89","267","246","844","335","1111","1"
"12","2017","31","Hotel","4","13","226","379","10","10","236","389","5.4"
"12","2017","31","","11","15","54","286","0","0","54","286","1"
"12","2017","31","Hotel","6","10","435","469","18","22","453","491","6.6"
"12","2017","31","Otros","6","12","44","87","0","0","44","87","1.8256578947368"
"12","2017","31","Otros","10","18","29","29","6","6","35","35","10.25"
"12","2017","31","Otros","9","22","259","560","0","0","259","560","7.6428571428571"
"12","2017","31","","14","27","352","398","0","0","352","398","1"
"12","2017","30","Hotel","16","27","76","135","5","19","81","154","5.8571428571429"
"12","2017","31","Otros","2","29","7","16","15","29","22","45","3.28"
"12","2017","31","Otros","13","33","31","33","0","0","31","33","5.125"
"12","2017","31","Otros","13","33","30","41","0","0","30","41","5.125"
"12","2017","31","Otros","6","10","106","668","0","0","106","668","3.8518518518518"
"12","2017","31","Hotel","10","18","35","62","33","78","68","140","7.75"
"12","2017","31","Hotel","14","31","90","138","25","75","115","213","24"
"12","2017","31","Hotel","4","21","96","96","3","3","99","99","3"
"12","2017","31","Hotel","3","4","23","53","40","204","63","257","2.6"
"12","2017","31","Otros","8","27","99","195","0","0","99","195","1"
"12","2017","31","Otros","6","27","20","64","0","0","20","64","3.960088691796"
"12","2017","31","Hotel","6","25","151","459","7","35","158","494","1"
"12","2017","31","Otros","6","12","158","278","6","9","164","287","1.8256578947368"
"12","2017","31","Hotel","6","27","30","44","0","0","30","44","3"
"12","2017","31","Otros","6","27","15","30","0","0","15","30","3.960088691796"
"12","2017","31","Otros","6","10","50","113","0","0","50","113","3.8518518518518"
"12","2017","31","Otros","6","12","62","134","0","0","62","134","1.8256578947368"
"12","2017","31","Otros","5","5","23","33","14","25","37","58","3.65625"
"12","2017","31","Hotel","12","24","119","317","110","282","229","599","3"
"12","2017","30","Hotel","15","16","159","186","3","9","162","195","7.8"
"12","2017","31","Otros","4","13","41","74","2","2","43","76","3.4"
"12","2017","31","Hotel","2","29","267","892","85","292","352","1184","1"
"12","2017","31","Hotel","4","21","7","11","5","8","12","19","3"
"12","2017","31","Hotel","10","27","138","232","556","658","694","890","2.25"
"12","2017","31","Hotel","8","3","151","240","73","122","224","362","4.1111111111111"
"12","2017","31","Hotel","12","27","72","92","31","32","103","124","1"
"12","2017","31","Otros","5","5","106","338","33","63","139","401","3.65625"
"12","2017","31","Otros","13","14","19","19","0","0","19","19","7.3846153846154"
"12","2017","31","Otros","10","11","189","443","119","166","308","609","11.764705882353"
"12","2017","30","Otros","16","40","286","482","23","48","309","530","28.142857142857"
"12","2017","31","Hotel","11","36","443","947","69","115","512","1062","1"
"12","2017","28","Otros","8","34","61","76","72","94","133","170","5.75"
"12","2017","31","Hotel","7","17","96","103","3","3","99","106","10"
"12","2017","31","Otros","12","35","224","360","10","12","234","372","3.5"
"12","2017","31","Otros","5","9","23","51","40","60","63","111","4.0454545454545"
"12","2017","31","Hotel","9","22","76","124","4","4","80","128","2.5555555555556"
"12","2017","31","Otros","2","29","47","96","43","115","90","211","3.28"
"12","2017","31","Otros","2","29","67","181","86","222","153","403","3.28"
"12","2017","31","Hotel","10","27","79","235","19","25","98","260","2.25"
"12","2017","31","Hotel","16","19","174","312","122","226","296","538","4"
"12","2017","31","Hotel","16","40","255","314","13","34","268","348","16.333333333333"
"12","2017","31","Hotel","8","27","183","263","37","41","220","304","4.5"
"12","2017","31","Otros","13","14","15","21","0","0","15","21","7.3846153846154"
"12","2017","31","Hotel","7","27","46","48","0","0","46","48","4.1666666666667"
"12","2017","31","Otros","2","6","2","2","0","0","2","2","5"
"12","2017","31","Hotel","7","17","394","810","35","212","429","1022","10"
"12","2017","31","Hotel","3","4","133","249","61","281","194","530","2.6"
"12","2017","31","Otros","6","12","12","160","0","0","12","160","1.8256578947368"
"12","2017","31","Otros","6","10","9","12","0","0","9","12","3.8518518518518"
"12","2017","31","Hotel","16","40","60","110","8","22","68","132","16.333333333333"
"12","2017","31","Otros","4","39","23","63","3","12","26","75","2.2222222222222"
"12","2017","31","Otros","13","14","101","270","0","0","101","270","7.3846153846154"
"12","2017","31","Otros","7","38","100","152","8","8","108","160","2.75"
"12","2017","31","Hotel","11","32","28","52","0","0","28","52","1"
"12","2017","17","Otros","11","36","92","157","1","1","93","158","5.1904761904762"
"12","2017","31","Hotel","4","21","148","148","29","41","177","189","3"
"12","2017","31","Otros","3","4","15","23","9","29","24","52","12.2"
"12","2017","31","Otros","5","9","59","92","62","99","121","191","4.0454545454545"
"12","2017","31","Hotel","8","27","40","86","6","28","46","114","4.5"
"12","2017","31","","7","17","133","433","14","56","147","489","1"
"12","2017","31","Otros","16","20","154","184","6","20","160","204","3.0769230769231"
"12","2017","31","Otros","4","21","79","102","22","24","101","126","4.8333333333333"
"12","2017","31","Otros","13","33","57","73","16","18","73","91","5.125"
"12","2017","31","","12","35","0","0","481","2012","481","2012","1"
"12","2017","31","Hotel","13","33","14","27","1","1","15","28","2"
"12","2017","31","Otros","4","39","18","35","0","0","18","35","2.2222222222222"
"12","2017","31","Otros","10","18","28","75","6","17","34","92","10.25"
"12","2017","31","Otros","6","27","70","101","3","4","73","105","3.960088691796"
"12","2017","31","Hotel","4","39","67","208","0","0","67","208","2.6"
"12","2017","31","Otros","14","31","280","304","154","250","434","554","20.2"
"12","2017","31","Hotel","2","29","36","108","152","363","188","471","2"
"12","2017","31","Hotel","9","26","124","218","4","9","128","227","1.5"
"12","2017","31","Otros","12","35","5","17","8","22","13","39","3.5"
"12","2017","31","Hotel","14","27","125","160","39","51","164","211","8.5"
"12","2017","31","Otros","11","36","111","283","8","32","119","315","5.1904761904762"
"12","2017","31","Otros","16","20","190","537","10","22","200","559","3.0769230769231"
"12","2017","31","Otros","4","39","3","10","0","0","3","10","2.2222222222222"
"12","2017","31","Otros","7","27","131","140","3","3","134","143","4.8333333333333"
"12","2017","31","Otros","6","27","91","154","2","2","93","156","3.960088691796"
"12","2017","31","Otros","5","8","10","310","0","0","10","310","5"
"12","2017","31","Otros","9","37","170","353","16","17","186","370","4.5"
"12","2017","31","Hotel","2","6","29","120","0","0","29","120","5.5"
"12","2017","31","Hotel","10","27","228","308","108","119","336","427","2.25"
"12","2017","31","Hotel","9","30","131","340","32","75","163","415","1"
"12","2017","31","Otros","4","13","12","20","3","4","15","24","3.4"
"12","2017","31","Hotel","5","5","252","252","77","77","329","329","1"
"12","2017","31","Otros","7","38","196","482","11","32","207","514","2.75"
"12","2017","31","Hotel","13","14","92","275","0","0","92","275","1"
"12","2017","31","Otros","5","9","14","20","18","22","32","42","4.0454545454545"
"12","2017","31","Otros","5","8","6","7","1","2","7","9","5"
"12","2017","26","Otros","10","27","16","416","0","0","16","416","4.84"
"12","2017","31","Hotel","13","14","6","11","0","0","6","11","1"
"12","2017","31","Otros","11","15","22","34","0","0","22","34","2.3571428571429"
"12","2017","31","Hotel","9","22","170","322","0","0","170","322","2.5555555555556"
"12","2017","31","Otros","11","36","106","164","34","36","140","200","5.1904761904762"
"12","2017","31","Hotel","10","18","1589","3047","2137","4410","3726","7457","1"
"12","2017","31","Hotel","6","12","146","277","4","4","150","281","5"
"12","2017","31","","2","29","683","2177","1200","3156","1883","5333","1"
"12","2017","31","Hotel","16","27","2297","3161","178","356","2475","3517","1"
"12","2017","31","","14","31","340","808","391","1517","731","2325","1"
"12","2017","31","Hotel","8","3","8","20","28","373","36","393","4.1111111111111"
"12","2017","31","Otros","13","33","48","90","35","45","83","135","5.125"
"12","2017","31","","14","27","100","166","0","0","100","166","2.6666666666667"
"12","2017","31","Otros","9","22","62","336","0","0","62","336","7.6428571428571"
"12","2017","31","Hotel","10","11","22","26","8","14","30","40","5.6666666666667"
"12","2017","31","Otros","6","12","7","11","0","0","7","11","1.8256578947368"
"12","2017","29","Hotel","8","3","94","126","27","40","121","166","4.1111111111111"
"12","2017","31","Otros","6","12","227","355","0","0","227","355","1.8256578947368"
"12","2017","31","Hotel","8","27","108","168","7","7","115","175","4.5"
"12","2017","31","Hotel","6","28","133","149","18","30","151","179","2.4"
"12","2017","31","Otros","6","25","101","696","0","0","101","696","2.3846153846154"
"12","2017","31","Otros","6","25","68","80","0","0","68","80","2.3846153846154"
"12","2017","31","Hotel","11","36","251","251","123","123","374","374","1"
"12","2017","31","Otros","2","6","36","82","193","597","229","679","5"
"12","2017","31","Hotel","14","31","40","75","142","313","182","388","24"
"12","2017","5","Otros","4","21","17","32","0","0","17","32","4.8333333333333"
"12","2017","31","Otros","7","38","29","63","5","7","34","70","2.75"
"12","2017","31","Otros","13","14","43","59","0","0","43","59","7.3846153846154"
"12","2017","31","Otros","2","29","50","75","48","56","98","131","3.28"
"12","2017","31","Otros","3","4","94","94","23","23","117","117","12.2"
"12","2017","31","Hotel","3","4","432","873","52","110","484","983","3"
"12","2017","31","Otros","7","27","202","301","31","36","233","337","1"
"12","2017","31","Otros","7","17","159","180","3","3","162","183","3"
"12","2017","31","Hotel","12","27","193","402","9","12","202","414","1"
"12","2017","31","Otros","5","5","33","60","8","19","41","79","3.65625"
"12","2017","31","Hotel","6","10","182","246","10","14","192","260","6.6"
"12","2017","31","Otros","10","18","8","44","0","0","8","44","10.25"
"12","2017","31","Otros","8","27","58","84","0","0","58","84","9.4"
"12","2017","31","Otros","8","3","12","26","22","51","34","77","10"
"12","2017","31","Hotel","16","27","46","65","0","0","46","65","5.8571428571429"
"12","2017","31","Otros","6","10","42","89","0","0","42","89","3.8518518518518"
"12","2017","31","Hotel","2","6","21","53","11","11","32","64","5.5"
"12","2017","31","Hotel","8","3","18","44","13","38","31","82","4.1111111111111"
"12","2017","31","Otros","10","11","18","26","14","16","32","42","11.764705882353"
"12","2017","31","Otros","6","27","55","71","0","0","55","71","3.960088691796"
"12","2017","27","Otros","15","16","5","15","0","0","5","15","9"
"12","2017","31","Otros","5","5","8","16","21","28","29","44","3.65625"
"12","2017","31","Otros","10","27","83","113","76","105","159","218","4.84"
"12","2017","31","Hotel","7","38","45","63","23","31","68","94","1"
"12","2017","31","Hotel","13","27","6","50","0","0","6","50","4.2"
"12","2017","31","Hotel","16","20","141","146","0","0","141","146","1"
"12","2017","31","Otros","10","27","87","146","141","193","228","339","4.84"
"12","2017","31","Hotel","3","7","40","51","11","19","51","70","1"
"12","2017","31","Otros","2","29","40","110","29","78","69","188","3.28"
"12","2017","31","Otros","10","18","6","16","0","0","6","16","10.25"
"12","2017","31","Otros","9","22","262","673","0","0","262","673","7.6428571428571"
"12","2017","31","Otros","15","27","102","107","11","11","113","118","1.4222222222222"
"12","2017","31","Otros","11","36","10","30","2","6","12","36","5.1904761904762"
"12","2017","31","Otros","5","5","27","42","6","9","33","51","3.65625"
"12","2017","31","Otros","2","29","10","50","19","77","29","127","3.28"
"12","2017","31","Hotel","9","22","148","248","25","25","173","273","2.5555555555556"
"12","2017","31","Otros","11","32","6","8","0","0","6","8","2.2857142857143"
"12","2017","31","Hotel","10","27","206","309","195","233","401","542","1"
"12","2017","31","Otros","16","27","92","127","8","16","100","143","2"
"12","2017","31","Hotel","16","20","19","37","0","0","19","37","1"
"12","2017","31","Otros","11","15","35","150","0","0","35","150","2.3571428571429"
"12","2017","31","Otros","7","17","33","102","1","1","34","103","3"
"12","2017","31","Otros","5","8","1","5","13","32","14","37","5"
"12","2017","30","Hotel","13","33","96","120","8","16","104","136","2"
"12","2017","31","Otros","5","9","74","123","30","52","104","175","4.0454545454545"
"12","2017","31","Otros","10","27","62","108","73","76","135","184","4.84"
"12","2017","31","Otros","9","22","117","243","0","0","117","243","7.6428571428571"
"12","2017","31","Otros","16","40","126","249","0","0","126","249","28.142857142857"
"12","2017","31","Hotel","16","40","80","108","12","18","92","126","1"
"12","2017","31","Otros","15","16","16","48","0","0","16","48","9"
"12","2017","31","Hotel","8","2","17","23","17","20","34","43","3"
"12","2017","31","Otros","8","3","215","350","0","0","215","350","10"
"12","2017","31","Otros","7","17","55","80","0","0","55","80","17.166666666667"
"12","2017","31","Otros","16","20","101","198","0","0","101","198","3.0769230769231"
"12","2017","31","Otros","6","27","54","84","3","45","57","129","3.960088691796"
"12","2017","31","Otros","12","35","44","98","247","399","291","497","3.5"
"12","2017","29","Otros","6","28","106","399","17","34","123","433","4.65"
"12","2017","31","Otros","6","28","336","631","31","42","367","673","4.65"
"12","2017","31","Hotel","8","34","80","135","80","80","160","215","2.5714285714286"
"12","2017","31","Hotel","16","20","1988","2399","10","19","1998","2418","1"
"12","2017","31","Hotel","2","6","63","94","0","0","63","94","2.2"
"12","2017","31","Hotel","7","27","35","60","0","0","35","60","4.1666666666667"
"12","2017","31","Hotel","10","23","1","21","0","0","1","21","4"
"12","2017","31","Hotel","9","26","29","50","17","28","46","78","1.5"
"12","2017","31","Otros","8","27","65","98","14","14","79","112","9.4"
"12","2017","31","Otros","10","27","26","28","4","4","30","32","4.84"
"12","2017","31","Otros","11","15","8","12","17","35","25","47","2.3571428571429"
"12","2017","31","Otros","16","20","65","107","4","12","69","119","3.0769230769231"
"12","2017","31","Otros","11","32","97","116","0","0","97","116","1"
"12","2017","31","Otros","16","27","83","83","4","4","87","87","13.818181818182"
"12","2017","31","Otros","9","37","127","127","0","0","127","127","4.5"
"12","2017","31","Hotel","2","29","25","40","50","193","75","233","2"
"12","2017","31","Hotel","2","1","22","116","0","0","22","116","6.4"
"12","2017","31","Otros","5","8","3","3","5","6","8","9","5"
"12","2017","31","Otros","9","37","56","76","31","60","87","136","4.5"
"12","2017","31","Otros","7","38","118","193","0","0","118","193","2.75"
"12","2017","31","Otros","11","32","44","92","5","5","49","97","1"
"12","2017","29","Otros","4","39","52","58","2","2","54","60","2.2222222222222"
"12","2017","31","Hotel","11","36","53","114","15","30","68","144","2.375"
"12","2017","31","Otros","10","23","73","152","5","16","78","168","7"
"12","2017","31","Hotel","15","16","631","1497","348","1227","979","2724","2"
"12","2017","31","Otros","2","29","21","43","210","439","231","482","3.28"
"12","2017","31","Hotel","6","12","907","1208","28","38","935","1246","1"
"12","2017","31","Hotel","11","15","145","379","0","0","145","379","1"
"12","2017","31","Otros","4","21","673","1306","15","20","688","1326","1"
"12","2017","31","Otros","16","19","112","279","0","0","112","279","10.263157894737"
"12","2017","31","","9","37","468","636","11","21","479","657","1"
"12","2017","31","Otros","10","27","191","296","157","235","348","531","4.84"
"12","2017","31","Otros","11","15","66","66","0","0","66","66","2.3571428571429"
"12","2017","31","Hotel","2","29","50","150","114","346","164","496","2"
"12","2017","31","Hotel","10","27","182","196","157","207","339","403","1"
"12","2017","31","Hotel","11","36","64","272","34","92","98","364","2.375"
"12","2017","31","Hotel","9","37","94","129","97","200","191","329","3.4"
"12","2017","31","Otros","14","27","20","40","0","0","20","40","11.833333333333"
"12","2017","31","Otros","7","38","225","376","0","0","225","376","1"
"12","2017","31","Hotel","2","1","28","88","0","0","28","88","6.4"
"12","2017","31","Otros","2","29","8","24","79","223","87","247","3.28"
"12","2017","31","Hotel","6","27","12","13","0","0","12","13","3"
"12","2017","31","Otros","5","9","93","93","0","0","93","93","4.0454545454545"
"12","2017","31","Hotel","2","1","142","172","0","0","142","172","6.4"
"12","2017","31","Hotel","3","7","9","36","38","47","47","83","1"
"12","2017","31","Otros","7","38","12","14","14","23","26","37","2.75"
"12","2017","31","Otros","7","17","18","55","0","0","18","55","17.166666666667"
"12","2017","31","Otros","7","38","25","50","7","14","32","64","2.75"
"12","2017","31","Otros","4","21","27","34","0","0","27","34","4.8333333333333"
"12","2017","31","Otros","2","1","39","39","8","8","47","47","5.5"
"12","2017","31","Otros","12","35","85","153","88","174","173","327","3.5"
"12","2017","31","Otros","12","35","31","41","96","110","127","151","3.5"
"12","2017","31","Otros","4","21","42","57","8","20","50","77","4.8333333333333"
"12","2017","31","Otros","12","24","27","67","17","65","44","132","9.2"
"12","2017","31","Otros","16","19","6","8","0","0","6","8","10.263157894737"
"12","2017","31","Otros","10","11","200","381","8","12","208","393","11.764705882353"
"12","2017","31","Otros","16","19","53","100","0","0","53","100","10.263157894737"
"12","2017","31","Hotel","2","27","45","45","13","13","58","58","1"
"12","2017","31","Otros","6","28","74","85","0","0","74","85","4.65"
"12","2017","31","Otros","10","18","204","424","96","258","300","682","10.25"
"12","2017","31","Otros","14","27","26","64","1","7","27","71","11.833333333333"
"12","2017","31","Hotel","11","32","5","10","5","18","10","28","1"
"12","2017","31","Otros","8","27","1","1","0","0","1","1","9.4"
"12","2017","31","Hotel","12","35","44","83","130","208","174","291","1.7272727272727"
"12","2017","31","Otros","13","14","9","9","6","6","15","15","7.3846153846154"
"12","2017","31","Otros","11","36","29","34","0","0","29","34","5.1904761904762"
"12","2017","31","Otros","16","20","61","101","12","28","73","129","3.0769230769231"
"12","2017","31","Hotel","14","31","99","179","699","899","798","1078","7.8"
"12","2017","31","Otros","2","27","145","264","8","10","153","274","3.2"
"12","2017","31","","16","40","455","1193","0","0","455","1193","3.0555555555556"
"12","2017","31","Hotel","11","36","98","142","10","24","108","166","2.375"
"12","2017","31","Hotel","9","22","22","32","4","6","26","38","2.5555555555556"
"12","2017","31","Otros","2","29","19","40","36","97","55","137","3.28"
"12","2017","31","Hotel","10","27","10","15","109","119","119","134","2.25"
"12","2017","31","Otros","10","27","15","84","0","0","15","84","4.84"
"12","2017","31","Hotel","16","19","34","38","0","0","34","38","4"
"12","2017","20","Otros","2","6","17","29","0","0","17","29","5"
"12","2017","31","Otros","7","27","139","179","8","8","147","187","4.8333333333333"
"12","2017","31","Hotel","2","6","113","860","0","0","113","860","5.5"
"12","2017","31","Hotel","6","28","7","7","6","6","13","13","2.4"
"12","2017","31","Otros","6","10","239","611","0","0","239","611","3.8518518518518"
"12","2017","31","Hotel","6","27","25","44","1","1","26","45","3"
"12","2017","31","Otros","5","5","27","42","6","9","33","51","3.65625"
"12","2017","28","Otros","12","24","46","83","91","106","137","189","9.2"
"12","2017","31","Hotel","8","2","60","126","8","20","68","146","3"
"12","2017","31","Hotel","11","32","8","68","4","9","12","77","1"
"12","2017","31","Otros","10","18","25","49","52","54","77","103","10.25"
"12","2017","31","Hotel","9","37","37","82","26","54","63","136","3.4"
"12","2017","31","Otros","5","9","40","63","86","139","126","202","4.0454545454545"
"12","2017","28","Otros","12","24","26","61","58","112","84","173","9.2"
"12","2017","31","Otros","9","22","13","25","0","0","13","25","7.6428571428571"
"12","2017","31","Otros","2","29","8","19","25","73","33","92","3.28"
"12","2017","31","Otros","10","23","6","12","4","20","10","32","7"
"12","2017","31","Otros","10","27","34","34","22","24","56","58","4.84"
"12","2017","31","Otros","10","11","100","100","0","0","100","100","11.764705882353"
"12","2017","31","Otros","8","3","30","45","9","51","39","96","10"
"12","2017","31","Otros","14","31","59","112","479","813","538","925","20.2"
"12","2017","31","Otros","2","29","168","476","190","476","358","952","3.28"
"12","2017","31","Otros","6","25","72","144","0","0","72","144","1"
"12","2017","31","Hotel","15","16","25","48","0","0","25","48","7.8"
"12","2017","31","Hotel","15","27","82","161","2","2","84","163","1"
"12","2017","31","Otros","10","27","7","39","5","15","12","54","4.84"
"12","2017","31","Otros","10","23","73","73","4","4","77","77","7"
"12","2017","31","Otros","6","27","4","4","0","0","4","4","3.960088691796"
"12","2017","31","Otros","16","40","206","299","0","0","206","299","28.142857142857"
"12","2017","31","Otros","11","36","184","239","13","26","197","265","5.1904761904762"
"12","2017","31","Otros","8","34","24","27","6","21","30","48","5.75"
"12","2017","16","Otros","6","12","14","63","0","0","14","63","1.8256578947368"
"12","2017","31","Otros","6","10","154","198","0","0","154","198","3.8518518518518"
"12","2017","31","Hotel","4","21","161","431","62","88","223","519","3"
"12","2017","31","Hotel","11","36","118","216","48","107","166","323","2.375"
"12","2017","31","Otros","5","8","128","198","66","100","194","298","5"
"12","2017","31","Hotel","7","17","93","158","0","0","93","158","10"
"12","2017","11","Hotel","11","36","105","156","13","20","118","176","1"
"12","2017","31","Otros","9","30","32","32","0","0","32","32","2.3333333333333"
"12","2017","31","Hotel","12","35","45","77","147","268","192","345","1.7272727272727"
"12","2017","21","Otros","2","1","66","159","2","2","68","161","5.5"
"12","2017","31","Hotel","6","25","50","58","0","0","50","58","1"
"12","2017","31","Otros","5","5","25","37","18","32","43","69","3.65625"
"12","2017","31","Otros","2","29","17","46","46","159","63","205","3.28"
"12","2017","31","Hotel","2","6","23","27","11","12","34","39","5.5"
"12","2017","31","Otros","7","17","30","58","0","0","30","58","17.166666666667"
"12","2017","31","Hotel","8","2","28","36","0","0","28","36","3"
"12","2017","31","Hotel","13","14","10","11","2","8","12","19","1"
"12","2017","31","Otros","7","38","53","136","11","18","64","154","2.75"
"12","2017","31","Hotel","14","31","9","19","114","284","123","303","24"
"12","2017","31","Hotel","5","5","49","64","102","144","151","208","2.1428571428571"
"12","2017","31","Otros","2","27","18","19","1","1","19","20","3.2"
"12","2017","31","Otros","5","8","19","19","0","0","19","19","5"
"12","2017","31","Otros","3","4","28","102","0","0","28","102","12.2"
"12","2017","31","Otros","13","14","1","10","0","0","1","10","7.3846153846154"
"12","2017","31","Otros","9","37","74","370","0","0","74","370","4.5"
"12","2017","31","Hotel","10","23","746","955","56","75","802","1030","1"
"12","2017","31","Otros","11","32","13","13","0","0","13","13","2.2857142857143"
"12","2017","31","Otros","11","15","3","3","0","0","3","3","2.3571428571429"
"12","2017","31","Otros","8","3","339","866","8","20","347","886","10"
"12","2017","31","Otros","16","20","96","286","4","12","100","298","3.0769230769231"
"12","2017","31","Otros","8","3","54","66","0","0","54","66","10"
"12","2017","31","Otros","16","27","100","235","0","0","100","235","2"
"12","2017","31","Hotel","16","19","12","26","0","0","12","26","4"
"12","2017","31","Hotel","16","27","47","122","0","0","47","122","5.8571428571429"
"12","2017","31","Otros","9","26","27","41","0","0","27","41","3.8888888888889"
"12","2017","31","Otros","5","5","36","42","5","10","41","52","3.65625"
"12","2017","31","Otros","14","27","19","19","3","3","22","22","11.833333333333"
"12","2017","25","Hotel","5","5","22","56","11","42","33","98","2.1428571428571"
"12","2017","31","Hotel","12","24","105","323","92","238","197","561","3"
"12","2017","31","Otros","16","27","22","59","0","0","22","59","13.818181818182"
"12","2017","31","Otros","8","3","28","68","36","95","64","163","1"
"12","2017","31","Otros","13","27","135","171","0","0","135","171","12.2"
"12","2017","31","Hotel","16","40","35","49","20","41","55","90","16.333333333333"
"12","2017","31","Otros","11","36","29","130","0","0","29","130","1"
"12","2017","31","Otros","10","27","35","50","57","93","92","143","4.84"
"12","2017","31","Otros","9","22","55","138","0","0","55","138","7.6428571428571"
"12","2017","31","Hotel","5","5","38","61","70","121","108","182","2.1428571428571"
"12","2017","31","Otros","2","29","63","135","56","171","119","306","3.28"
"12","2017","31","Otros","2","29","0","0","24","72","24","72","3.28"
"12","2017","31","Hotel","13","14","68","68","6","6","74","74","1"
"12","2017","31","Otros","6","25","1","1","0","0","1","1","2.3846153846154"
"12","2017","31","Otros","2","1","7","10","2","2","9","12","5.5"
"12","2017","31","Hotel","12","27","39","50","73","81","112","131","1"
"12","2017","31","Hotel","13","27","11","28","0","0","11","28","4.2"
"12","2017","31","Otros","6","12","82","177","0","0","82","177","1.8256578947368"
"12","2017","31","Otros","6","27","42","47","0","0","42","47","3.960088691796"
"12","2017","31","Otros","6","25","41","41","0","0","41","41","2.3846153846154"
"12","2017","31","Hotel","6","28","22","60","2","6","24","66","2.5833333333333"
"12","2017","31","Otros","5","5","3","4","0","0","3","4","3.65625"
"12","2017","31","Otros","5","9","16","21","7","8","23","29","4.0454545454545"
"12","2017","31","Otros","5","8","17","23","9","14","26","37","5"
"12","2017","31","Hotel","2","29","181","413","77","274","258","687","1"
"12","2017","31","Otros","5","5","71","118","56","84","127","202","3.65625"
"12","2017","31","Hotel","9","26","28","58","0","0","28","58","1.5"
"12","2017","31","Otros","9","30","5","9","0","0","5","9","2.3333333333333"
"12","2017","31","Otros","11","15","21","34","0","0","21","34","2.3571428571429"
"12","2017","31","Hotel","16","27","2","4","10","14","12","18","5.8571428571429"
"12","2017","31","Otros","9","30","24","40","0","0","24","40","2.3333333333333"
"12","2017","31","Otros","2","29","24","31","45","168","69","199","3.28"
"12","2017","31","Otros","7","38","29","62","31","69","60","131","2.75"
"12","2017","31","Otros","4","21","75","285","34","109","109","394","4.8333333333333"
"12","2017","31","Otros","9","22","49","109","0","0","49","109","7.6428571428571"
"12","2017","31","Otros","9","22","154","304","0","0","154","304","7.6428571428571"
"12","2017","31","Otros","13","27","16","22","0","0","16","22","12.2"
"12","2017","31","Hotel","11","36","2104","2153","89","135","2193","2288","1"
"12","2017","31","Otros","13","33","14","32","4","8","18","40","5.125"
"12","2017","31","Otros","11","36","85","192","77","175","162","367","5.1904761904762"
"12","2017","31","Otros","12","35","52","77","313","468","365","545","3.5"
"12","2017","31","Otros","12","35","12","44","7","18","19","62","3.5"
"12","2017","31","Otros","10","11","76","160","8","24","84","184","11.764705882353"
"12","2017","31","Otros","12","24","6","18","15","60","21","78","9.2"
"12","2017","31","Otros","16","20","56","181","0","0","56","181","3.0769230769231"
"12","2017","31","Hotel","7","27","40","59","0","0","40","59","1"
"12","2017","31","Otros","6","12","24","26","0","0","24","26","1.8256578947368"
"12","2017","31","Otros","11","32","49","128","11","25","60","153","2.2857142857143"
"12","2017","31","Otros","6","28","29","33","0","0","29","33","4.65"
"12","2017","31","Otros","8","34","3","3","2","2","5","5","5.75"
"12","2017","28","Otros","16","27","6","7","0","0","6","7","13.818181818182"
"12","2017","31","Otros","10","11","6","6","0","0","6","6","11.764705882353"
"12","2017","31","Otros","6","10","66","220","2","8","68","228","3.8518518518518"
"12","2017","31","Otros","8","3","2","4","0","0","2","4","10"
"12","2017","31","Hotel","16","20","76","250","11","56","87","306","1"
"12","2017","31","Hotel","11","32","29","32","24","41","53","73","1"
"12","2017","31","Otros","8","27","30","124","2","4","32","128","9.4"
"12","2017","31","Otros","12","27","2","3","14","15","16","18","3.4285714285714"
"12","2017","31","Otros","6","10","30","42","0","0","30","42","3.8518518518518"
"12","2017","31","Otros","6","10","24","90","0","0","24","90","3.8518518518518"
"12","2017","31","Otros","5","8","15","19","9","9","24","28","5"
"12","2017","31","Otros","5","8","26","32","25","29","51","61","5"
"12","2017","31","Hotel","9","26","69","107","9","15","78","122","1.5"
"12","2017","31","Hotel","13","14","21","39","0","0","21","39","1"
"12","2017","31","Otros","10","18","80","214","83","254","163","468","10.25"
"12","2017","31","Otros","8","2","54","58","19","19","73","77","6.4285714285714"
"12","2017","31","Otros","7","27","9","10","0","0","9","10","4.8333333333333"
"12","2017","31","Otros","2","29","15","36","43","67","58","103","3.28"
"12","2017","31","Otros","11","32","1","1","0","0","1","1","2.2857142857143"
"12","2017","31","Otros","9","30","21","43","2","3","23","46","2.3333333333333"
"12","2017","31","Otros","2","29","15","40","2","6","17","46","3.28"
"12","2017","31","Otros","5","5","8","10","0","0","8","10","3.65625"
"12","2017","31","Otros","11","15","22","24","0","0","22","24","2.3571428571429"
"12","2017","31","Otros","10","23","9","9","0","0","9","9","7"
"12","2017","31","Otros","11","36","68","160","21","31","89","191","5.1904761904762"
"12","2017","31","Hotel","3","7","26","32","58","100","84","132","1"
"12","2017","31","Otros","10","27","8","12","2","2","10","14","4.84"
"12","2017","31","Otros","2","27","15","15","0","0","15","15","3.2"
"12","2017","31","Otros","12","35","29","60","60","138","89","198","3.5"
"12","2017","31","Otros","10","27","30","59","23","38","53","97","4.84"
"12","2017","31","Otros","16","40","41","90","163","461","204","551","28.142857142857"
"12","2017","31","Hotel","8","3","337","706","113","189","450","895","4.1111111111111"
"12","2017","31","Otros","9","22","46","125","0","0","46","125","7.6428571428571"
"12","2017","31","Otros","13","14","13","21","0","0","13","21","7.3846153846154"
"12","2017","31","Otros","5","9","4","4","10","10","14","14","4.0454545454545"
"12","2017","31","Otros","10","18","27","33","40","65","67","98","10.25"
"12","2017","31","Otros","6","25","201","526","0","0","201","526","2.3846153846154"
"12","2017","31","Otros","9","22","72","152","0","0","72","152","7.6428571428571"
"12","2017","31","Otros","10","27","35","67","0","0","35","67","4.84"
"12","2017","31","Otros","16","20","33","52","8","16","41","68","3.0769230769231"
"12","2017","31","Hotel","7","17","112","205","0","0","112","205","10"
"12","2017","31","Otros","15","27","56","73","0","0","56","73","1.4222222222222"
"12","2017","31","Otros","12","35","4","4","18","34","22","38","3.5"
"12","2017","31","Otros","12","35","19","19","224","271","243","290","3.5"
"12","2017","31","Otros","3","7","9","10","0","0","9","10","2"
"12","2017","31","Otros","10","11","9","12","9","15","18","27","11.764705882353"
"12","2017","31","Otros","12","24","5","15","10","30","15","45","9.2"
"12","2017","31","Otros","10","23","35","38","0","0","35","38","7"
"12","2017","31","Otros","7","27","19","24","0","0","19","24","4.8333333333333"
"12","2017","31","","10","18","6","14","0","0","6","14","1"
"12","2017","31","Otros","16","27","2","2","0","0","2","2","13.818181818182"
"12","2017","31","Hotel","2","29","9","27","38","92","47","119","1"
"12","2017","31","Otros","14","27","34","168","0","0","34","168","11.833333333333"
"12","2017","31","Otros","11","32","78","103","0","0","78","103","2.2857142857143"
"12","2017","31","Otros","16","19","184","284","12","24","196","308","1"
"12","2017","31","Otros","16","27","34","45","0","0","34","45","13.818181818182"
"12","2017","31","Otros","8","3","5","12","25","175","30","187","10"
"12","2017","31","Otros","16","27","89","162","0","0","89","162","13.818181818182"
"12","2017","31","Otros","16","20","81","190","2","4","83","194","3.0769230769231"
"12","2017","31","Otros","16","40","96","205","26","55","122","260","28.142857142857"
"12","2017","31","Hotel","11","36","72","118","21","30","93","148","2.375"
"12","2017","31","Otros","6","10","89","110","0","0","89","110","3.8518518518518"
"12","2017","31","Otros","7","38","167","463","21","65","188","528","2.75"
"12","2017","31","Otros","13","14","10","17","0","0","10","17","7.3846153846154"
"12","2017","31","Otros","9","30","10","11","0","0","10","11","2.3333333333333"
"12","2017","31","Otros","13","27","50","398","0","0","50","398","12.2"
"12","2017","31","Otros","10","27","24","28","38","38","62","66","4.84"
"12","2017","31","Otros","6","25","43","45","38","54","81","99","2.3846153846154"
"12","2017","31","Otros","9","26","16","169","0","0","16","169","3.8888888888889"
"12","2017","31","Otros","10","18","13","45","43","108","56","153","10.25"
"12","2017","31","Otros","2","29","38","111","0","0","38","111","3.28"
"12","2017","31","Otros","6","25","13","38","0","0","13","38","2.3846153846154"
"12","2017","31","Otros","5","9","4","4","12","12","16","16","4.0454545454545"
"12","2017","31","Otros","5","9","4","10","6","24","10","34","4.0454545454545"
"12","2017","31","Hotel","9","37","40","117","5","6","45","123","3.4"
"12","2017","31","Hotel","7","38","167","379","26","52","193","431","1"
"12","2017","31","Otros","7","27","45","70","0","0","45","70","4.8333333333333"
"12","2017","31","Otros","5","9","9","9","5","7","14","16","4.0454545454545"
"12","2017","31","Otros","10","27","9","9","3","3","12","12","4.84"
"12","2017","31","Otros","7","27","13","13","0","0","13","13","4.8333333333333"
"12","2017","31","Otros","16","40","19","37","36","92","55","129","28.142857142857"
"12","2017","31","Otros","10","23","18","18","4","4","22","22","7"
"12","2017","31","Otros","15","16","75","403","9","54","84","457","9"
"12","2017","15","Otros","3","7","2","4","51","109","53","113","2"
"12","2017","31","Otros","7","17","55","136","5","20","60","156","17.166666666667"
"12","2017","31","Otros","8","27","18","133","5","20","23","153","9.4"
"12","2017","31","Otros","9","22","20","60","0","0","20","60","7.6428571428571"
"12","2017","31","Otros","16","19","20","30","0","0","20","30","10.263157894737"
"12","2017","0","","15","27","0","0","0","0","0","0","1"
"12","2017","31","Hotel","10","11","33","33","10","10","43","43","5.6666666666667"
"12","2017","31","Otros","2","27","6","6","6","6","12","12","3.2"
"12","2017","31","Otros","8","2","21","23","50","73","71","96","6.4285714285714"
"12","2017","31","Otros","5","5","9","19","0","0","9","19","3.65625"
"12","2017","31","Otros","12","35","4","4","26","26","30","30","3.5"
"12","2017","31","Otros","8","3","4","10","26","86","30","96","10"
"12","2017","31","Otros","12","24","3","3","216","359","219","362","9.2"
"12","2017","31","Otros","11","32","29","65","7","15","36","80","2.2857142857143"
"12","2017","31","Otros","10","27","12","18","93","147","105","165","4.84"
"12","2017","30","Otros","11","15","34","59","0","0","34","59","2.3571428571429"
"12","2017","31","Otros","5","8","11","23","25","40","36","63","5"
"12","2017","31","Otros","14","27","15","15","4","4","19","19","11.833333333333"
"12","2017","31","Otros","13","27","362","612","0","0","362","612","12.2"
"12","2017","31","Hotel","10","18","49","50","128","128","177","178","3.2"
"12","2017","31","Otros","10","27","15","15","20","20","35","35","4.84"
"12","2017","31","Otros","11","32","37","49","0","0","37","49","1"
"12","2017","31","Otros","9","37","21","90","0","0","21","90","4.5"
"12","2017","31","Otros","12","35","36","72","292","409","328","481","3.5"
"12","2017","27","Otros","8","34","89","152","53","67","142","219","5.75"
"12","2017","31","Hotel","16","40","15","19","79","153","94","172","16.333333333333"
"12","2017","31","Hotel","10","11","15","80","7","13","22","93","5.6666666666667"
"12","2017","31","Otros","7","27","8","22","0","0","8","22","4.8333333333333"
"12","2017","31","Hotel","7","38","1","1","6","9","7","10","1"
"12","2017","31","Otros","6","27","19","45","0","0","19","45","3.960088691796"
"12","2017","31","Otros","6","10","47","85","0","0","47","85","3.8518518518518"
"12","2017","31","Otros","6","25","181","513","0","0","181","513","1"
"12","2017","31","Otros","6","25","4","7","3","3","7","10","2.3846153846154"
"12","2017","31","Otros","6","27","12","105","3","6","15","111","3.960088691796"
"12","2017","31","Otros","6","27","99","247","0","0","99","247","3.960088691796"
"12","2017","31","Otros","5","5","18","29","21","39","39","68","3.65625"
"12","2017","31","Otros","5","5","6","12","0","0","6","12","3.65625"
"12","2017","31","Otros","3","4","34","40","16","27","50","67","12.2"
"12","2017","31","Otros","10","23","6","6","0","0","6","6","7"
"12","2017","31","Otros","8","3","28","112","0","0","28","112","10"
"12","2017","31","Otros","5","5","15","31","12","20","27","51","3.65625"
"12","2017","31","Otros","5","8","40","47","5","8","45","55","5"
"12","2017","31","Otros","6","10","80","128","3","9","83","137","3.8518518518518"
"12","2017","31","Otros","16","19","36","77","0","0","36","77","10.263157894737"
"12","2017","31","Otros","11","15","25","59","0","0","25","59","2.3571428571429"
"12","2017","31","Otros","7","38","45","55","0","0","45","55","2.75"
"12","2017","31","Otros","11","32","90","201","23","31","113","232","2.2857142857143"
"12","2017","31","Otros","8","2","31","44","0","0","31","44","6.4285714285714"
"12","2017","31","Otros","10","27","23","44","12","17","35","61","4.84"
"12","2017","31","Otros","6","27","21","36","0","0","21","36","3.960088691796"
"12","2017","31","Otros","11","32","37","52","10","10","47","62","2.2857142857143"
"12","2017","31","Otros","8","34","19","19","26","34","45","53","5.75"
"12","2017","31","Otros","11","32","4","7","0","0","4","7","2.2857142857143"
"12","2017","31","Otros","10","11","11","20","0","0","11","20","11.764705882353"
"12","2017","31","Otros","11","32","3","8","1","2","4","10","2.2857142857143"
"12","2017","31","Otros","14","31","0","0","19","23","19","23","20.2"
"12","2017","31","Hotel","14","31","172","320","660","2418","832","2738","17.4"
"12","2017","31","Otros","11","36","179","365","10","14","189","379","5.1904761904762"
"12","2017","31","Hotel","15","16","1074","2325","221","476","1295","2801","2"
"12","2017","31","Otros","15","27","17","21","0","0","17","21","1.4222222222222"
"12","2017","31","Otros","5","5","13","25","20","31","33","56","3.65625"
"12","2017","31","Otros","8","34","9","9","6","6","15","15","5.75"
"12","2017","31","Otros","7","27","33","50","6","6","39","56","4.8333333333333"
"12","2017","31","Otros","12","35","11","14","33","52","44","66","3.5"
"12","2017","31","Otros","5","5","46","110","0","0","46","110","3.65625"
"12","2017","31","Otros","10","11","0","0","1","10","1","10","11.764705882353"
"12","2017","31","Otros","10","11","1","1","0","0","1","1","11.764705882353"
"12","2017","31","Otros","9","30","8","186","0","0","8","186","2.3333333333333"
"12","2017","31","Otros","8","2","15","27","0","0","15","27","6.4285714285714"
"12","2017","31","Otros","10","27","47","75","58","67","105","142","4.84"
"12","2017","31","Otros","5","9","19","19","4","4","23","23","4.0454545454545"
"12","2017","31","Otros","6","27","16","16","0","0","16","16","3.960088691796"
"12","2017","31","Otros","6","10","87","156","6","14","93","170","3.8518518518518"
"12","2017","31","Otros","6","10","61","91","0","0","61","91","3.8518518518518"
"12","2017","31","Otros","6","27","35","49","0","0","35","49","3.960088691796"
"12","2017","31","Otros","6","12","10","84","0","0","10","84","1.8256578947368"
"12","2017","31","Otros","6","10","110","280","0","0","110","280","3.8518518518518"
"12","2017","10","Otros","6","10","22","25","0","0","22","25","3.8518518518518"
"12","2017","31","Otros","6","27","9","9","0","0","9","9","3.960088691796"
"12","2017","31","Otros","6","12","78","90","0","0","78","90","1.8256578947368"
"12","2017","31","Otros","6","10","10","10","0","0","10","10","3.8518518518518"
"12","2017","31","Hotel","6","25","74","167","0","0","74","167","1"
"12","2017","7","Otros","6","27","7","7","0","0","7","7","3.960088691796"
"12","2017","31","Otros","5","9","39","82","20","31","59","113","4.0454545454545"
"12","2017","31","Otros","5","5","71","123","33","54","104","177","3.65625"
"12","2017","31","Otros","5","5","16","41","0","0","16","41","3.65625"
"12","2017","31","Otros","5","5","61","100","22","42","83","142","3.65625"
"12","2017","31","Otros","11","36","58","142","5","49","63","191","5.1904761904762"
"12","2017","31","Hotel","6","10","396","886","19","33","415","919","1"
"12","2017","31","Otros","5","9","12","22","2","8","14","30","4.0454545454545"
"12","2017","31","Otros","5","8","14","40","36","51","50","91","5"
"12","2017","0","Hotel","15","27","0","0","0","0","0","0","1"
"12","2017","31","Hotel","3","4","367","2237","12","40","379","2277","3"
"12","2017","31","Otros","3","7","10","10","18","18","28","28","1"
"12","2017","31","Otros","7","38","104","235","10","14","114","249","2.75"
"12","2017","31","Hotel","10","27","78","98","73","91","151","189","1"
"12","2017","31","Hotel","12","35","16","16","275","559","291","575","1.7272727272727"
"12","2017","31","Hotel","10","27","18","18","0","0","18","18","2.25"
"12","2017","31","Hotel","7","17","527","858","98","221","625","1079","4"
"12","2017","11","Hotel","16","19","8","12","6","22","14","34","4"
"12","2017","31","Hotel","2","6","254","588","0","0","254","588","2.2"
"12","2017","31","Otros","5","5","70","342","27","110","97","452","3.65625"
"12","2017","29","Otros","12","24","29","34","96","100","125","134","9.2"
"12","2017","31","Otros","5","8","22","22","14","14","36","36","5"
"12","2017","31","Otros","4","13","169","202","3","3","172","205","1"
"12","2017","31","Otros","10","11","81","81","0","0","81","81","11.764705882353"
"12","2017","31","Otros","12","35","141","169","299","404","440","573","3.5"
"12","2017","31","Otros","10","23","110","113","6","22","116","135","7"
"12","2017","31","Otros","11","36","539","811","114","193","653","1004","5.1904761904762"
"12","2017","31","Otros","12","35","39","55","224","335","263","390","3.5"
"12","2017","31","Otros","11","36","29","54","4","4","33","58","5.1904761904762"
"12","2017","31","Otros","8","2","26","67","7","14","33","81","6.4285714285714"
"12","2017","31","Otros","9","30","22","44","0","0","22","44","2.3333333333333"
"12","2017","31","Otros","11","36","115","236","20","50","135","286","5.1904761904762"
"12","2017","31","Otros","6","10","23","29","0","0","23","29","3.8518518518518"
"12","2017","31","Otros","10","18","13","27","2","6","15","33","10.25"
"12","2017","31","Otros","7","27","8","68","0","0","8","68","4.8333333333333"
"12","2017","31","Otros","16","20","66","184","0","0","66","184","1"
"12","2017","31","Otros","9","22","30","40","0","0","30","40","7.6428571428571"
"12","2017","31","Otros","5","5","137","190","15","30","152","220","3.65625"
"12","2017","31","Otros","12","35","28","33","81","96","109","129","3.5"
"12","2017","31","Otros","10","11","0","0","20","34","20","34","11.764705882353"
"12","2017","31","Otros","10","11","11","11","0","0","11","11","11.764705882353"
"12","2017","24","Otros","5","9","33","64","9","13","42","77","4.0454545454545"
"12","2017","31","Otros","5","5","10","250","0","0","10","250","3.65625"
"12","2017","31","Otros","12","35","6","12","51","70","57","82","3.5"
"12","2017","22","Otros","7","38","79","143","4","8","83","151","2.75"
"12","2017","31","Hotel","12","35","25","25","304","499","329","524","1.7272727272727"
"12","2017","31","Otros","13","14","44","81","0","0","44","81","1"
"12","2017","31","Otros","5","5","22","41","12","27","34","68","3.65625"
"12","2017","31","Hotel","9","26","5","11","0","0","5","11","1.5"
"12","2017","31","Hotel","16","19","23","44","0","0","23","44","1"
"12","2017","31","Otros","16","19","84","183","0","0","84","183","10.263157894737"
"12","2017","31","Otros","9","30","25","60","1","1","26","61","2.3333333333333"
"12","2017","31","Otros","16","19","13","19","0","0","13","19","10.263157894737"
"12","2017","31","Otros","16","19","118","272","0","0","118","272","10.263157894737"
"12","2017","31","Otros","9","26","8","34","0","0","8","34","3.8888888888889"
"12","2017","31","Otros","16","40","0","0","2","3","2","3","28.142857142857"
"12","2017","31","Hotel","16","27","14","18","0","0","14","18","5.8571428571429"
"12","2017","31","Otros","16","19","28","60","0","0","28","60","10.263157894737"
"12","2017","31","Otros","16","19","43","69","0","0","43","69","10.263157894737"
"12","2017","29","","9","30","159","327","16","36","175","363","1"
"12","2017","31","Otros","16","19","32","64","0","0","32","64","10.263157894737"
"12","2017","31","Otros","10","11","1","2","0","0","1","2","11.764705882353"
"12","2017","31","Otros","11","36","18","18","0","0","18","18","5.1904761904762"
"12","2017","31","Otros","16","19","10","46","0","0","10","46","10.263157894737"
"12","2017","31","Otros","16","19","58","82","0","0","58","82","1.3333333333333"
"12","2017","31","Otros","16","19","31","53","0","0","31","53","10.263157894737"
"12","2017","31","Otros","10","18","27","55","52","102","79","157","10.25"
"12","2017","31","Otros","16","19","56","134","0","0","56","134","10.263157894737"
"12","2017","31","Otros","16","19","6","9","0","0","6","9","1.3333333333333"
"12","2017","31","","9","26","299","1311","0","0","299","1311","1"
"12","2017","31","Otros","16","19","15","20","0","0","15","20","10.263157894737"
"12","2017","31","Otros","16","19","44","46","11","23","55","69","10.263157894737"
"12","2017","31","Hotel","8","2","347","627","44","66","391","693","1"
"12","2017","31","Otros","6","10","41","76","0","0","41","76","3.8518518518518"
"12","2017","31","Otros","6","12","157","202","0","0","157","202","1.8256578947368"
"12","2017","31","Hotel","16","19","35","62","43","67","78","129","1"
"12","2017","31","Otros","3","7","16","16","58","58","74","74","2"
"12","2017","31","Hotel","2","6","701","2058","198","1037","899","3095","1"
"12","2017","31","Hotel","3","4","171","241","21","35","192","276","2.6"
"12","2017","31","Hotel","16","40","2092","3268","1684","2823","3776","6091","1"
"12","2017","31","Otros","16","27","163","212","18","18","181","230","13.818181818182"
"12","2017","31","Hotel","6","28","179","252","43","80","222","332","2.4"
"12","2017","31","Hotel","8","34","1682","2103","322","553","2004","2656","1"
"12","2017","31","Otros","9","30","8","8","0","0","8","8","2.3333333333333"
"12","2017","31","Hotel","10","18","127","127","147","147","274","274","1"
"12","2017","31","Hotel","9","30","140","380","2","6","142","386","1"
"12","2017","31","Hotel","15","27","30","45","0","0","30","45","1"
"12","2017","31","Hotel","9","22","82","442","0","0","82","442","2.5555555555556"
"12","2017","31","","11","15","128","218","0","0","128","218","1"
"12","2017","31","Otros","6","12","16","16","0","0","16","16","1.8256578947368"
"12","2017","31","Hotel","15","27","30","930","0","0","30","930","1"
"12","2017","31","Otros","15","27","74","120","0","0","74","120","1.4222222222222"
"12","2017","31","Otros","15","27","7","217","0","0","7","217","1.4222222222222"
"12","2017","31","Otros","2","1","16","16","10","10","26","26","1"
"12","2017","31","Otros","12","24","10","12","3","3","13","15","9.2"
"12","2017","31","Otros","5","5","9","22","24","35","33","57","3.65625"
"12","2017","31","Hotel","7","27","148","215","26","34","174","249","1"
"12","2017","31","Otros","16","20","184","313","0","0","184","313","3.0769230769231"
"12","2017","0","","10","11","0","0","0","0","0","0","1"
"12","2017","31","Hotel","16","40","32","46","28","89","60","135","16.333333333333"
"12","2017","31","Otros","12","35","8","10","0","0","8","10","3.5"
"12","2017","31","Hotel","6","27","34","46","2","2","36","48","3"
"12","2017","31","Otros","5","5","17","32","15","28","32","60","3.65625"
"12","2017","31","Hotel","6","27","55","55","0","0","55","55","3"
"12","2017","31","Otros","6","25","32","41","0","0","32","41","2.3846153846154"
"12","2017","0","Hotel","15","27","0","0","0","0","0","0","1"
"12","2017","31","Otros","5","9","29","38","75","81","104","119","4.0454545454545"
"12","2017","31","Hotel","15","27","112","112","0","0","112","112","1"
"12","2017","31","Hotel","5","9","11","51","0","0","11","51","1"
"12","2017","31","Hotel","8","34","57","95","61","133","118","228","2.5714285714286"
"12","2017","0","Hotel","15","27","0","0","0","0","0","0","1"
"12","2017","31","Hotel","6","27","252","469","0","0","252","469","3"
"12","2017","31","Otros","6","27","42","124","0","0","42","124","1"
"12","2017","31","Otros","12","27","2","5","17","31","19","36","3.4285714285714"
"12","2017","31","Hotel","2","27","377","393","407","445","784","838","1"
"12","2017","31","Hotel","2","6","192","192","0","0","192","192","1"
"12","2017","31","Otros","2","6","33","64","0","0","33","64","1"
"12","2017","31","Hotel","4","39","106","106","0","0","106","106","1"
"12","2017","31","Hotel","6","10","207","259","9","9","216","268","1"
"12","2017","31","Otros","5","8","18","55","25","41","43","96","5"
"12","2017","0","Hotel","13","33","0","0","0","0","0","0","1"
"12","2017","31","Hotel","13","33","103","206","24","48","127","254","1"
"12","2017","31","Otros","11","32","178","341","68","111","246","452","2.2857142857143"
"12","2017","31","Hotel","9","26","322","531","192","252","514","783","1"
"12","2017","31","Hotel","16","20","105","143","14","25","119","168","1"
"12","2017","31","Otros","16","20","9","9","11","11","20","20","3.0769230769231"
"12","2017","31","","16","40","234","455","28","125","262","580","1"
"12","2017","31","Hotel","15","16","1547","3092","291","868","1838","3960","1"
"12","2017","31","Hotel","5","9","14","18","97","130","111","148","1"
"12","2017","31","Otros","7","38","59","177","2","2","61","179","2.75"
"12","2017","31","Otros","2","6","2345","2345","0","0","2345","2345","1"
"12","2017","31","Otros","2","6","163","331","0","0","163","331","1"
"12","2017","31","Hotel","15","27","336","2215","28","30","364","2245","1"
"12","2017","31","Otros","7","38","65","130","0","0","65","130","2.75"
"12","2017","31","Otros","2","1","8","19","8","22","16","41","1"
"12","2017","31","Otros","8","3","67","136","8","18","75","154","10"
"12","2017","31","Otros","11","36","21","61","0","0","21","61","5.1904761904762"
"12","2017","31","Otros","16","20","46","112","0","0","46","112","3.0769230769231"
"12","2017","31","Otros","8","3","181","322","0","0","181","322","1"
"12","2017","31","Otros","4","39","34","80","7","22","41","102","2.2222222222222"
"12","2017","31","Otros","5","5","22","53","13","19","35","72","3.65625"
"12","2017","31","Otros","12","27","1","1","32","43","33","44","3.4285714285714"
"12","2017","31","Otros","7","27","38","76","0","0","38","76","1"
"12","2017","31","Hotel","2","6","182","1067","20","36","202","1103","1"
"12","2017","31","Hotel","14","27","149","720","65","90","214","810","1"
"12","2017","31","Hotel","16","19","562","1004","0","0","562","1004","1"
"12","2017","31","","2","1","13","182","0","0","13","182","1"
"12","2017","31","Hotel","2","27","63","122","10","12","73","134","1"
"12","2017","31","Otros","16","20","215","323","8","50","223","373","1"
"12","2017","0","Otros","13","14","0","0","0","0","0","0","1"
"12","2017","31","Hotel","11","36","94","146","7","11","101","157","2.375"
"12","2017","31","Otros","13","14","4","120","0","0","4","120","7.3846153846154"
"12","2017","31","Otros","12","27","8","12","0","0","8","12","3.4285714285714"
"12","2017","31","Hotel","2","6","117","196","0","0","117","196","2.2"
"12","2017","31","Otros","2","6","365","1573","0","0","365","1573","1"
"12","2017","31","Otros","10","27","3","24","0","0","3","24","4.84"
"12","2017","31","Otros","12","27","2","2","3","3","5","5","3.4285714285714"
"12","2017","31","Otros","13","14","8","15","0","0","8","15","7.3846153846154"
"12","2017","31","Otros","6","12","99","174","19","29","118","203","1.8256578947368"
"12","2017","31","Otros","2","6","670","993","116","315","786","1308","1"
"12","2017","31","Hotel","12","35","11","21","3","4","14","25","1.7272727272727"
"12","2017","31","Otros","5","5","18","40","29","47","47","87","3.65625"
"12","2017","31","Otros","9","30","6","126","4","120","10","246","2.3333333333333"
"12","2017","31","Hotel","8","2","15","18","3","3","18","21","1"
"12","2017","31","Otros","9","30","15","34","0","0","15","34","2.3333333333333"
"12","2017","31","Hotel","15","27","19","21","0","0","19","21","1"
"12","2017","31","Hotel","3","7","19","19","8","8","27","27","1"
"12","2017","31","Otros","6","12","84","125","0","0","84","125","1.8256578947368"
"12","2017","31","Otros","12","27","23","48","15","17","38","65","3.4285714285714"
"12","2017","16","Otros","2","6","5","50","0","0","5","50","5"
"12","2017","6","Otros","6","27","18","18","0","0","18","18","3.960088691796"
"12","2017","31","Hotel","10","11","60","109","4","12","64","121","1"
"12","2017","31","Otros","2","1","7","56","0","0","7","56","1"
"12","2017","31","Otros","11","36","26","36","12","12","38","48","5.1904761904762"
"12","2017","31","Hotel","11","32","2","12","0","0","2","12","1"
"12","2017","31","Otros","2","27","9","180","0","0","9","180","1"
"12","2017","31","Otros","12","27","5","5","8","10","13","15","3.4285714285714"
"12","2017","31","Hotel","8","2","19","21","2","2","21","23","3"
"12","2017","31","Hotel","16","20","42","42","4","4","46","46","1"
"12","2017","31","Otros","12","35","0","0","90","138","90","138","3.5"
"12","2017","31","Otros","13","14","83","110","0","0","83","110","1"
"12","2017","31","Otros","2","27","24","274","0","0","24","274","3.2"
"12","2017","31","Hotel","6","27","21","21","0","0","21","21","3"
"12","2017","31","Hotel","8","3","48","81","49","96","97","177","4.1111111111111"
"12","2017","0","Hotel","15","27","0","0","0","0","0","0","1"
"12","2017","31","Otros","8","3","28","41","0","0","28","41","10"
"12","2017","31","Hotel","16","20","30","56","0","0","30","56","1"
"12","2017","31","Hotel","6","28","121","185","0","0","121","185","2.4"
"12","2017","31","Otros","2","1","27","51","8","8","35","59","5.5"
"12","2017","31","Hotel","11","36","77","124","152","263","229","387","2.375"
"12","2017","31","Otros","4","13","270","1019","0","0","270","1019","1"
"12","2017","31","Otros","2","6","209","1463","0","0","209","1463","1"
"12","2017","31","Otros","8","34","49","89","39","86","88","175","5.75"
"12","2017","31","Hotel","11","15","12","52","0","0","12","52","1"
"12","2017","31","Otros","15","27","16","32","0","0","16","32","1.4222222222222"
"12","2017","31","Hotel","13","14","106","166","4","4","110","170","1"
"12","2017","31","Hotel","13","14","151","270","33","60","184","330","1"
"12","2017","31","Hotel","9","30","67","133","38","80","105","213","1"
"12","2017","31","Hotel","4","13","177","352","27","30","204","382","5.4"
"12","2017","31","Otros","6","27","20","26","0","0","20","26","3.960088691796"
"12","2017","0","Hotel","15","27","0","0","0","0","0","0","1"
"12","2017","31","Hotel","2","29","8","26","65","238","73","264","2"
"12","2017","31","Hotel","13","33","17","34","2","2","19","36","2"
"12","2017","31","Hotel","12","35","105","212","92","203","197","415","1.7272727272727"
"12","2017","31","Hotel","13","14","202","272","3","3","205","275","1"
"12","2017","31","Otros","6","25","34","66","0","0","34","66","2.3846153846154"
"12","2017","31","Hotel","8","2","12","30","17","92","29","122","3"
"12","2017","31","Otros","4","39","52","122","0","0","52","122","2.2222222222222"
"12","2017","31","Otros","6","12","143","151","24","70","167","221","1.8256578947368"
"12","2017","31","Otros","13","33","43","67","26","50","69","117","5.125"
"12","2017","31","Hotel","4","13","163","363","56","97","219","460","5.4"
"12","2017","31","Hotel","7","27","199","260","0","0","199","260","4.1666666666667"
"12","2017","31","Hotel","4","13","561","1512","55","110","616","1622","1"
"12","2017","31","","5","8","17","17","11","14","28","31","1"
"12","2017","31","Otros","8","2","13","28","6","14","19","42","6.4285714285714"
"12","2017","31","Otros","2","6","0","0","10","10","10","10","1"
"12","2017","31","","6","10","134","238","0","0","134","238","1"
"12","2017","31","Hotel","2","29","62","90","110","154","172","244","2"
"12","2017","31","","14","31","103","154","419","1235","522","1389","1"
"12","2017","31","Hotel","16","27","3674","14698","0","0","3674","14698","1"
"12","2017","31","Hotel","12","35","43","88","88","110","131","198","1.7272727272727"
"12","2017","31","","12","35","942","1039","5148","5626","6090","6665","1"
"12","2017","31","","9","26","122","139","16","17","138","156","1"
"12","2017","31","Otros","11","32","140","230","0","0","140","230","2.2857142857143"
"12","2017","31","Otros","12","24","48","105","116","174","164","279","9.2"
"12","2017","31","Hotel","6","25","35","55","0","0","35","55","1"
"12","2017","31","Otros","11","32","22","33","0","0","22","33","2.2857142857143"
"12","2017","31","Hotel","16","19","64","74","0","0","64","74","4"
"12","2017","31","Otros","13","33","48","54","7","9","55","63","5.125"
"12","2017","31","Otros","16","27","33","110","2","24","35","134","13.818181818182"
"12","2017","31","Otros","6","12","90","95","1","1","91","96","1.8256578947368"
"12","2017","31","Otros","2","29","11","49","11","68","22","117","3.28"
"12","2017","31","Hotel","14","27","398","482","264","328","662","810","1"
"12","2017","31","Otros","2","1","1","1","0","0","1","1","1"
"12","2017","31","Otros","11","32","20","20","5","5","25","25","2.2857142857143"
"12","2017","31","Otros","2","27","67","67","0","0","67","67","1"
"12","2017","31","Hotel","2","29","71","279","58","225","129","504","1"
"12","2017","31","Hotel","4","13","31","707","0","0","31","707","3.2"
"12","2017","31","Hotel","4","21","16","36","6","11","22","47","3"
"12","2017","28","Otros","7","27","73","77","3","3","76","80","4.8333333333333"
"12","2017","31","","3","4","66","127","45","88","111","215","1"
"12","2017","27","Hotel","6","27","8","10","9","18","17","28","3"
"12","2017","31","Otros","16","19","10","14","0","0","10","14","10.263157894737"
"12","2017","31","Otros","11","32","1","1","0","0","1","1","2.2857142857143"
"12","2017","31","Otros","3","7","56","78","52","84","108","162","2"
"12","2017","31","Otros","5","5","30","56","13","27","43","83","3.65625"
"12","2017","24","Otros","15","27","1201","1972","0","0","1201","1972","1.4222222222222"
"12","2017","31","Otros","6","25","147","268","3","3","150","271","2.3846153846154"
"12","2017","31","","10","27","34","76","5","6","39","82","1"
"12","2017","31","Otros","2","29","33","70","156","222","189","292","3.28"
"12","2017","31","Otros","12","35","1","2","30","46","31","48","3.5"
"12","2017","31","Otros","16","19","59","133","0","0","59","133","10.263157894737"
"12","2017","31","Otros","9","26","68","88","6","7","74","95","3.8888888888889"
"12","2017","31","Hotel","13","33","61","68","7","7","68","75","2"
"12","2017","31","Otros","11","32","27","54","18","27","45","81","2.2857142857143"
"12","2017","31","Otros","9","22","28","36","0","0","28","36","7.6428571428571"
"12","2017","31","Otros","6","27","7","69","0","0","7","69","3.960088691796"
"12","2017","30","Otros","15","27","4","4","0","0","4","4","1.4222222222222"
"12","2017","31","Otros","11","32","96","106","20","29","116","135","2.2857142857143"
"12","2017","31","Otros","11","15","21","22","0","0","21","22","2.3571428571429"
"12","2017","31","Otros","9","37","10","22","0","0","10","22","4.5"
"12","2017","31","Otros","5","9","12","15","12","25","24","40","4.0454545454545"
"12","2017","31","Hotel","10","27","11","145","0","0","11","145","2.25"
"12","2017","31","Otros","6","28","17","70","1","1","18","71","4.65"
"12","2017","31","Otros","4","13","34","44","24","29","58","73","3.4"
"12","2017","31","Otros","2","1","1","1","0","0","1","1","1"
"12","2017","31","Otros","2","29","34","83","79","141","113","224","3.28"
"12","2017","15","Hotel","8","3","21","59","0","0","21","59","4.1111111111111"
"12","2017","31","Otros","16","19","182","590","0","0","182","590","1.3333333333333"
"12","2017","31","Otros","12","35","5","5","94","113","99","118","3.5"
"12","2017","31","Hotel","12","35","23","52","196","250","219","302","1.7272727272727"
"12","2017","31","Otros","12","35","6","8","37","71","43","79","3.5"
"12","2017","31","Otros","2","29","67","130","94","168","161","298","3.28"
"12","2017","31","Hotel","7","27","90","189","20","20","110","209","1"
"12","2017","31","Hotel","9","22","36","55","3","6","39","61","2.5555555555556"
"12","2017","31","Hotel","12","35","62","97","199","264","261","361","1.7272727272727"
"12","2017","31","Otros","15","16","77","146","21","45","98","191","2"
"12","2017","31","Hotel","15","27","9","18","5","10","14","28","1"
"12","2017","31","Otros","4","13","99","139","31","56","130","195","3.4"
"12","2017","31","Hotel","8","34","81","155","57","82","138","237","2.5714285714286"
"12","2017","31","Hotel","16","20","200","400","0","0","200","400","1"
"12","2017","31","Hotel","6","28","190","225","59","89","249","314","2.4"
"12","2017","31","Hotel","15","27","76","270","25","25","101","295","1"
"12","2017","31","Otros","12","35","67","174","106","230","173","404","3.5"
"12","2017","31","Otros","11","15","29","49","6","10","35","59","2.3571428571429"
"12","2017","31","Otros","11","15","47","80","11","30","58","110","2.3571428571429"
"12","2017","31","Otros","11","36","56","94","73","132","129","226","5.1904761904762"
"12","2017","31","Hotel","11","36","57","143","8","20","65","163","2.375"
"12","2017","31","Hotel","6","12","118","239","0","0","118","239","5"
"12","2017","31","Otros","8","3","34","57","63","98","97","155","10"
"12","2017","31","Otros","10","27","10","20","13","21","23","41","4.84"
"12","2017","31","Otros","8","3","11","11","24","110","35","121","10"
"12","2017","31","Otros","6","25","44","50","0","0","44","50","2.3846153846154"
"12","2017","31","Hotel","2","27","40","98","0","0","40","98","1"
"12","2017","31","Hotel","10","18","140","333","80","240","220","573","3.2"
"12","2017","31","Otros","11","32","95","249","11","21","106","270","1"
"12","2017","31","Hotel","6","10","1850","2563","292","431","2142","2994","1"
"12","2017","31","Otros","11","32","29","68","5","10","34","78","2.2857142857143"
"12","2017","0","Otros","2","27","0","0","0","0","0","0","1"
"12","2017","31","","12","24","131","262","492","1184","623","1446","1"
"12","2017","31","Hotel","16","27","638","799","0","0","638","799","5.8571428571429"
"12","2017","31","Hotel","7","38","39","240","0","0","39","240","1"
"12","2017","31","Hotel","6","12","2335","2523","63","73","2398","2596","1"
"1","2018","31","Hotel","14","31","2566","4177","7881","10651","10447","14828","1"
"1","2018","31","Hotel","14","31","1374","1766","3319","8600","4693","10366","1"
"1","2018","31","Hotel","14","31","867","1018","1293","3896","2160","4914","1"
"1","2018","31","Hotel","11","32","98","170","58","109","156","279","1"
"1","2018","31","Hotel","14","27","4236","5747","867","1175","5103","6922","1"
"1","2018","31","Otros","11","32","178","289","0","0","178","289","2.2857142857143"
"1","2018","31","Hotel","14","31","457","542","3368","4989","3825","5531","5.4"
"1","2018","31","Hotel","15","16","1923","4059","521","1413","2444","5472","1"
"1","2018","31","Hotel","14","31","1015","1722","1172","3480","2187","5202","5.4"
"1","2018","31","Hotel","12","24","3004","4553","3999","5952","7003","10505","1"
"1","2018","31","Hotel","16","40","1307","2342","711","1819","2018","4161","1"
"1","2018","31","Hotel","6","12","1317","1935","127","253","1444","2188","1"
"1","2018","31","Hotel","10","23","2393","3063","804","1201","3197","4264","1"
"1","2018","31","Hotel","14","31","1649","4168","339","853","1988","5021","5.4"
"1","2018","31","Hotel","3","4","756","1878","409","1052","1165","2930","1"
"1","2018","31","","11","32","757","1113","174","277","931","1390","1"
"1","2018","31","Hotel","6","12","1057","1562","121","375","1178","1937","1"
"1","2018","31","Hotel","6","12","2307","3208","381","508","2688","3716","1"
"1","2018","31","Hotel","9","26","4016","7894","221","286","4237","8180","1"
"1","2018","31","Hotel","2","1","457","1699","62","535","519","2234","1"
"1","2018","31","Hotel","9","26","1213","1785","254","710","1467","2495","1"
"1","2018","31","Hotel","6","12","600","920","89","246","689","1166","1"
"1","2018","31","Hotel","14","31","66","81","4578","8333","4644","8414","5.4"
"1","2018","31","Hotel","11","32","356","639","106","167","462","806","1"
"1","2018","31","Hotel","2","6","1165","1664","242","314","1407","1978","1"
"1","2018","31","Hotel","16","40","1566","3089","2179","4460","3745","7549","1"
"1","2018","31","Hotel","14","27","938","1867","715","1058","1653","2925","1"
"1","2018","31","Otros","11","36","236","934","0","0","236","934","1"
"1","2018","31","Hotel","10","23","1087","2885","938","1885","2025","4770","1"
"1","2018","31","Hotel","14","31","420","1092","765","3415","1185","4507","7.8"
"1","2018","31","Hotel","7","17","689","1312","395","1155","1084","2467","1"
"1","2018","31","Hotel","2","1","2255","3607","0","0","2255","3607","2"
"1","2018","31","Hotel","2","1","1605","2513","393","942","1998","3455","2"
"1","2018","31","Hotel","4","13","866","1358","158","215","1024","1573","1"
"1","2018","31","Hotel","2","1","890","1720","78","277","968","1997","2"
"1","2018","31","Hotel","10","27","1152","4386","705","1816","1857","6202","1"
"1","2018","31","Hotel","14","27","578","699","2399","2704","2977","3403","1"
"1","2018","31","Hotel","14","27","1679","2325","1357","2616","3036","4941","1"
"1","2018","31","Hotel","6","12","1898","1918","102","189","2000","2107","1"
"1","2018","31","Hotel","6","12","1438","2149","621","833","2059","2982","1"
"1","2018","31","Hotel","13","27","2137","5253","91","481","2228","5734","1"
"1","2018","31","Hotel","14","31","45","101","972","2652","1017","2753","7.8"
"1","2018","31","Hotel","6","12","1640","5013","336","1028","1976","6041","1"
"1","2018","31","Hotel","16","27","2792","5347","217","435","3009","5782","1"
"1","2018","31","","10","27","311","547","104","161","415","708","1"
"1","2018","31","Hotel","10","18","652","1430","968","2435","1620","3865","1"
"1","2018","31","Hotel","9","37","1496","2490","457","839","1953","3329","1"
"1","2018","31","Hotel","16","27","2268","9077","0","0","2268","9077","1"
"1","2018","31","Hotel","15","16","1209","1758","393","968","1602","2726","2"
"1","2018","31","Hotel","2","1","1602","2684","329","549","1931","3233","2"
"1","2018","31","Hotel","3","4","567","1809","311","516","878","2325","1"
"1","2018","31","Hotel","16","40","1113","1618","1938","3570","3051","5188","1"
"1","2018","31","Hotel","7","17","4881","5370","1133","1359","6014","6729","1"
"1","2018","31","Hotel","12","24","1073","1538","3029","3994","4102","5532","1"
"1","2018","31","Hotel","12","35","1037","2113","2242","3872","3279","5985","1"
"1","2018","31","Hotel","2","6","364","916","111","139","475","1055","1"
"1","2018","31","Hotel","13","33","1225","1728","212","332","1437","2060","1"
"1","2018","31","Hotel","10","27","1292","2055","804","1227","2096","3282","1"
"1","2018","31","Hotel","10","23","1643","2927","323","576","1966","3503","1"
"1","2018","31","Hotel","11","36","1503","3135","639","951","2142","4086","1"
"1","2018","31","Hotel","8","34","997","2197","300","351","1297","2548","1"
"1","2018","31","Hotel","2","6","469","1247","201","349","670","1596","1"
"1","2018","31","Hotel","14","31","775","1127","1128","1757","1903","2884","7.8"
"1","2018","31","Hotel","11","36","2167","3754","410","775","2577","4529","1"
"1","2018","31","","10","27","128","219","166","286","294","505","1"
"1","2018","31","Hotel","14","31","2366","3705","2512","7440","4878","11145","5.4"
"1","2018","31","Hotel","4","13","3086","3100","4","8","3090","3108","1"
"1","2018","31","Hotel","6","28","1684","2120","97","108","1781","2228","1"
"1","2018","31","Otros","14","31","171","244","231","428","402","672","2.8"
"1","2018","31","Otros","16","27","60","120","0","0","60","120","2"
"1","2018","31","Hotel","2","1","871","1541","72","115","943","1656","2"
"1","2018","31","Hotel","10","18","2184","2509","2093","2355","4277","4864","1"
"1","2018","31","Hotel","7","17","1054","1976","478","1098","1532","3074","1"
"1","2018","31","Hotel","12","24","433","1230","1071","2917","1504","4147","1"
"1","2018","31","Hotel","10","18","1534","2808","957","1976","2491","4784","1"
"1","2018","31","Hotel","2","1","2992","3620","59","136","3051","3756","1"
"1","2018","31","Hotel","10","18","1435","2219","1919","3575","3354","5794","1"
"1","2018","31","Hotel","6","28","1816","2809","577","816","2393","3625","1"
"1","2018","31","Hotel","5","5","1018","1841","927","1087","1945","2928","1"
"1","2018","31","Hotel","4","13","324","806","64","81","388","887","1"
"1","2018","31","Hotel","10","18","1277","2174","1862","2765","3139","4939","1"
"1","2018","31","Hotel","16","40","1585","2765","501","893","2086","3658","1"
"1","2018","31","Hotel","8","3","3200","7817","638","1361","3838","9178","1"
"1","2018","31","Hotel","15","16","656","1123","328","913","984","2036","2"
"1","2018","31","Hotel","14","31","68","182","429","1609","497","1791","7.8"
"1","2018","31","Hotel","13","33","686","867","315","384","1001","1251","1"
"1","2018","31","Hotel","15","16","606","1082","264","678","870","1760","2"
"1","2018","31","Otros","4","21","790","1465","67","238","857","1703","1"
"1","2018","31","Hotel","6","10","1115","1987","13","42","1128","2029","1"
"1","2018","31","Hotel","16","19","588","1283","78","269","666","1552","1"
"1","2018","31","Hotel","16","27","1104","2393","7","16","1111","2409","1"
"1","2018","31","Hotel","10","11","1499","3075","287","520","1786","3595","1"
"1","2018","31","Otros","10","23","571","1555","37","142","608","1697","1"
"1","2018","31","Hotel","12","35","120","310","697","1882","817","2192","1"
"1","2018","31","Hotel","11","36","883","1690","299","536","1182","2226","1"
"1","2018","31","Hotel","14","31","25","44","312","1718","337","1762","17.4"
"1","2018","31","Hotel","10","18","533","1206","886","2182","1419","3388","3.2"
"1","2018","31","Hotel","4","13","259","451","117","158","376","609","1"
"1","2018","31","Hotel","6","12","449","707","198","355","647","1062","5"
"1","2018","31","Hotel","6","10","779","1081","151","295","930","1376","1"
"1","2018","31","Otros","5","5","341","584","226","450","567","1034","3.65625"
"1","2018","31","Hotel","12","24","978","1272","1641","1836","2619","3108","1"
"1","2018","31","Hotel","8","3","1341","2958","393","726","1734","3684","1"
"1","2018","31","Hotel","13","27","738","1328","0","0","738","1328","2.75"
"1","2018","31","Hotel","15","16","365","1600","30","62","395","1662","4"
"1","2018","31","Otros","15","16","316","1443","147","612","463","2055","2"
"1","2018","31","Otros","16","20","839","1859","74","202","913","2061","1"
"1","2018","31","Hotel","3","4","1365","3445","300","350","1665","3795","1"
"1","2018","31","Hotel","11","36","145","172","0","0","145","172","1"
"1","2018","31","Hotel","2","6","221","1015","100","323","321","1338","1"
"1","2018","31","Hotel","8","34","800","1533","164","314","964","1847","1"
"1","2018","31","Hotel","4","13","25","37","20","38","45","75","3.2"
"1","2018","31","Hotel","13","27","647","2095","0","0","647","2095","2.75"
"1","2018","31","Hotel","2","29","242","562","1044","2704","1286","3266","1"
"1","2018","31","Otros","11","36","155","480","7","11","162","491","1"
"1","2018","31","Otros","7","17","188","466","0","0","188","466","1"
"1","2018","31","","10","11","14","14","2","2","16","16","1"
"1","2018","31","Hotel","4","13","930","1347","81","186","1011","1533","1"
"1","2018","31","Hotel","16","40","2519","3781","1151","1729","3670","5510","5.6666666666667"
"1","2018","31","Hotel","10","23","711","1163","1015","2264","1726","3427","2.8"
"1","2018","31","Hotel","8","34","472","789","309","508","781","1297","1"
"1","2018","31","Hotel","5","5","504","1461","278","802","782","2263","1"
"1","2018","31","Hotel","3","4","137","295","53","109","190","404","3"
"1","2018","31","Hotel","9","26","37","82","13","35","50","117","1"
"1","2018","31","Hotel","8","34","593","819","374","572","967","1391","1"
"1","2018","31","Hotel","7","17","255","569","329","1502","584","2071","4"
"1","2018","31","Hotel","4","13","282","676","36","51","318","727","3.2"
"1","2018","31","Hotel","12","35","7","48","796","2813","803","2861","1"
"1","2018","31","Hotel","16","40","842","1761","3309","7026","4151","8787","1"
"1","2018","31","Hotel","9","26","264","459","166","945","430","1404","1"
"1","2018","31","","6","27","306","562","25","78","331","640","1"
"1","2018","31","Hotel","9","26","182","275","23","39","205","314","1"
"1","2018","31","Hotel","4","13","104","133","44","52","148","185","3.2"
"1","2018","31","Hotel","6","28","1656","1905","4","4","1660","1909","1"
"1","2018","31","","2","29","67","123","679","2080","746","2203","1"
"1","2018","31","Hotel","16","19","35","58","0","0","35","58","1"
"1","2018","31","Hotel","13","33","1261","1561","274","626","1535","2187","1"
"1","2018","31","Hotel","8","3","511","1147","526","1234","1037","2381","1"
"1","2018","31","Hotel","14","27","694","1520","1007","1810","1701","3330","1"
"1","2018","31","Hotel","16","40","516","1035","75","150","591","1185","5.6666666666667"
"1","2018","31","Hotel","12","24","263","459","211","878","474","1337","1"
"1","2018","31","Hotel","10","18","956","1772","460","1197","1416","2969","3.2"
"1","2018","31","Otros","15","16","159","159","7","7","166","166","9"
"1","2018","31","Hotel","6","10","697","762","6","8","703","770","1"
"1","2018","31","Hotel","10","11","674","1233","233","545","907","1778","1"
"1","2018","31","Otros","6","10","182","733","5","5","187","738","3.8518518518518"
"1","2018","31","Otros","10","23","191","957","0","0","191","957","1"
"1","2018","31","Otros","8","2","34","47","0","0","34","47","1"
"1","2018","31","Otros","10","11","49","74","40","58","89","132","1"
"1","2018","31","Hotel","10","23","506","780","679","1393","1185","2173","2.8"
"1","2018","31","Hotel","6","12","447","630","43","89","490","719","5"
"1","2018","31","Hotel","6","27","99","199","7","15","106","214","3"
"1","2018","31","Hotel","10","23","336","809","490","1369","826","2178","2.8"
"1","2018","31","","4","39","121","392","0","0","121","392","1"
"1","2018","31","Hotel","8","34","324","528","697","1048","1021","1576","1"
"1","2018","31","Hotel","8","34","608","874","358","507","966","1381","1"
"1","2018","31","Otros","4","39","18","30","0","0","18","30","2.2222222222222"
"1","2018","31","Otros","13","14","700","1400","0","0","700","1400","1"
"1","2018","31","Hotel","10","23","311","461","153","244","464","705","2.8"
"1","2018","31","Otros","13","14","350","918","0","0","350","918","1"
"1","2018","31","Hotel","12","24","451","638","641","1143","1092","1781","1"
"1","2018","31","","6","25","394","547","0","0","394","547","1"
"1","2018","31","Hotel","15","27","828","1354","26","36","854","1390","1"
"1","2018","31","Hotel","12","35","134","222","963","1638","1097","1860","1"
"1","2018","31","Hotel","16","40","168","220","334","850","502","1070","1"
"1","2018","31","Hotel","16","27","17","19","36","51","53","70","1"
"1","2018","31","Hotel","9","30","128","401","0","0","128","401","1"
"1","2018","31","Hotel","4","13","320","846","90","178","410","1024","3.2"
"1","2018","31","Hotel","2","29","54","154","715","1514","769","1668","1"
"1","2018","31","Hotel","16","20","878","901","531","544","1409","1445","1"
"1","2018","31","Hotel","5","5","754","931","264","320","1018","1251","1"
"1","2018","31","Hotel","13","33","616","974","66","132","682","1106","1"
"1","2018","31","Otros","16","19","237","373","9","31","246","404","1.3333333333333"
"1","2018","31","Hotel","12","24","123","331","362","768","485","1099","1"
"1","2018","31","","8","2","497","1131","94","261","591","1392","1"
"1","2018","31","Hotel","12","35","1","4","264","2116","265","2120","1"
"1","2018","31","Hotel","16","27","21","29","595","632","616","661","2.5"
"1","2018","31","Otros","9","37","48","94","0","0","48","94","2"
"1","2018","31","Otros","16","27","516","1055","22","75","538","1130","2"
"1","2018","31","Hotel","8","34","448","726","293","529","741","1255","1"
"1","2018","31","Otros","8","3","1462","5572","28","114","1490","5686","1"
"1","2018","31","Hotel","7","27","304","454","88","156","392","610","1"
"1","2018","31","Hotel","4","39","292","417","4","8","296","425","1"
"1","2018","31","Hotel","15","16","230","460","66","222","296","682","4"
"1","2018","31","Hotel","4","39","73","89","11","11","84","100","1"
"1","2018","31","Hotel","4","39","217","478","8","8","225","486","1"
"1","2018","28","Hotel","15","16","86","201","137","580","223","781","4"
"1","2018","31","Hotel","14","31","4","5","347","1116","351","1121","17.4"
"1","2018","31","Hotel","8","34","324","606","319","456","643","1062","1"
"1","2018","31","Hotel","6","28","212","293","105","128","317","421","1"
"1","2018","31","Hotel","7","17","677","1433","39","60","716","1493","4"
"1","2018","31","Otros","7","27","5","10","0","0","5","10","1"
"1","2018","31","Hotel","11","36","1577","1807","106","233","1683","2040","1"
"1","2018","31","Otros","7","17","206","506","42","183","248","689","1"
"1","2018","31","Otros","4","21","510","1483","207","578","717","2061","1"
"1","2018","31","Otros","15","16","155","155","65","65","220","220","2"
"1","2018","31","Otros","7","17","339","1063","322","2104","661","3167","3"
"1","2018","31","Hotel","7","38","154","198","0","0","154","198","1"
"1","2018","31","Hotel","16","27","613","659","34","49","647","708","2.5"
"1","2018","31","Hotel","2","6","31","37","17","17","48","54","2.2"
"1","2018","31","Hotel","11","36","478","853","263","496","741","1349","1"
"1","2018","31","Otros","13","14","39","46","0","0","39","46","1"
"1","2018","31","Hotel","6","28","57","78","12","18","69","96","1"
"1","2018","31","Hotel","6","12","68","131","0","0","68","131","5"
"1","2018","31","Otros","9","22","203","617","0","0","203","617","1"
"1","2018","31","","13","14","203","341","7","7","210","348","2"
"1","2018","31","Hotel","2","29","94","233","721","1365","815","1598","1"
"1","2018","31","Hotel","2","29","47","161","222","623","269","784","1"
"1","2018","31","Otros","4","13","465","491","34","34","499","525","1"
"1","2018","31","Hotel","15","16","87","213","38","102","125","315","4"
"1","2018","31","Hotel","2","1","122","296","8","8","130","304","6.4"
"1","2018","31","Otros","7","27","174","328","3","3","177","331","1"
"1","2018","31","Otros","13","33","74","84","0","0","74","84","5.125"
"1","2018","31","","4","21","837","1000","66","106","903","1106","1"
"1","2018","31","Hotel","6","10","259","399","11","11","270","410","1"
"1","2018","31","Hotel","11","36","604","1454","20","60","624","1514","1"
"1","2018","31","Otros","14","31","353","1038","113","417","466","1455","2.8"
"1","2018","31","Hotel","7","27","227","422","12","36","239","458","1"
"1","2018","31","Otros","6","10","78","417","0","0","78","417","3.8518518518518"
"1","2018","31","Hotel","4","39","98","142","32","50","130","192","2.6"
"1","2018","31","Otros","8","2","53","121","47","124","100","245","6.4285714285714"
"1","2018","31","Otros","11","36","69","136","15","43","84","179","5.1904761904762"
"1","2018","31","Hotel","13","33","238","438","16","24","254","462","1"
"1","2018","31","Hotel","10","18","99","99","77","77","176","176","1"
"1","2018","31","Otros","9","37","53","97","0","0","53","97","2"
"1","2018","31","","3","4","149","292","68","114","217","406","1"
"1","2018","31","Hotel","7","17","299","706","127","241","426","947","4"
"1","2018","31","Hotel","8","2","265","452","33","43","298","495","1"
"1","2018","31","Otros","9","37","12","22","0","0","12","22","2"
"1","2018","31","Otros","15","16","178","257","58","95","236","352","2"
"1","2018","30","Hotel","10","11","697","916","20","26","717","942","1"
"1","2018","31","Hotel","16","19","478","515","0","0","478","515","1"
"1","2018","31","Hotel","10","23","147","186","213","278","360","464","4"
"1","2018","31","","7","38","310","550","81","141","391","691","1"
"1","2018","31","Hotel","7","27","252","480","39","168","291","648","1"
"1","2018","31","Hotel","11","36","591","1336","149","371","740","1707","1"
"1","2018","31","Hotel","16","40","193","343","18","34","211","377","16.333333333333"
"1","2018","31","Hotel","16","19","152","345","5","44","157","389","1"
"1","2018","31","Hotel","12","35","117","144","363","442","480","586","1"
"1","2018","31","Hotel","16","19","40","54","0","0","40","54","1"
"1","2018","31","Hotel","16","20","30","41","2","6","32","47","1"
"1","2018","31","Hotel","10","11","331","481","76","96","407","577","1"
"1","2018","31","Otros","7","27","87","165","5","5","92","170","4.8333333333333"
"1","2018","31","Otros","7","27","24","52","0","0","24","52","1"
"1","2018","31","Hotel","7","27","26","30","1","1","27","31","4.1666666666667"
"1","2018","0","Otros","16","19","0","0","0","0","0","0","1"
"1","2018","31","Otros","13","14","647","1462","14","36","661","1498","1"
"1","2018","31","Otros","11","15","218","218","0","0","218","218","2.3571428571429"
"1","2018","31","Otros","10","27","63","63","87","129","150","192","4.84"
"1","2018","31","Otros","14","31","2505","2505","235","235","2740","2740","2.8"
"1","2018","31","Otros","11","36","20","64","2","5","22","69","5.1904761904762"
"1","2018","31","Hotel","16","19","174","219","0","0","174","219","1"
"1","2018","31","","14","27","280","482","20","30","300","512","2.6666666666667"
"1","2018","31","Hotel","16","40","108","118","12","20","120","138","5.6666666666667"
"1","2018","31","Hotel","10","27","16","38","0","0","16","38","2.25"
"1","2018","31","Otros","2","29","221","452","443","1004","664","1456","3.28"
"1","2018","31","Hotel","13","27","12","24","42","75","54","99","1"
"1","2018","31","Otros","9","22","90","113","0","0","90","113","1"
"1","2018","31","Hotel","2","27","210","275","53","67","263","342","1"
"1","2018","31","Hotel","8","34","384","754","143","272","527","1026","1"
"1","2018","31","Hotel","7","27","202","722","21","26","223","748","1"
"1","2018","31","Hotel","15","16","253","729","170","381","423","1110","4"
"1","2018","31","Hotel","16","20","120","192","0","0","120","192","1"
"1","2018","31","Otros","4","13","61","242","0","0","61","242","1"
"1","2018","31","Otros","5","9","333","535","175","223","508","758","1"
"1","2018","31","Hotel","2","1","262","624","1","3","263","627","6.4"
"1","2018","31","Otros","11","32","74","354","0","0","74","354","2.2857142857143"
"1","2018","31","Hotel","2","29","4","13","262","1629","266","1642","1"
"1","2018","31","Hotel","16","27","181","192","72","90","253","282","2.5"
"1","2018","31","Hotel","10","18","245","779","2","2","247","781","3.2"
"1","2018","31","Otros","11","36","503","745","228","274","731","1019","1"
"1","2018","31","Otros","13","14","168","280","11","16","179","296","1"
"1","2018","0","Hotel","7","27","0","0","0","0","0","0","1"
"1","2018","31","Otros","7","17","233","521","0","0","233","521","3"
"1","2018","31","Otros","14","31","450","808","352","647","802","1455","2.8"
"1","2018","31","Hotel","12","35","94","240","322","638","416","878","1"
"1","2018","31","Hotel","2","29","319","1002","297","898","616","1900","1"
"1","2018","31","Hotel","8","3","186","572","166","310","352","882","1"
"1","2018","31","Hotel","8","34","337","439","123","195","460","634","2.5714285714286"
"1","2018","31","Hotel","8","34","246","363","216","561","462","924","2.5714285714286"
"1","2018","31","Hotel","12","35","144","318","688","1368","832","1686","1"
"1","2018","31","Hotel","12","35","94","102","222","315","316","417","1"
"1","2018","31","Hotel","11","32","192","575","57","98","249","673","1"
"1","2018","31","Hotel","13","33","279","420","58","63","337","483","2"
"1","2018","31","Hotel","10","23","269","384","85","131","354","515","2.8"
"1","2018","31","Hotel","12","35","191","416","108","174","299","590","1"
"1","2018","31","","16","40","218","320","146","410","364","730","3.0555555555556"
"1","2018","31","Otros","16","19","102","233","0","0","102","233","1.3333333333333"
"1","2018","31","Otros","16","20","46","184","14","56","60","240","1"
"1","2018","31","Hotel","6","12","113","298","16","37","129","335","5"
"1","2018","31","Hotel","16","19","294","436","0","0","294","436","4"
"1","2018","31","Hotel","12","24","172","365","376","594","548","959","1"
"1","2018","31","Hotel","12","24","155","222","493","608","648","830","3"
"1","2018","31","Hotel","8","3","94","340","0","0","94","340","1"
"1","2018","31","Hotel","5","9","7","13","20","37","27","50","1"
"1","2018","31","Hotel","16","27","259","386","33","75","292","461","2.5"
"1","2018","31","Otros","10","23","59","59","0","0","59","59","7"
"1","2018","31","Otros","13","14","397","879","30","46","427","925","7.3846153846154"
"1","2018","31","Otros","2","6","36","92","9","29","45","121","1"
"1","2018","26","Hotel","15","16","17","19","265","323","282","342","7.8"
"1","2018","31","Hotel","8","3","752","1504","0","0","752","1504","1"
"1","2018","31","Hotel","8","34","337","525","559","1156","896","1681","1"
"1","2018","31","Hotel","8","3","145","411","115","284","260","695","1"
"1","2018","31","","2","29","115","286","121","345","236","631","1"
"1","2018","31","Hotel","2","1","412","556","37","63","449","619","6.4"
"1","2018","31","Hotel","7","17","203","430","9","42","212","472","4"
"1","2018","31","Otros","7","17","176","720","304","1672","480","2392","3"
"1","2018","31","Hotel","16","40","172","814","253","767","425","1581","5.6666666666667"
"1","2018","31","Hotel","12","24","348","521","625","803","973","1324","1"
"1","2018","31","Hotel","14","31","197","460","311","1213","508","1673","17.4"
"1","2018","0","Hotel","9","26","0","0","0","0","0","0","1"
"1","2018","31","Hotel","6","12","31","31","0","0","31","31","5"
"1","2018","31","Otros","5","9","29","49","17","29","46","78","4.0454545454545"
"1","2018","31","Otros","5","9","5","5","4","8","9","13","4.0454545454545"
"1","2018","31","Otros","15","27","199","288","0","0","199","288","1.4222222222222"
"1","2018","31","Hotel","8","34","16","18","10","10","26","28","2.5714285714286"
"1","2018","31","Hotel","10","18","323","854","275","635","598","1489","7.75"
"1","2018","31","Hotel","15","16","289","830","51","92","340","922","7.8"
"1","2018","31","Hotel","2","29","53","146","476","1656","529","1802","1"
"1","2018","31","Hotel","4","39","97","157","4","7","101","164","2.6"
"1","2018","31","Otros","4","39","116","116","3","3","119","119","2.2222222222222"
"1","2018","31","Hotel","4","13","104","200","174","290","278","490","5.4"
"1","2018","31","Otros","10","23","44","77","9","14","53","91","7"
"1","2018","31","Otros","14","31","49","82","446","993","495","1075","20.2"
"1","2018","31","Hotel","3","4","290","791","115","190","405","981","2.6"
"1","2018","31","Hotel","10","23","159","292","168","286","327","578","4"
"1","2018","31","Otros","9","22","484","1391","12","24","496","1415","1"
"1","2018","31","Hotel","12","24","180","384","536","765","716","1149","3"
"1","2018","31","Hotel","13","14","72","110","0","0","72","110","1"
"1","2018","31","Hotel","12","35","196","321","334","503","530","824","1.7272727272727"
"1","2018","31","Hotel","6","28","340","545","0","0","340","545","1"
"1","2018","31","","6","28","64","95","0","0","64","95","1"
"1","2018","31","Hotel","12","24","293","659","216","622","509","1281","3"
"1","2018","31","Otros","5","9","33","49","17","27","50","76","4.0454545454545"
"1","2018","31","Hotel","16","20","128","200","4","11","132","211","1"
"1","2018","31","Hotel","4","21","326","643","145","318","471","961","3"
"1","2018","31","Otros","10","11","65","118","8","10","73","128","11.764705882353"
"1","2018","31","Otros","13","14","192","204","0","0","192","204","7.3846153846154"
"1","2018","31","Otros","6","27","313","1173","0","0","313","1173","1"
"1","2018","31","Otros","16","27","160","308","12","28","172","336","13.818181818182"
"1","2018","31","Hotel","9","26","434","434","0","0","434","434","1"
"1","2018","31","Hotel","16","27","786","815","926","1163","1712","1978","2.5"
"1","2018","31","Hotel","3","4","1820","2745","179","232","1999","2977","3"
"1","2018","31","Otros","16","27","53","159","0","0","53","159","2"
"1","2018","31","Otros","16","19","1430","6596","18","33","1448","6629","1.3333333333333"
"1","2018","31","Hotel","6","12","597","829","31","38","628","867","5"
"1","2018","31","Hotel","2","1","211","401","50","55","261","456","6.4"
"1","2018","31","Hotel","10","11","438","760","121","286","559","1046","1"
"1","2018","31","Otros","10","23","111","111","23","23","134","134","1"
"1","2018","31","Otros","10","27","899","954","149","174","1048","1128","4.84"
"1","2018","31","Hotel","16","27","304","497","110","310","414","807","2.5"
"1","2018","31","Hotel","6","28","288","356","61","64","349","420","1"
"1","2018","31","Hotel","4","13","177","375","21","30","198","405","5.4"
"1","2018","31","Hotel","14","27","665","805","64","96","729","901","8.5"
"1","2018","31","Hotel","10","27","155","241","723","925","878","1166","1"
"1","2018","31","Hotel","13","27","152","203","67","88","219","291","4.2"
"1","2018","31","Hotel","3","4","851","992","28","40","879","1032","3"
"1","2018","31","Otros","4","13","297","645","29","104","326","749","3.4"
"1","2018","31","Otros","11","15","40","80","0","0","40","80","2.3571428571429"
"1","2018","31","Otros","6","10","172","418","67","134","239","552","3.8518518518518"
"1","2018","31","Otros","2","1","85","102","6","6","91","108","1"
"1","2018","31","","6","12","75","574","0","0","75","574","1"
"1","2018","31","Otros","10","23","237","611","100","309","337","920","1"
"1","2018","31","Hotel","16","19","218","226","0","0","218","226","4"
"1","2018","31","Hotel","10","11","35","93","34","121","69","214","5.6666666666667"
"1","2018","31","Hotel","10","23","103","108","32","34","135","142","4"
"1","2018","31","Otros","14","31","47","178","325","807","372","985","2.8"
"1","2018","31","Otros","13","27","6","6","0","0","6","6","12.2"
"1","2018","31","Hotel","2","1","184","555","0","0","184","555","6.4"
"1","2018","31","Hotel","16","19","88","237","0","0","88","237","4"
"1","2018","31","Otros","12","35","42","75","55","84","97","159","3.5"
"1","2018","31","Otros","15","16","89","312","115","358","204","670","2"
"1","2018","31","Otros","9","22","794","1588","150","300","944","1888","1"
"1","2018","31","Hotel","10","27","247","335","853","1154","1100","1489","1"
"1","2018","31","Hotel","2","27","154","270","35","53","189","323","3.6"
"1","2018","31","Hotel","16","20","54","128","40","111","94","239","1"
"1","2018","31","Hotel","10","18","8","23","1","1","9","24","7.75"
"1","2018","31","Hotel","6","12","235","235","0","0","235","235","5"
"1","2018","31","Hotel","2","27","110","348","0","0","110","348","3.6"
"1","2018","31","Hotel","15","16","174","415","98","378","272","793","7.8"
"1","2018","31","Hotel","10","23","90","90","43","43","133","133","4"
"1","2018","31","Hotel","11","32","47","76","15","18","62","94","1"
"1","2018","31","Hotel","14","27","135","376","73","221","208","597","8.5"
"1","2018","31","Otros","16","19","54","92","0","0","54","92","4"
"1","2018","31","Otros","10","11","59","81","19","26","78","107","11.764705882353"
"1","2018","31","Otros","13","14","56","188","4","8","60","196","1"
"1","2018","31","Hotel","2","27","114","232","26","37","140","269","3.6"
"1","2018","31","Otros","13","14","167","777","14","30","181","807","7.3846153846154"
"1","2018","31","Hotel","2","1","207","218","4","4","211","222","6.4"
"1","2018","31","Otros","7","17","131","718","127","1041","258","1759","17.166666666667"
"1","2018","31","Otros","10","23","42","236","15","60","57","296","7"
"1","2018","31","Hotel","13","27","265","265","24","24","289","289","2.75"
"1","2018","31","Otros","10","18","57","510","80","166","137","676","10.25"
"1","2018","31","Otros","5","9","70","553","0","0","70","553","4.0454545454545"
"1","2018","31","Hotel","4","39","88","90","7","7","95","97","2.6"
"1","2018","31","Otros","16","27","42","98","2","4","44","102","13.818181818182"
"1","2018","31","Hotel","14","27","30","41","57","171","87","212","8.5"
"1","2018","31","Hotel","10","11","217","387","55","86","272","473","5.6666666666667"
"1","2018","31","Hotel","10","18","146","399","132","369","278","768","7.75"
"1","2018","31","Otros","14","31","127","201","154","254","281","455","20.2"
"1","2018","31","Otros","11","32","55","154","0","0","55","154","2.2857142857143"
"1","2018","31","Otros","5","5","41","105","30","51","71","156","3.65625"
"1","2018","31","Otros","6","25","80","395","0","0","80","395","2.3846153846154"
"1","2018","31","Hotel","3","4","96","259","30","57","126","316","2.6"
"1","2018","31","Otros","7","27","341","851","13","33","354","884","4.8333333333333"
"1","2018","31","Otros","2","29","104","270","219","569","323","839","3.28"
"1","2018","31","Hotel","2","29","64","201","191","528","255","729","1"
"1","2018","31","Otros","4","21","175","337","70","250","245","587","1"
"1","2018","31","Hotel","7","27","172","224","0","0","172","224","4.1666666666667"
"1","2018","31","Otros","5","5","28","67","18","27","46","94","3.65625"
"1","2018","31","Otros","11","36","92","212","116","344","208","556","5.1904761904762"
"1","2018","31","Otros","6","27","170","327","0","0","170","327","1"
"1","2018","31","Hotel","7","27","224","224","0","0","224","224","4.1666666666667"
"1","2018","31","Hotel","16","20","52","88","52","68","104","156","1"
"1","2018","31","Hotel","12","24","308","569","249","510","557","1079","3"
"1","2018","30","Hotel","9","26","78","198","8","15","86","213","1.5"
"1","2018","31","Hotel","7","17","295","777","254","1066","549","1843","10"
"1","2018","31","Hotel","9","37","229","308","31","113","260","421","3.4"
"1","2018","31","Hotel","5","5","435","604","206","249","641","853","2.1428571428571"
"1","2018","31","Otros","6","27","123","306","7","75","130","381","3.960088691796"
"1","2018","31","Hotel","9","37","115","213","18","18","133","231","3.4"
"1","2018","31","Otros","10","27","84","84","111","111","195","195","4.84"
"1","2018","31","Otros","8","3","186","420","16","26","202","446","10"
"1","2018","31","Otros","16","20","60","104","0","0","60","104","3.0769230769231"
"1","2018","31","Otros","9","22","18","54","0","0","18","54","7.6428571428571"
"1","2018","31","Otros","10","27","272","407","90","101","362","508","4.84"
"1","2018","31","Otros","10","23","150","161","12","12","162","173","7"
"1","2018","31","Otros","2","6","456","456","262","262","718","718","1"
"1","2018","31","Otros","5","5","88","149","55","113","143","262","4"
"1","2018","31","Otros","4","39","9","21","1","1","10","22","2.2222222222222"
"1","2018","31","Hotel","2","27","251","378","81","88","332","466","1"
"1","2018","31","Hotel","14","31","91","223","116","624","207","847","24"
"1","2018","31","Otros","12","35","12","20","269","529","281","549","2.6666666666667"
"1","2018","31","Otros","2","29","132","415","106","417","238","832","3.28"
"1","2018","31","Otros","8","3","896","3845","82","440","978","4285","10"
"1","2018","31","Hotel","7","27","44","162","1","1","45","163","1"
"1","2018","31","","13","14","10","24","55","102","65","126","1"
"1","2018","31","Hotel","6","10","334","419","57","60","391","479","6.6"
"1","2018","31","Hotel","8","34","143","167","115","166","258","333","2.5714285714286"
"1","2018","31","Hotel","9","22","108","143","0","0","108","143","2.5555555555556"
"1","2018","31","Hotel","2","6","117","240","165","165","282","405","2.2"
"1","2018","31","Hotel","10","27","97","236","255","335","352","571","2.25"
"1","2018","31","Otros","14","27","284","284","0","0","284","284","11.833333333333"
"1","2018","31","Otros","6","12","387","602","23","66","410","668","1.8256578947368"
"1","2018","31","Hotel","6","27","72","186","0","0","72","186","3"
"1","2018","31","Hotel","5","5","53","79","54","84","107","163","2.1428571428571"
"1","2018","30","Hotel","5","5","105","133","68","108","173","241","2.1428571428571"
"1","2018","31","Hotel","13","27","133","243","4","4","137","247","4.2"
"1","2018","31","Hotel","2","27","214","290","23","51","237","341","3.6"
"1","2018","31","Hotel","8","3","34","74","97","97","131","171","4.1111111111111"
"1","2018","31","Otros","11","36","86","283","24","54","110","337","5.1904761904762"
"1","2018","31","Otros","9","30","531","1847","0","0","531","1847","2.3333333333333"
"1","2018","31","Otros","16","19","84","225","0","0","84","225","10.263157894737"
"1","2018","31","Hotel","14","31","71","112","340","1102","411","1214","17.4"
"1","2018","31","Hotel","2","1","335","388","6","6","341","394","6.4"
"1","2018","31","Hotel","16","40","763","1398","967","1754","1730","3152","5.6666666666667"
"1","2018","31","Otros","7","17","204","458","159","1131","363","1589","17.166666666667"
"1","2018","31","Hotel","13","27","283","375","163","442","446","817","2.75"
"1","2018","31","Hotel","14","31","254","361","510","750","764","1111","24"
"1","2018","31","Otros","3","4","79","195","30","66","109","261","12.2"
"1","2018","31","Otros","8","34","187","259","255","396","442","655","5.75"
"1","2018","31","Hotel","9","22","206","287","5","5","211","292","2.5555555555556"
"1","2018","31","Hotel","4","21","130","172","26","33","156","205","3"
"1","2018","31","Hotel","6","27","86","133","0","0","86","133","3"
"1","2018","31","Hotel","12","35","74","144","231","346","305","490","1.7272727272727"
"1","2018","31","Hotel","2","29","36","73","143","277","179","350","2"
"1","2018","31","Otros","10","11","102","138","27","28","129","166","11.764705882353"
"1","2018","31","Hotel","6","10","87","121","0","0","87","121","6.6"
"1","2018","31","Hotel","13","14","145","145","56","112","201","257","2"
"1","2018","24","Otros","16","27","171","365","0","0","171","365","13.818181818182"
"1","2018","31","Otros","6","27","23","23","2","6","25","29","3.960088691796"
"1","2018","31","Hotel","16","40","91","189","647","1443","738","1632","5.6666666666667"
"1","2018","31","Otros","6","10","259","521","8","16","267","537","3.8518518518518"
"1","2018","31","Otros","10","23","39","51","40","59","79","110","7"
"1","2018","31","Hotel","6","28","294","335","54","54","348","389","1"
"1","2018","31","Otros","7","38","301","566","148","259","449","825","2.75"
"1","2018","31","Hotel","6","12","220","316","16","52","236","368","5"
"1","2018","31","Hotel","13","27","478","816","9","16","487","832","4.2"
"1","2018","31","Otros","4","21","71","186","0","0","71","186","4.8333333333333"
"1","2018","31","Otros","13","14","76","85","0","0","76","85","1"
"1","2018","30","Hotel","16","27","68","156","19","25","87","181","5.8571428571429"
"1","2018","31","Hotel","5","5","61","87","141","164","202","251","2.1428571428571"
"1","2018","31","Otros","12","24","96","296","113","155","209","451","9.2"
"1","2018","31","Otros","15","16","97","160","97","125","194","285","9"
"1","2018","31","Hotel","8","27","183","183","44","44","227","227","4.5"
"1","2018","31","Hotel","9","22","43","65","0","0","43","65","2.5555555555556"
"1","2018","31","Hotel","10","11","247","434","82","157","329","591","5.6666666666667"
"1","2018","31","Hotel","8","3","136","286","138","364","274","650","4.1111111111111"
"1","2018","31","Hotel","6","10","324","602","23","47","347","649","6.6"
"1","2018","31","Otros","9","26","47","165","12","26","59","191","3.8888888888889"
"1","2018","31","Hotel","4","39","79","153","21","60","100","213","2.6"
"1","2018","31","Otros","6","27","17","23","0","0","17","23","3.960088691796"
"1","2018","31","Otros","6","12","150","191","15","20","165","211","1.8256578947368"
"1","2018","31","Hotel","6","27","123","204","2","3","125","207","3"
"1","2018","31","Otros","5","9","74","83","27","37","101","120","4.0454545454545"
"1","2018","31","Otros","5","9","181","438","284","475","465","913","1"
"1","2018","31","Hotel","2","27","156","156","27","27","183","183","3.6"
"1","2018","31","Hotel","2","29","10","41","181","562","191","603","1"
"1","2018","31","Hotel","4","13","249","425","31","33","280","458","5.4"
"1","2018","31","","11","15","60","287","0","0","60","287","1"
"1","2018","31","Hotel","6","10","527","593","30","39","557","632","6.6"
"1","2018","31","Otros","6","12","45","169","2","10","47","179","1.8256578947368"
"1","2018","31","Otros","10","18","35","35","12","12","47","47","10.25"
"1","2018","31","Otros","9","22","371","1167","4","6","375","1173","7.6428571428571"
"1","2018","31","Otros","7","27","212","558","0","0","212","558","1"
"1","2018","31","","14","27","267","801","0","0","267","801","1"
"1","2018","31","Hotel","16","27","82","94","11","11","93","105","5.8571428571429"
"1","2018","31","Otros","2","29","29","65","43","72","72","137","3.28"
"1","2018","31","Hotel","8","27","16","54","0","0","16","54","1"
"1","2018","31","Otros","13","33","27","30","0","0","27","30","5.125"
"1","2018","31","Hotel","9","22","234","471","0","0","234","471","1"
"1","2018","31","Otros","10","23","33","112","0","0","33","112","1"
"1","2018","31","Otros","13","33","17","20","0","0","17","20","5.125"
"1","2018","30","Otros","6","10","111","706","0","0","111","706","3.8518518518518"
"1","2018","31","Hotel","10","18","134","256","97","203","231","459","7.75"
"1","2018","31","Hotel","14","31","75","114","54","182","129","296","24"
"1","2018","31","Hotel","4","21","103","103","10","10","113","113","3"
"1","2018","31","Hotel","3","4","40","166","90","398","130","564","2.6"
"1","2018","31","Otros","8","27","317","709","3","6","320","715","1"
"1","2018","31","Otros","6","27","23","60","0","0","23","60","3.960088691796"
"1","2018","31","Hotel","6","25","241","365","1","2","242","367","1"
"1","2018","31","Otros","6","12","227","376","24","51","251","427","1.8256578947368"
"1","2018","31","Hotel","6","27","54","408","0","0","54","408","3"
"1","2018","31","Otros","6","27","12","24","0","0","12","24","3.960088691796"
"1","2018","31","Otros","6","10","197","478","0","0","197","478","3.8518518518518"
"1","2018","31","Otros","6","12","105","226","0","0","105","226","1.8256578947368"
"1","2018","31","Otros","5","5","59","70","35","45","94","115","3.65625"
"1","2018","31","Hotel","12","24","128","482","66","175","194","657","3"
"1","2018","31","Hotel","12","35","14","23","117","162","131","185","2"
"1","2018","31","Hotel","15","16","122","171","9","15","131","186","7.8"
"1","2018","31","Otros","4","13","143","221","0","0","143","221","3.4"
"1","2018","31","Hotel","2","29","239","698","171","578","410","1276","1"
"1","2018","31","Hotel","4","21","94","188","30","34","124","222","3"
"1","2018","31","Hotel","10","27","130","345","434","553","564","898","2.25"
"1","2018","31","Hotel","8","3","220","497","94","222","314","719","4.1111111111111"
"1","2018","31","Hotel","12","27","92","127","56","58","148","185","1"
"1","2018","31","Otros","5","5","129","358","23","48","152","406","3.65625"
"1","2018","31","Otros","13","14","69","78","0","0","69","78","7.3846153846154"
"1","2018","31","Otros","10","11","420","623","113","213","533","836","11.764705882353"
"1","2018","31","Otros","16","40","185","533","55","357","240","890","28.142857142857"
"1","2018","31","Hotel","11","36","360","752","97","231","457","983","1"
"1","2018","31","Otros","12","35","71","196","171","381","242","577","2.6666666666667"
"1","2018","31","Otros","8","34","63","88","63","94","126","182","5.75"
"1","2018","4","Hotel","7","17","18","18","0","0","18","18","10"
"1","2018","31","Otros","12","35","192","327","25","47","217","374","3.5"
"1","2018","31","Otros","5","9","31","55","50","62","81","117","4.0454545454545"
"1","2018","31","Hotel","9","22","112","182","3","10","115","192","2.5555555555556"
"1","2018","31","Otros","2","29","54","136","72","145","126","281","3.28"
"1","2018","31","Otros","2","29","158","293","98","154","256","447","3.28"
"1","2018","31","Otros","10","23","55","106","17","20","72","126","1"
"1","2018","31","Hotel","10","27","125","164","231","269","356","433","2.25"
"1","2018","31","Hotel","16","19","151","187","53","63","204","250","4"
"1","2018","31","Hotel","16","40","59","508","46","152","105","660","16.333333333333"
"1","2018","31","Hotel","8","27","383","595","84","134","467","729","4.5"
"1","2018","31","Otros","13","14","16","16","4","4","20","20","7.3846153846154"
"1","2018","31","Hotel","7","27","56","115","0","0","56","115","4.1666666666667"
"1","2018","31","Otros","2","6","1","1","0","0","1","1","5"
"1","2018","31","Hotel","7","17","219","506","110","809","329","1315","10"
"1","2018","31","Hotel","3","4","146","296","67","155","213","451","2.6"
"1","2018","20","Otros","6","12","16","104","0","0","16","104","1.8256578947368"
"1","2018","31","Otros","6","10","56","62","0","0","56","62","3.8518518518518"
"1","2018","31","Hotel","16","40","74","122","80","168","154","290","16.333333333333"
"1","2018","31","Otros","4","39","44","69","11","18","55","87","2.2222222222222"
"1","2018","31","Otros","13","14","112","297","0","0","112","297","7.3846153846154"
"1","2018","31","Otros","7","38","194","352","8","8","202","360","2.75"
"1","2018","31","Hotel","11","32","70","98","0","0","70","98","1"
"1","2018","25","Otros","11","36","150","334","14","30","164","364","5.1904761904762"
"1","2018","31","Hotel","4","21","123","260","12","26","135","286","3"
"1","2018","31","Otros","3","4","19","65","0","0","19","65","12.2"
"1","2018","31","Otros","5","9","74","130","64","141","138","271","4.0454545454545"
"1","2018","31","Otros","16","19","67","138","0","0","67","138","4"
"1","2018","31","Hotel","8","27","90","102","13","74","103","176","4.5"
"1","2018","31","Otros","16","40","33","77","51","186","84","263","1"
"1","2018","31","","7","17","111","411","80","640","191","1051","1"
"1","2018","31","Otros","16","20","139","536","62","570","201","1106","3.0769230769231"
"1","2018","31","Otros","4","21","169","276","61","113","230","389","4.8333333333333"
"1","2018","31","Otros","13","33","46","56","30","45","76","101","5.125"
"1","2018","31","","12","35","19","27","1288","2015","1307","2042","1"
"1","2018","31","Hotel","13","33","0","0","2","6","2","6","2"
"1","2018","31","Otros","4","39","13","25","3","9","16","34","2.2222222222222"
"1","2018","31","Otros","10","18","52","129","13","32","65","161","10.25"
"1","2018","31","Otros","6","27","87","180","4","6","91","186","3.960088691796"
"1","2018","31","Otros","12","35","13","17","454","720","467","737","2.6666666666667"
"1","2018","15","Hotel","4","39","38","83","0","0","38","83","2.6"
"1","2018","31","Otros","14","31","12","72","158","274","170","346","20.2"
"1","2018","31","Hotel","2","29","44","116","312","667","356","783","2"
"1","2018","31","Hotel","13","14","22","62","0","0","22","62","1"
"1","2018","31","Hotel","9","26","165","227","3","4","168","231","1.5"
"1","2018","31","Otros","8","2","40","198","4","6","44","204","1"
"1","2018","31","Otros","12","35","11","12","10","14","21","26","3.5"
"1","2018","31","Hotel","14","27","123","150","66","81","189","231","8.5"
"1","2018","31","Otros","11","36","117","433","64","202","181","635","5.1904761904762"
"1","2018","31","Otros","16","20","182","746","52","256","234","1002","3.0769230769231"
"1","2018","31","Otros","4","39","2","10","0","0","2","10","2.2222222222222"
"1","2018","31","Otros","7","27","203","293","11","53","214","346","4.8333333333333"
"1","2018","31","Otros","6","27","115","152","10","26","125","178","3.960088691796"
"1","2018","31","Otros","5","8","10","162","5","9","15","171","5"
"1","2018","31","Otros","9","37","204","405","0","0","204","405","4.5"
"1","2018","31","Hotel","2","6","31","65","0","0","31","65","5.5"
"1","2018","31","Hotel","10","27","122","147","232","256","354","403","2.25"
"1","2018","31","Hotel","9","30","139","334","16","57","155","391","1"
"1","2018","31","Otros","4","13","80","169","1","1","81","170","3.4"
"1","2018","31","Hotel","5","5","355","355","0","0","355","355","1"
"1","2018","31","Otros","7","38","287","771","29","65","316","836","2.75"
"1","2018","31","Hotel","13","14","69","207","18","54","87","261","1"
"1","2018","31","Otros","5","9","21","40","17","30","38","70","4.0454545454545"
"1","2018","31","Otros","5","8","2","3","0","0","2","3","5"
"1","2018","31","Otros","10","27","135","135","212","459","347","594","4.84"
"1","2018","31","Hotel","13","14","11","17","3","3","14","20","1"
"1","2018","31","Otros","11","15","1","2","0","0","1","2","2.3571428571429"
"1","2018","31","Hotel","9","22","427","625","0","0","427","625","2.5555555555556"
"1","2018","31","Otros","11","36","195","321","32","63","227","384","5.1904761904762"
"1","2018","31","Hotel","10","18","1655","3855","2616","5168","4271","9023","1"
"1","2018","31","Hotel","6","12","253","420","0","0","253","420","5"
"1","2018","31","","2","29","345","851","905","2253","1250","3104","1"
"1","2018","31","Hotel","16","27","2429","5334","119","230","2548","5564","1"
"1","2018","31","","14","31","332","653","601","2402","933","3055","1"
"1","2018","31","Hotel","8","3","54","223","32","64","86","287","4.1111111111111"
"1","2018","31","Otros","13","33","110","161","106","188","216","349","5.125"
"1","2018","31","","14","27","102","146","0","0","102","146","2.6666666666667"
"1","2018","31","Otros","9","22","106","201","0","0","106","201","7.6428571428571"
"1","2018","31","Hotel","10","11","45","117","31","60","76","177","5.6666666666667"
"1","2018","31","Otros","6","12","17","28","0","0","17","28","1.8256578947368"
"1","2018","31","Hotel","8","3","192","384","82","152","274","536","4.1111111111111"
"1","2018","31","Otros","9","22","175","733","0","0","175","733","3.25"
"1","2018","31","Hotel","7","17","303","934","36","172","339","1106","1"
"1","2018","31","Otros","6","12","362","812","0","0","362","812","1.8256578947368"
"1","2018","31","Hotel","8","27","229","229","9","9","238","238","4.5"
"1","2018","31","Hotel","6","28","233","278","39","45","272","323","2.4"
"1","2018","31","Otros","8","2","260","607","130","208","390","815","1"
"1","2018","31","Hotel","8","27","86","103","0","0","86","103","1"
"1","2018","31","Otros","6","25","262","1268","0","0","262","1268","2.3846153846154"
"1","2018","31","Otros","6","25","124","188","0","0","124","188","2.3846153846154"
"1","2018","31","Hotel","11","36","278","468","0","0","278","468","1"
"1","2018","31","Otros","16","20","29","85","9","9","38","94","1"
"1","2018","31","Otros","2","6","30","72","255","733","285","805","5"
"1","2018","31","Hotel","14","31","47","73","143","338","190","411","24"
"1","2018","31","Otros","4","21","118","421","43","143","161","564","4.8333333333333"
"1","2018","31","Otros","7","38","94","203","10","15","104","218","2.75"
"1","2018","31","Otros","13","14","168","326","12","20","180","346","7.3846153846154"
"1","2018","31","Otros","2","29","36","60","57","167","93","227","3.28"
"1","2018","31","Otros","3","4","103","103","49","49","152","152","12.2"
"1","2018","31","Hotel","3","4","394","1036","52","111","446","1147","3"
"1","2018","31","Otros","7","27","408","595","87","100","495","695","1"
"1","2018","31","Otros","7","17","218","286","15","15","233","301","3"
"1","2018","31","Hotel","12","27","237","381","9","9","246","390","1"
"1","2018","31","Otros","5","5","38","74","13","32","51","106","3.65625"
"1","2018","31","Hotel","6","10","350","467","9","20","359","487","6.6"
"1","2018","31","Otros","10","18","144","437","56","151","200","588","10.25"
"1","2018","31","Otros","8","27","70","100","0","0","70","100","9.4"
"1","2018","31","Otros","8","3","110","437","39","140","149","577","10"
"1","2018","31","Hotel","16","27","59","79","2","2","61","81","5.8571428571429"
"1","2018","31","Otros","16","40","117","267","0","0","117","267","1"
"1","2018","31","Otros","8","27","165","276","11","11","176","287","1"
"1","2018","31","Otros","6","10","57","117","0","0","57","117","3.8518518518518"
"1","2018","31","Otros","7","17","159","458","51","293","210","751","3"
"1","2018","31","Otros","16","40","24","26","24","82","48","108","1"
"1","2018","31","Hotel","2","6","28","50","14","14","42","64","5.5"
"1","2018","31","Hotel","8","3","78","292","25","85","103","377","4.1111111111111"
"1","2018","31","Otros","7","38","449","896","0","0","449","896","1"
"1","2018","31","Otros","10","11","81","150","27","62","108","212","11.764705882353"
"1","2018","31","Otros","6","27","137","246","0","0","137","246","3.960088691796"
"1","2018","31","Otros","15","16","18","39","3","6","21","45","9"
"1","2018","31","Otros","6","25","243","362","0","0","243","362","1"
"1","2018","31","Otros","5","5","37","65","57","70","94","135","3.65625"
"1","2018","31","Otros","10","27","168","601","113","185","281","786","4.84"
"1","2018","31","Hotel","7","38","85","106","43","43","128","149","1"
"1","2018","31","Hotel","12","35","92","92","332","546","424","638","2"
"1","2018","31","Hotel","13","27","19","206","1","1","20","207","4.2"
"1","2018","31","Hotel","16","20","190","354","0","0","190","354","1"
"1","2018","31","Otros","10","27","84","127","275","330","359","457","4.84"
"1","2018","31","Otros","16","40","52","106","5","14","57","120","1"
"1","2018","31","Hotel","3","7","29","33","14","21","43","54","1"
"1","2018","31","Otros","2","29","106","213","25","45","131","258","3.28"
"1","2018","31","Otros","10","18","89","182","42","88","131","270","10.25"
"1","2018","31","Otros","5","5","84","179","103","202","187","381","4"
"1","2018","31","Otros","9","22","310","1155","0","0","310","1155","7.6428571428571"
"1","2018","31","Otros","15","27","122","128","4","4","126","132","1.4222222222222"
"1","2018","31","Otros","5","5","51","107","65","90","116","197","4"
"1","2018","31","Hotel","16","19","72","171","0","0","72","171","1"
"1","2018","31","Otros","11","36","21","38","5","10","26","48","5.1904761904762"
"1","2018","31","Otros","5","5","31","52","18","29","49","81","3.65625"
"1","2018","31","Otros","2","29","25","75","27","77","52","152","3.28"
"1","2018","31","Hotel","9","22","218","218","31","31","249","249","2.5555555555556"
"1","2018","31","Otros","11","32","4","8","0","0","4","8","2.2857142857143"
"1","2018","31","Hotel","10","27","306","499","441","613","747","1112","1"
"1","2018","31","Otros","16","27","122","254","4","8","126","262","2"
"1","2018","31","Otros","13","33","7","12","50","83","57","95","1"
"1","2018","31","Hotel","16","20","69","161","2","4","71","165","1"
"1","2018","31","Otros","11","15","32","69","10","30","42","99","2.3571428571429"
"1","2018","31","Otros","7","17","61","201","7","40","68","241","3"
"1","2018","31","Otros","5","8","25","28","20","24","45","52","5"
"1","2018","31","Otros","8","27","216","232","16","16","232","248","1"
"1","2018","31","Otros","8","3","5","62","29","180","34","242","14.75"
"1","2018","31","Otros","16","27","38","266","0","0","38","266","1"
"1","2018","0","Otros","13","14","0","0","0","0","0","0","1"
"1","2018","31","Hotel","13","33","77","111","16","21","93","132","2"
"1","2018","31","Otros","5","9","76","171","43","74","119","245","4.0454545454545"
"1","2018","31","Otros","10","27","97","211","117","153","214","364","4.84"
"1","2018","31","Otros","9","22","150","372","0","0","150","372","7.6428571428571"
"1","2018","31","Otros","16","40","128","255","17","30","145","285","28.142857142857"
"1","2018","31","Hotel","16","40","111","141","24","97","135","238","1"
"1","2018","31","Otros","15","16","21","47","19","29","40","76","9"
"1","2018","31","Hotel","8","2","33","61","45","55","78","116","3"
"1","2018","31","Otros","8","3","95","314","0","0","95","314","10"
"1","2018","31","Otros","7","17","58","68","10","15","68","83","17.166666666667"
"1","2018","31","Otros","16","20","148","206","22","38","170","244","3.0769230769231"
"1","2018","31","Otros","6","27","109","248","2","2","111","250","3.960088691796"
"1","2018","31","Otros","12","35","62","141","313","523","375","664","3.5"
"1","2018","31","Otros","6","28","75","454","24","38","99","492","4.65"
"1","2018","31","Otros","6","28","776","1375","39","86","815","1461","4.65"
"1","2018","31","Hotel","8","34","95","131","179","247","274","378","2.5714285714286"
"1","2018","31","Hotel","16","20","2400","2815","18","55","2418","2870","1"
"1","2018","31","Hotel","2","6","195","486","0","0","195","486","2.2"
"1","2018","31","Hotel","7","27","52","52","0","0","52","52","4.1666666666667"
"1","2018","31","Hotel","10","23","81","134","19","27","100","161","4"
"1","2018","31","Hotel","9","26","91","214","11","33","102","247","1.5"
"1","2018","31","Otros","13","14","74","116","0","0","74","116","1"
"1","2018","31","Otros","8","27","268","365","8","8","276","373","9.4"
"1","2018","31","Otros","10","27","74","126","32","32","106","158","4.84"
"1","2018","31","Otros","11","15","54","84","16","21","70","105","2.3571428571429"
"1","2018","31","Otros","16","20","118","137","0","0","118","137","3.0769230769231"
"1","2018","31","Otros","11","32","108","120","0","0","108","120","1"
"1","2018","31","Otros","16","27","110","110","6","6","116","116","13.818181818182"
"1","2018","31","Otros","7","38","16","52","0","0","16","52","1"
"1","2018","31","Otros","9","37","71","101","0","0","71","101","4.5"
"1","2018","31","Hotel","2","29","27","92","75","267","102","359","2"
"1","2018","31","Hotel","2","1","145","529","8","11","153","540","6.4"
"1","2018","31","Otros","5","8","19","23","37","37","56","60","5"
"1","2018","31","Otros","9","37","62","124","57","176","119","300","4.5"
"1","2018","31","Otros","7","38","307","1060","0","0","307","1060","2.75"
"1","2018","31","Otros","11","32","152","499","17","22","169","521","1"
"1","2018","31","Otros","4","39","103","115","7","7","110","122","2.2222222222222"
"1","2018","31","Hotel","11","36","84","148","24","48","108","196","2.375"
"1","2018","31","Otros","10","23","100","429","22","135","122","564","7"
"1","2018","31","Otros","6","28","464","621","32","42","496","663","1"
"1","2018","31","Otros","7","38","167","362","66","139","233","501","1"
"1","2018","31","Hotel","15","16","1973","4782","2600","2803","4573","7585","2"
"1","2018","31","Otros","2","29","28","85","218","454","246","539","3.28"
"1","2018","0","Hotel","8","3","0","0","0","0","0","0","1"
"1","2018","31","Hotel","6","12","825","1039","28","34","853","1073","1"
"1","2018","31","Hotel","11","15","323","2886","0","0","323","2886","1"
"1","2018","31","Otros","4","21","762","1784","52","72","814","1856","1"
"1","2018","31","Otros","16","19","163","439","0","0","163","439","10.263157894737"
"1","2018","31","","9","37","335","468","12","18","347","486","1"
"1","2018","31","Otros","10","27","240","375","199","286","439","661","4.84"
"1","2018","31","Otros","11","15","151","151","0","0","151","151","2.3571428571429"
"1","2018","31","Hotel","8","3","5","85","4","4","9","89","1"
"1","2018","31","Hotel","2","29","60","176","137","410","197","586","2"
"1","2018","31","Otros","9","22","191","306","0","0","191","306","3.25"
"1","2018","31","Hotel","10","27","321","441","290","336","611","777","1"
"1","2018","31","Hotel","11","36","182","589","80","193","262","782","2.375"
"1","2018","31","Hotel","9","37","135","182","82","156","217","338","3.4"
"1","2018","31","Otros","14","27","6","12","4","4","10","16","11.833333333333"
"1","2018","31","Otros","7","38","360","913","5","5","365","918","1"
"1","2018","31","Hotel","2","1","72","405","0","0","72","405","6.4"
"1","2018","31","Otros","2","29","15","23","98","271","113","294","3.28"
"1","2018","31","Hotel","6","27","4","5","0","0","4","5","3"
"1","2018","31","Otros","5","9","5","155","0","0","5","155","4.0454545454545"
"1","2018","31","Hotel","2","1","161","203","0","0","161","203","6.4"
"1","2018","31","Hotel","10","27","72","112","213","275","285","387","1"
"1","2018","31","Hotel","3","7","5","34","46","71","51","105","1"
"1","2018","31","Otros","7","38","22","22","16","16","38","38","2.75"
"1","2018","0","Otros","12","24","0","0","0","0","0","0","1"
"1","2018","31","Otros","7","17","24","58","4","4","28","62","17.166666666667"
"1","2018","31","Otros","7","38","50","88","9","20","59","108","2.75"
"1","2018","31","Otros","4","21","75","84","11","11","86","95","4.8333333333333"
"1","2018","31","Otros","2","1","47","47","4","4","51","51","5.5"
"1","2018","31","Otros","12","35","72","252","116","227","188","479","3.5"
"1","2018","0","Otros","3","4","0","0","0","0","0","0","1"
"1","2018","31","Otros","12","35","44","89","54","62","98","151","3.5"
"1","2018","31","Otros","4","21","45","67","8","22","53","89","4.8333333333333"
"1","2018","31","Otros","12","24","17","45","15","40","32","85","9.2"
"1","2018","31","Otros","16","19","30","50","0","0","30","50","10.263157894737"
"1","2018","31","Otros","9","30","20","45","0","0","20","45","1"
"1","2018","31","Otros","10","11","355","748","17","38","372","786","11.764705882353"
"1","2018","31","Otros","16","19","71","226","0","0","71","226","10.263157894737"
"1","2018","31","Hotel","2","27","107","107","59","59","166","166","1"
"1","2018","31","Otros","6","28","133","168","7","7","140","175","4.65"
"1","2018","31","Otros","10","18","217","613","70","218","287","831","10.25"
"1","2018","31","Otros","14","27","34","71","0","0","34","71","11.833333333333"
"1","2018","31","Hotel","16","19","118","228","0","0","118","228","1"
"1","2018","31","Hotel","11","32","112","182","0","0","112","182","1"
"1","2018","31","Hotel","7","17","63","269","17","115","80","384","1"
"1","2018","31","Otros","8","27","13","20","0","0","13","20","9.4"
"1","2018","31","Hotel","12","35","55","147","173","285","228","432","1.7272727272727"
"1","2018","31","Otros","13","14","65","99","0","0","65","99","7.3846153846154"
"1","2018","31","Hotel","11","15","1164","1191","0","0","1164","1191","1"
"1","2018","31","Otros","16","19","126","516","0","0","126","516","4"
"1","2018","31","Otros","11","36","51","93","0","0","51","93","5.1904761904762"
"1","2018","31","Otros","10","23","49","101","21","40","70","141","1"
"1","2018","31","Otros","16","20","169","299","8","24","177","323","3.0769230769231"
"1","2018","31","Hotel","14","31","113","182","627","794","740","976","7.8"
"1","2018","31","Otros","2","27","218","324","30","71","248","395","3.2"
"1","2018","31","","16","40","482","2928","0","0","482","2928","3.0555555555556"
"1","2018","31","Hotel","11","36","214","321","32","52","246","373","2.375"
"1","2018","31","Hotel","9","22","83","147","2","2","85","149","2.5555555555556"
"1","2018","31","Otros","6","10","356","701","0","0","356","701","1"
"1","2018","31","Otros","2","29","19","43","47","115","66","158","3.28"
"1","2018","31","Hotel","10","27","27","40","229","309","256","349","2.25"
"1","2018","31","Hotel","10","18","59","66","77","87","136","153","1"
"1","2018","31","Otros","10","27","11","47","0","0","11","47","4.84"
"1","2018","31","Hotel","16","19","69","96","7","21","76","117","4"
"1","2018","20","Otros","2","6","13","23","6","6","19","29","5"
"1","2018","31","Otros","7","27","338","1269","12","114","350","1383","4.8333333333333"
"1","2018","31","Hotel","2","6","98","773","0","0","98","773","5.5"
"1","2018","31","Hotel","6","28","7","7","15","15","22","22","2.4"
"1","2018","31","Otros","6","10","185","596","4","20","189","616","3.8518518518518"
"1","2018","31","Hotel","6","27","37","55","2","2","39","57","3"
"1","2018","31","Otros","6","10","30","58","0","0","30","58","1"
"1","2018","31","Otros","5","9","197","379","88","200","285","579","5.5"
"1","2018","31","Otros","5","5","43","65","14","20","57","85","3.65625"
"1","2018","30","Otros","12","24","55","119","87","128","142","247","9.2"
"1","2018","31","Hotel","8","2","84","192","18","36","102","228","3"
"1","2018","31","Hotel","11","32","19","62","2","6","21","68","1"
"1","2018","31","Otros","10","18","39","125","86","263","125","388","10.25"
"1","2018","31","Hotel","9","37","51","184","33","69","84","253","3.4"
"1","2018","31","Otros","5","9","95","149","144","168","239","317","4.0454545454545"
"1","2018","30","Otros","12","24","32","71","38","75","70","146","9.2"
"1","2018","31","Otros","9","22","23","28","0","0","23","28","7.6428571428571"
"1","2018","31","Otros","2","29","18","65","28","103","46","168","3.28"
"1","2018","31","Otros","10","23","27","67","3","3","30","70","7"
"1","2018","31","Otros","7","27","102","180","0","0","102","180","1"
"1","2018","31","Otros","10","27","25","82","6","14","31","96","3"
"1","2018","31","Otros","10","27","41","158","21","73","62","231","4.84"
"1","2018","31","Otros","10","11","212","212","0","0","212","212","11.764705882353"
"1","2018","31","Otros","10","11","42","138","0","0","42","138","1"
"1","2018","31","Otros","8","3","92","490","54","476","146","966","10"
"1","2018","31","Otros","14","31","61","189","541","882","602","1071","20.2"
"1","2018","31","Otros","2","29","347","894","254","688","601","1582","3.28"
"1","2018","31","Otros","6","25","150","261","0","0","150","261","1"
"1","2018","31","Otros","10","18","64","166","83","281","147","447","4.6"
"1","2018","31","Hotel","15","16","144","423","60","147","204","570","7.8"
"1","2018","31","Otros","13","33","47","135","6","16","53","151","1"
"1","2018","31","Otros","8","27","69","82","0","0","69","82","1"
"1","2018","31","Hotel","15","27","150","221","4","4","154","225","1"
"1","2018","31","Otros","10","27","27","86","9","25","36","111","4.84"
"1","2018","31","Otros","10","23","73","73","4","4","77","77","7"
"1","2018","31","Otros","6","27","35","59","0","0","35","59","3.960088691796"
"1","2018","31","Otros","16","40","161","386","0","0","161","386","28.142857142857"
"1","2018","31","Otros","11","36","277","475","26","52","303","527","5.1904761904762"
"1","2018","31","Otros","8","34","42","52","16","23","58","75","5.75"
"1","2018","31","Otros","6","12","15","140","0","0","15","140","1.8256578947368"
"1","2018","31","Otros","6","10","237","540","0","0","237","540","3.8518518518518"
"1","2018","31","Otros","8","27","317","437","33","67","350","504","1"
"1","2018","31","Otros","8","2","54","187","25","54","79","241","1"
"1","2018","31","Hotel","12","24","18","18","241","241","259","259","1"
"1","2018","31","Hotel","4","21","194","397","18","245","212","642","3"
"1","2018","31","Otros","7","27","167","205","8","8","175","213","1"
"1","2018","31","Hotel","11","36","209","537","79","172","288","709","2.375"
"1","2018","31","Otros","5","8","137","231","164","200","301","431","5"
"1","2018","31","Hotel","7","17","196","196","18","45","214","241","10"
"1","2018","22","Hotel","11","36","302","445","35","39","337","484","1"
"1","2018","31","Otros","9","30","89","110","0","0","89","110","2.3333333333333"
"1","2018","31","Otros","5","8","0","0","38","149","38","149","9"
"1","2018","31","Hotel","12","35","64","196","164","267","228","463","1.7272727272727"
"1","2018","31","Otros","2","1","79","104","47","79","126","183","5.5"
"1","2018","31","Hotel","6","25","167","169","0","0","167","169","1"
"1","2018","31","Otros","5","5","19","27","16","27","35","54","3.65625"
"1","2018","31","Otros","2","29","26","71","59","179","85","250","3.28"
"1","2018","31","Hotel","2","6","19","19","21","24","40","43","5.5"
"1","2018","31","Otros","7","17","51","113","23","91","74","204","17.166666666667"
"1","2018","31","Hotel","8","2","11","19","17","17","28","36","3"
"1","2018","31","Hotel","13","14","35","55","0","0","35","55","1"
"1","2018","31","Otros","7","38","93","180","21","46","114","226","2.75"
"1","2018","31","Hotel","14","31","7","7","192","434","199","441","24"
"1","2018","31","Hotel","5","5","19","33","83","149","102","182","2.1428571428571"
"1","2018","31","Otros","2","27","6","6","5","6","11","12","3.2"
"1","2018","31","Otros","12","24","31","54","69","114","100","168","1"
"1","2018","31","Otros","5","8","17","29","50","73","67","102","5"
"1","2018","31","Otros","3","4","61","229","0","0","61","229","12.2"
"1","2018","31","Otros","13","14","4","20","0","0","4","20","7.3846153846154"
"1","2018","31","Otros","9","37","38","406","0","0","38","406","4.5"
"1","2018","31","Hotel","10","23","1332","1484","228","284","1560","1768","1"
"1","2018","31","Otros","11","32","63","63","5","5","68","68","2.2857142857143"
"1","2018","31","Otros","10","11","154","321","0","0","154","321","1"
"1","2018","31","Otros","11","15","5","15","0","0","5","15","2.3571428571429"
"1","2018","31","Otros","8","3","59","310","37","99","96","409","10"
"1","2018","31","Otros","16","20","133","854","25","213","158","1067","3.0769230769231"
"1","2018","31","Otros","10","18","176","432","7","10","183","442","4.6"
"1","2018","31","Otros","8","3","83","320","0","0","83","320","10"
"1","2018","31","Otros","16","27","143","272","0","0","143","272","2"
"1","2018","31","Otros","16","19","6","14","0","0","6","14","4"
"1","2018","31","Hotel","16","19","37","44","13","16","50","60","4"
"1","2018","31","Hotel","16","27","72","174","10","30","82","204","5.8571428571429"
"1","2018","31","Otros","12","35","17","17","13","15","30","32","2.6666666666667"
"1","2018","31","Otros","9","26","7","66","1","12","8","78","3.8888888888889"
"1","2018","31","Otros","5","5","29","53","12","23","41","76","3.65625"
"1","2018","31","Otros","14","27","33","33","4","4","37","37","11.833333333333"
"1","2018","31","Hotel","5","5","3","3","41","275","44","278","2.1428571428571"
"1","2018","31","Hotel","12","24","102","195","162","300","264","495","3"
"1","2018","31","Otros","16","27","61","217","0","0","61","217","13.818181818182"
"1","2018","31","Otros","7","27","34","126","0","0","34","126","1"
"1","2018","31","Otros","8","3","135","483","6","36","141","519","1"
"1","2018","31","Otros","9","37","56","126","0","0","56","126","2"
"1","2018","31","Otros","13","27","233","303","26","99","259","402","12.2"
"1","2018","31","Hotel","16","40","26","38","62","223","88","261","16.333333333333"
"1","2018","31","Otros","11","36","47","166","0","0","47","166","1"
"1","2018","31","Otros","10","27","72","137","76","116","148","253","4.84"
"1","2018","31","Hotel","7","38","73","111","16","31","89","142","1"
"1","2018","31","Otros","13","33","297","410","0","0","297","410","1"
"1","2018","31","Otros","9","22","132","386","0","0","132","386","7.6428571428571"
"1","2018","31","Hotel","8","3","17","21","12","18","29","39","1"
"1","2018","31","Hotel","5","5","67","110","85","114","152","224","2.1428571428571"
"1","2018","31","Otros","2","29","45","102","132","296","177","398","3.28"
"1","2018","31","Otros","2","29","10","17","6","8","16","25","3.28"
"1","2018","31","Otros","2","29","27","93","32","92","59","185","1"
"1","2018","31","Hotel","7","17","32","102","35","426","67","528","1"
"1","2018","31","Hotel","13","14","117","137","13","13","130","150","1"
"1","2018","31","Otros","6","25","4","4","0","0","4","4","2.3846153846154"
"1","2018","31","Otros","2","1","7","11","0","0","7","11","5.5"
"1","2018","31","Hotel","12","27","38","50","83","83","121","133","1"
"1","2018","31","Hotel","13","27","10","12","0","0","10","12","4.2"
"1","2018","31","Otros","6","12","170","303","1","4","171","307","1.8256578947368"
"1","2018","31","Otros","6","27","40","46","0","0","40","46","3.960088691796"
"1","2018","31","Otros","6","25","108","140","0","0","108","140","2.3846153846154"
"1","2018","31","Otros","6","25","53","175","11","31","64","206","1"
"1","2018","31","Hotel","6","28","20","64","2","4","22","68","2.5833333333333"
"1","2018","6","Otros","6","27","7","15","0","0","7","15","3.6666666666667"
"1","2018","31","Otros","5","5","0","0","5","10","5","10","3.65625"
"1","2018","31","Otros","5","9","22","48","9","12","31","60","4.0454545454545"
"1","2018","31","Otros","5","8","20","45","9","13","29","58","5"
"1","2018","31","Hotel","2","29","147","394","260","704","407","1098","1"
"1","2018","31","Otros","5","5","138","222","86","103","224","325","3.65625"
"1","2018","31","Hotel","9","26","13","43","10","20","23","63","1.5"
"1","2018","31","Otros","9","30","10","13","0","0","10","13","2.3333333333333"
"1","2018","31","Otros","11","15","27","81","3","16","30","97","2.3571428571429"
"1","2018","31","Hotel","16","27","2","2","4","6","6","8","5.8571428571429"
"1","2018","31","Otros","9","30","13","19","3","5","16","24","2.3333333333333"
"1","2018","24","Otros","11","15","112","200","18","18","130","218","1"
"1","2018","31","Otros","2","29","58","113","13","49","71","162","3.28"
"1","2018","31","Otros","7","38","53","105","33","63","86","168","2.75"
"1","2018","31","Otros","4","21","100","436","36","161","136","597","4.8333333333333"
"1","2018","31","Otros","9","22","113","297","0","0","113","297","7.6428571428571"
"1","2018","31","Otros","9","22","168","400","0","0","168","400","7.6428571428571"
"1","2018","31","Otros","13","27","35","215","0","0","35","215","12.2"
"1","2018","31","Otros","8","3","118","295","8","8","126","303","14.75"
"1","2018","12","Otros","11","32","19","143","0","0","19","143","1"
"1","2018","31","Hotel","11","36","3336","3474","108","154","3444","3628","1"
"1","2018","31","Otros","13","33","18","30","10","16","28","46","5.125"
"1","2018","31","Otros","11","36","104","227","92","212","196","439","5.1904761904762"
"1","2018","31","Otros","12","35","71","143","258","430","329","573","3.5"
"1","2018","31","Otros","12","35","18","43","37","72","55","115","3.5"
"1","2018","31","Otros","16","40","26","36","0","0","26","36","1"
"1","2018","31","Otros","10","11","119","357","19","50","138","407","11.764705882353"
"1","2018","31","Otros","12","24","22","55","38","76","60","131","9.2"
"1","2018","31","Otros","16","20","76","363","0","0","76","363","3.0769230769231"
"1","2018","31","Hotel","7","27","13","31","0","0","13","31","1"
"1","2018","31","Otros","13","27","41","61","0","0","41","61","9"
"1","2018","31","Otros","6","12","24","29","0","0","24","29","1.8256578947368"
"1","2018","31","Otros","11","32","176","511","26","68","202","579","2.2857142857143"
"1","2018","31","Otros","6","28","250","341","4","14","254","355","4.65"
"1","2018","31","Otros","8","34","7","7","0","0","7","7","5.75"
"1","2018","30","Otros","16","27","7","7","0","0","7","7","13.818181818182"
"1","2018","31","Otros","10","27","21","21","9","9","30","30","3"
"1","2018","31","Otros","10","11","39","39","0","0","39","39","11.764705882353"
"1","2018","31","Otros","6","10","80","210","5","50","85","260","3.8518518518518"
"1","2018","31","Otros","8","3","4","5","0","0","4","5","10"
"1","2018","31","Hotel","16","20","35","124","38","222","73","346","1"
"1","2018","31","Hotel","11","32","90","116","24","32","114","148","1"
"1","2018","31","Otros","8","27","22","99","9","9","31","108","9.4"
"1","2018","31","Otros","12","27","92","177","47","88","139","265","3.4285714285714"
"1","2018","31","Otros","6","10","106","204","0","0","106","204","3.8518518518518"
"1","2018","31","Otros","6","10","17","73","0","0","17","73","3.8518518518518"
"1","2018","31","Otros","5","8","36","51","11","13","47","64","5"
"1","2018","31","Otros","5","8","37","37","34","40","71","77","5"
"1","2018","31","Otros","5","9","26","36","21","37","47","73","5.5"
"1","2018","31","Hotel","9","26","98","108","4","8","102","116","1.5"
"1","2018","31","Hotel","13","14","12","24","13","39","25","63","1"
"1","2018","31","Otros","10","18","69","399","74","306","143","705","10.25"
"1","2018","31","Otros","8","2","68","73","35","37","103","110","6.4285714285714"
"1","2018","31","Otros","7","27","6","6","0","0","6","6","4.8333333333333"
"1","2018","31","Otros","2","29","12","34","58","248","70","282","1"
"1","2018","31","Otros","2","29","62","179","40","87","102","266","3.28"
"1","2018","31","Otros","11","32","14","43","0","0","14","43","2.2857142857143"
"1","2018","31","Otros","9","30","59","170","0","0","59","170","2.3333333333333"
"1","2018","31","Otros","2","29","17","43","25","68","42","111","3.28"
"1","2018","31","Otros","5","5","12","20","8","8","20","28","3.65625"
"1","2018","31","Otros","11","15","30","38","0","0","30","38","2.3571428571429"
"1","2018","31","Otros","10","23","72","72","26","26","98","98","7"
"1","2018","31","Otros","11","36","94","204","45","60","139","264","5.1904761904762"
"1","2018","31","Hotel","3","7","19","43","36","65","55","108","1"
"1","2018","31","Otros","10","27","17","17","7","7","24","24","4.84"
"1","2018","31","Otros","2","27","4","4","0","0","4","4","3.2"
"1","2018","31","Otros","12","35","18","47","29","42","47","89","3.5"
"1","2018","31","Otros","10","27","23","34","48","82","71","116","4.84"
"1","2018","31","Otros","16","40","27","60","183","454","210","514","28.142857142857"
"1","2018","31","Hotel","8","3","346","828","161","412","507","1240","4.1111111111111"
"1","2018","31","Otros","9","22","129","229","2","4","131","233","7.6428571428571"
"1","2018","31","Otros","13","14","71","143","3","21","74","164","7.3846153846154"
"1","2018","31","Otros","5","9","16","22","19","31","35","53","4.0454545454545"
"1","2018","31","Otros","10","18","57","86","42","102","99","188","10.25"
"1","2018","31","Otros","6","25","215","572","26","92","241","664","2.3846153846154"
"1","2018","31","Otros","9","22","78","246","0","0","78","246","7.6428571428571"
"1","2018","31","Otros","10","27","54","92","15","18","69","110","4.84"
"1","2018","31","Otros","9","22","39","85","0","0","39","85","3.25"
"1","2018","31","Otros","16","20","76","162","6","18","82","180","3.0769230769231"
"1","2018","31","Otros","13","14","181","384","13","13","194","397","1"
"1","2018","31","Otros","16","19","18","42","0","0","18","42","4"
"1","2018","31","Hotel","7","17","135","364","0","0","135","364","10"
"1","2018","31","Otros","15","27","69","162","0","0","69","162","1.4222222222222"
"1","2018","31","Otros","12","35","26","38","35","42","61","80","3.5"
"1","2018","31","Otros","12","35","27","36","232","310","259","346","3.5"
"1","2018","23","Otros","3","7","5","7","0","0","5","7","2"
"1","2018","31","Otros","10","11","40","67","8","13","48","80","11.764705882353"
"1","2018","31","Otros","12","24","5","16","31","56","36","72","9.2"
"1","2018","31","Otros","10","23","59","62","0","0","59","62","7"
"1","2018","31","Otros","7","27","16","37","0","0","16","37","4.8333333333333"
"1","2018","31","","10","18","9","15","1","1","10","16","1"
"1","2018","31","Otros","10","18","43","158","7","7","50","165","4.6"
"1","2018","31","Otros","8","2","15","15","2","2","17","17","1"
"1","2018","31","Otros","16","27","4","4","0","0","4","4","13.818181818182"
"1","2018","22","Hotel","2","29","0","0","28","94","28","94","1"
"1","2018","31","Otros","14","27","10","10","0","0","10","10","11.833333333333"
"1","2018","31","Otros","11","32","37","155","5","13","42","168","2.2857142857143"
"1","2018","31","Otros","16","19","112","460","0","0","112","460","1"
"1","2018","31","Otros","16","27","51","104","0","0","51","104","13.818181818182"
"1","2018","31","Otros","8","3","56","426","22","122","78","548","10"
"1","2018","31","Otros","16","27","200","379","0","0","200","379","13.818181818182"
"1","2018","31","Otros","16","20","66","236","41","160","107","396","3.0769230769231"
"1","2018","31","Otros","11","36","19","35","0","0","19","35","3.25"
"1","2018","31","Otros","8","2","46","79","23","29","69","108","1"
"1","2018","31","Otros","16","40","130","433","52","167","182","600","28.142857142857"
"1","2018","31","Hotel","11","36","95","167","23","35","118","202","2.375"
"1","2018","31","Otros","7","17","64","333","0","0","64","333","3"
"1","2018","31","Otros","6","10","115","192","0","0","115","192","3.8518518518518"
"1","2018","31","Otros","7","38","182","572","30","94","212","666","2.75"
"1","2018","31","Otros","13","14","80","123","5","10","85","133","7.3846153846154"
"1","2018","31","Otros","9","30","37","38","0","0","37","38","2.3333333333333"
"1","2018","31","Otros","13","27","31","129","0","0","31","129","12.2"
"1","2018","31","Otros","10","27","34","86","14","17","48","103","4.84"
"1","2018","31","Otros","6","25","73","84","87","111","160","195","2.3846153846154"
"1","2018","31","Otros","9","26","29","509","0","0","29","509","3.8888888888889"
"1","2018","31","Otros","10","18","25","98","49","225","74","323","10.25"
"1","2018","31","Otros","2","29","35","115","0","0","35","115","3.28"
"1","2018","31","Otros","6","25","94","236","0","0","94","236","2.3846153846154"
"1","2018","31","Otros","6","25","9","9","0","0","9","9","1"
"1","2018","31","Otros","6","27","172","334","0","0","172","334","3.6666666666667"
"1","2018","31","Otros","5","9","10","22","9","12","19","34","4.0454545454545"
"1","2018","31","Otros","5","9","93","134","34","49","127","183","4.0454545454545"
"1","2018","31","Hotel","9","37","26","68","3","9","29","77","3.4"
"1","2018","31","Hotel","7","38","201","447","59","133","260","580","1"
"1","2018","31","Otros","7","27","72","83","0","0","72","83","4.8333333333333"
"1","2018","31","Otros","5","9","15","15","0","0","15","15","4.0454545454545"
"1","2018","31","Otros","10","27","9","10","23","29","32","39","4.84"
"1","2018","31","Otros","7","27","31","31","0","0","31","31","4.8333333333333"
"1","2018","31","Otros","16","40","38","68","45","91","83","159","28.142857142857"
"1","2018","31","Otros","10","23","33","33","7","7","40","40","7"
"1","2018","31","Otros","15","16","75","362","19","80","94","442","9"
"1","2018","31","Otros","3","7","6","12","56","149","62","161","2"
"1","2018","31","Otros","7","17","46","128","6","20","52","148","17.166666666667"
"1","2018","31","Otros","8","27","54","163","45","45","99","208","9.4"
"1","2018","28","Otros","11","36","102","185","11","17","113","202","3.25"
"1","2018","31","Otros","9","22","55","405","0","0","55","405","7.6428571428571"
"1","2018","31","Otros","16","19","29","78","0","0","29","78","10.263157894737"
"1","2018","31","Otros","13","14","148","268","5","5","153","273","1"
"1","2018","31","Otros","5","9","25","61","14","46","39","107","5.5"
"1","2018","0","","15","27","0","0","0","0","0","0","1"
"1","2018","31","Hotel","16","19","72","171","0","0","72","171","1"
"1","2018","31","Hotel","10","11","55","55","39","39","94","94","5.6666666666667"
"1","2018","31","Otros","2","27","0","0","3","3","3","3","3.2"
"1","2018","31","Otros","8","2","83","116","74","101","157","217","6.4285714285714"
"1","2018","31","Otros","5","5","11","12","2","2","13","14","3.65625"
"1","2018","31","Otros","12","35","8","10","47","68","55","78","3.5"
"1","2018","31","Otros","8","3","22","61","68","200","90","261","10"
"1","2018","31","Otros","12","24","3","5","197","345","200","350","9.2"
"1","2018","31","Otros","11","32","88","386","8","24","96","410","2.2857142857143"
"1","2018","31","Otros","10","27","124","245","194","392","318","637","4.84"
"1","2018","31","Hotel","9","22","92","233","0","0","92","233","1"
"1","2018","30","Otros","11","15","71","305","10","40","81","345","2.3571428571429"
"1","2018","31","Otros","5","8","24","45","2","2","26","47","5"
"1","2018","31","Otros","14","27","36","36","1","1","37","37","11.833333333333"
"1","2018","31","Otros","13","27","346","535","0","0","346","535","12.2"
"1","2018","31","Otros","13","33","69","136","0","0","69","136","1"
"1","2018","31","Hotel","10","18","154","154","291","291","445","445","3.2"
"1","2018","31","Otros","6","25","168","246","0","0","168","246","1"
"1","2018","31","Otros","13","14","18","20","0","0","18","20","3.25"
"1","2018","0","Otros","10","23","0","0","0","0","0","0","1"
"1","2018","31","Otros","10","27","36","36","41","41","77","77","4.84"
"1","2018","31","Otros","13","14","34","263","4","8","38","271","3.25"
"1","2018","31","Otros","10","11","92","242","12","18","104","260","1"
"1","2018","31","Otros","15","16","11","33","0","0","11","33","1"
"1","2018","31","Otros","11","32","53","60","0","0","53","60","1"
"1","2018","31","Otros","9","37","17","40","0","0","17","40","4.5"
"1","2018","31","Otros","12","35","61","75","295","355","356","430","3.5"
"1","2018","31","Otros","8","34","94","153","57","93","151","246","5.75"
"1","2018","31","Hotel","16","40","12","16","75","158","87","174","16.333333333333"
"1","2018","31","Hotel","10","11","77","185","20","44","97","229","5.6666666666667"
"1","2018","31","Otros","7","27","14","23","0","0","14","23","4.8333333333333"
"1","2018","31","Hotel","7","38","19","191","0","0","19","191","1"
"1","2018","31","Otros","6","27","1","1","0","0","1","1","3.960088691796"
"1","2018","31","Otros","6","10","83","301","0","0","83","301","3.8518518518518"
"1","2018","31","Otros","6","25","348","884","0","0","348","884","1"
"1","2018","15","Otros","6","25","10","15","1","3","11","18","2.3846153846154"
"1","2018","31","Otros","6","27","8","248","0","0","8","248","3.960088691796"
"1","2018","23","Otros","6","10","88","114","0","0","88","114","1"
"1","2018","31","Otros","6","25","141","310","5","35","146","345","1"
"1","2018","31","Otros","6","27","237","600","7","19","244","619","3.960088691796"
"1","2018","31","Otros","5","5","21","40","30","43","51","83","3.65625"
"1","2018","31","Otros","5","5","12","20","0","0","12","20","3.65625"
"1","2018","31","Otros","5","8","61","89","27","47","88","136","9"
"1","2018","31","Otros","10","23","18","26","2","2","20","28","1"
"1","2018","31","Otros","3","4","80","152","16","32","96","184","12.2"
"1","2018","31","Otros","10","23","17","38","136","217","153","255","1"
"1","2018","31","Otros","10","23","24","63","7","14","31","77","7"
"1","2018","31","Otros","8","3","18","156","0","0","18","156","10"
"1","2018","31","Otros","13","14","11","18","5","35","16","53","3.25"
"1","2018","31","Otros","5","5","27","60","25","31","52","91","3.65625"
"1","2018","31","Otros","5","8","45","60","19","25","64","85","5"
"1","2018","31","Otros","6","10","69","118","51","102","120","220","3.8518518518518"
"1","2018","31","Otros","16","19","41","162","0","0","41","162","10.263157894737"
"1","2018","31","Otros","10","18","77","262","28","72","105","334","4.6"
"1","2018","31","Otros","11","15","47","125","24","72","71","197","2.3571428571429"
"1","2018","31","Otros","7","38","131","174","4","4","135","178","2.75"
"1","2018","31","Otros","11","32","217","494","48","73","265","567","2.2857142857143"
"1","2018","31","Otros","8","2","74","140","8","8","82","148","6.4285714285714"
"1","2018","31","Otros","10","27","32","82","17","31","49","113","4.84"
"1","2018","31","Otros","6","27","68","148","0","0","68","148","3.960088691796"
"1","2018","31","Otros","6","28","28","52","0","0","28","52","1"
"1","2018","31","Otros","13","14","78","189","0","0","78","189","1"
"1","2018","31","Otros","11","32","58","97","4","8","62","105","2.2857142857143"
"1","2018","31","Otros","8","34","26","29","56","82","82","111","5.75"
"1","2018","31","Otros","11","32","24","31","0","0","24","31","2.2857142857143"
"1","2018","31","Otros","10","18","20","22","18","20","38","42","4.6"
"1","2018","31","Otros","10","11","14","18","14","18","28","36","11.764705882353"
"1","2018","31","Otros","11","32","35","64","11","14","46","78","2.2857142857143"
"1","2018","31","Otros","14","31","0","0","16","22","16","22","20.2"
"1","2018","31","Hotel","8","3","186","383","89","214","275","597","1"
"1","2018","31","Hotel","14","31","99","217","677","2476","776","2693","17.4"
"1","2018","31","Otros","11","36","405","649","55","78","460","727","5.1904761904762"
"1","2018","31","Hotel","15","16","1412","3054","290","625","1702","3679","2"
"1","2018","31","Otros","15","27","26","32","8","8","34","40","1.4222222222222"
"1","2018","31","Otros","5","5","17","29","25","40","42","69","3.65625"
"1","2018","31","Otros","8","34","10","10","6","6","16","16","5.75"
"1","2018","31","Otros","13","14","14","30","0","0","14","30","3.25"
"1","2018","31","Otros","7","27","36","51","0","0","36","51","4.8333333333333"
"1","2018","31","Otros","12","35","6","9","21","29","27","38","3.5"
"1","2018","31","Otros","5","5","66","139","5","10","71","149","3.65625"
"1","2018","31","Otros","10","11","4","12","0","0","4","12","11.764705882353"
"1","2018","31","Otros","10","11","2","3","0","0","2","3","11.764705882353"
"1","2018","31","Otros","9","30","6","135","0","0","6","135","2.3333333333333"
"1","2018","31","Otros","8","2","12","48","0","0","12","48","6.4285714285714"
"1","2018","31","Otros","10","27","76","114","112","173","188","287","4.84"
"1","2018","31","Otros","5","9","0","0","12","36","12","36","4.0454545454545"
"1","2018","31","Otros","10","27","98","117","67","81","165","198","3"
"1","2018","31","Otros","6","27","14","34","6","42","20","76","3.960088691796"
"1","2018","31","Otros","6","10","138","316","14","50","152","366","3.8518518518518"
"1","2018","31","Otros","6","10","95","249","0","0","95","249","3.8518518518518"
"1","2018","31","Otros","6","27","29","34","0","0","29","34","3.960088691796"
"1","2018","20","Otros","6","12","10","28","0","0","10","28","1.8256578947368"
"1","2018","31","Otros","6","10","71","302","0","0","71","302","3.8518518518518"
"1","2018","31","Otros","6","10","41","66","0","0","41","66","3.8518518518518"
"1","2018","31","Otros","6","27","10","20","0","0","10","20","3.960088691796"
"1","2018","31","Otros","6","12","97","181","4","8","101","189","1.8256578947368"
"1","2018","31","Otros","6","10","10","10","0","0","10","10","3.8518518518518"
"1","2018","31","Hotel","6","25","124","279","0","0","124","279","1"
"1","2018","31","Otros","6","10","32","108","0","0","32","108","1"
"1","2018","31","Otros","6","27","8","8","0","0","8","8","3.960088691796"
"1","2018","31","Otros","5","9","27","39","34","39","61","78","4.0454545454545"
"1","2018","31","Otros","5","5","76","161","54","113","130","274","3.65625"
"1","2018","31","Otros","5","5","24","32","0","0","24","32","3.65625"
"1","2018","31","Otros","5","5","96","192","35","76","131","268","3.65625"
"1","2018","31","Otros","5","9","96","139","39","50","135","189","5.5"
"1","2018","31","Otros","11","36","60","280","0","0","60","280","5.1904761904762"
"1","2018","31","Otros","10","27","0","0","3","3","3","3","3"
"1","2018","31","Otros","10","11","53","65","0","0","53","65","1"
"1","2018","31","Hotel","6","10","1061","2548","51","103","1112","2651","1"
"1","2018","31","Otros","5","9","29","43","3","3","32","46","4.0454545454545"
"1","2018","31","Otros","5","8","8","19","57","88","65","107","5"
"1","2018","0","Hotel","15","27","0","0","0","0","0","0","1"
"1","2018","31","Hotel","3","4","281","1742","18","46","299","1788","3"
"1","2018","31","Otros","3","7","5","5","23","23","28","28","1"
"1","2018","31","Otros","7","38","161","439","3","12","164","451","2.75"
"1","2018","31","Hotel","10","27","130","151","135","195","265","346","1"
"1","2018","31","Hotel","12","35","13","13","354","584","367","597","1.7272727272727"
"1","2018","31","Hotel","10","27","10","15","0","0","10","15","2.25"
"1","2018","31","Hotel","7","17","554","1223","170","412","724","1635","4"
"1","2018","7","Hotel","16","19","16","16","2","4","18","20","4"
"1","2018","31","Hotel","2","6","596","1554","0","0","596","1554","2.2"
"1","2018","31","Otros","5","5","112","494","51","198","163","692","3.65625"
"1","2018","31","Hotel","10","18","118","144","352","358","470","502","1"
"1","2018","31","Otros","12","24","69","90","182","231","251","321","9.2"
"1","2018","31","Otros","5","8","22","29","16","20","38","49","5"
"1","2018","31","Otros","4","13","204","235","7","10","211","245","1"
"1","2018","31","Otros","10","11","244","244","0","0","244","244","11.764705882353"
"1","2018","31","Otros","12","35","124","174","347","471","471","645","3.5"
"1","2018","31","Otros","10","23","180","201","18","22","198","223","7"
"1","2018","31","Otros","11","36","744","1537","302","623","1046","2160","5.1904761904762"
"1","2018","31","Otros","12","35","49","81","341","412","390","493","3.5"
"1","2018","31","Otros","11","36","56","150","4","8","60","158","5.1904761904762"
"1","2018","31","Otros","8","2","61","193","12","53","73","246","6.4285714285714"
"1","2018","31","Otros","9","30","127","343","0","0","127","343","2.3333333333333"
"1","2018","31","Otros","11","36","188","346","38","144","226","490","5.1904761904762"
"1","2018","31","Otros","6","10","117","251","0","0","117","251","3.8518518518518"
"1","2018","31","Otros","10","18","52","148","21","98","73","246","10.25"
"1","2018","31","Otros","10","11","38","97","0","0","38","97","1"
"1","2018","31","Otros","7","27","17","124","5","12","22","136","4.8333333333333"
"1","2018","31","Otros","16","20","32","128","7","28","39","156","1"
"1","2018","31","Otros","9","22","85","155","0","0","85","155","7.6428571428571"
"1","2018","31","Otros","15","16","222","758","0","0","222","758","1"
"1","2018","31","Otros","5","5","149","185","30","73","179","258","3.65625"
"1","2018","31","Otros","12","35","46","60","96","112","142","172","3.5"
"1","2018","31","Otros","10","11","11","13","0","0","11","13","11.764705882353"
"1","2018","31","Otros","10","11","8","12","0","0","8","12","11.764705882353"
"1","2018","26","Otros","5","9","53","94","10","11","63","105","4.0454545454545"
"1","2018","31","Otros","5","5","10","310","0","0","10","310","3.65625"
"1","2018","31","Otros","10","11","73","95","53","77","126","172","1"
"1","2018","31","Otros","12","35","20","58","62","125","82","183","3.5"
"1","2018","31","Otros","7","38","118","284","33","88","151","372","2.75"
"1","2018","31","Hotel","12","35","19","38","274","490","293","528","1.7272727272727"
"1","2018","31","Otros","13","14","92","138","0","0","92","138","1"
"1","2018","31","Otros","5","5","50","80","31","45","81","125","3.65625"
"1","2018","31","Otros","8","3","96","235","17","56","113","291","14.75"
"1","2018","31","Hotel","9","26","7","14","0","0","7","14","1.5"
"1","2018","31","Hotel","16","19","135","135","0","0","135","135","1"
"1","2018","31","Otros","9","22","129","186","0","0","129","186","3.25"
"1","2018","31","Otros","16","19","75","99","0","0","75","99","10.263157894737"
"1","2018","31","Otros","9","30","36","151","1","1","37","152","2.3333333333333"
"1","2018","31","Otros","16","19","7","8","0","0","7","8","10.263157894737"
"1","2018","31","Otros","16","19","183","558","0","0","183","558","10.263157894737"
"1","2018","31","Otros","9","26","4","7","0","0","4","7","3.8888888888889"
"1","2018","31","Otros","16","40","4","7","1","1","5","8","28.142857142857"
"1","2018","31","Hotel","16","27","16","31","5","5","21","36","5.8571428571429"
"1","2018","31","Otros","16","19","52","160","0","0","52","160","10.263157894737"
"1","2018","31","Otros","16","19","164","384","0","0","164","384","10.263157894737"
"1","2018","31","","9","30","16","89","6","10","22","99","1"
"1","2018","31","Otros","16","19","55","149","0","0","55","149","10.263157894737"
"1","2018","31","Otros","10","11","12","12","7","7","19","19","11.764705882353"
"1","2018","31","Otros","11","36","23","23","0","0","23","23","5.1904761904762"
"1","2018","31","Otros","16","19","10","46","0","0","10","46","10.263157894737"
"1","2018","31","Otros","16","19","252","568","0","0","252","568","1.3333333333333"
"1","2018","31","Otros","16","19","98","144","0","0","98","144","10.263157894737"
"1","2018","31","Otros","10","18","18","48","90","202","108","250","10.25"
"1","2018","31","Otros","16","19","143","437","0","0","143","437","10.263157894737"
"1","2018","31","Otros","16","19","83","110","0","0","83","110","1.3333333333333"
"1","2018","31","","9","26","272","1187","0","0","272","1187","1"
"1","2018","31","Otros","16","19","17","29","0","0","17","29","10.263157894737"
"1","2018","31","Otros","16","19","65","95","5","7","70","102","10.263157894737"
"1","2018","31","Hotel","8","2","399","785","92","177","491","962","1"
"1","2018","31","Otros","6","10","106","242","0","0","106","242","3.8518518518518"
"1","2018","31","Otros","6","25","350","831","0","0","350","831","1"
"1","2018","31","Otros","6","12","223","319","0","0","223","319","1.8256578947368"
"1","2018","31","Hotel","16","19","48","82","34","48","82","130","1"
"1","2018","31","Otros","3","7","0","0","28","28","28","28","2"
"1","2018","31","Hotel","2","6","814","2429","363","603","1177","3032","1"
"1","2018","31","Hotel","3","4","672","905","85","112","757","1017","2.6"
"1","2018","31","Hotel","16","40","2167","3396","2477","4103","4644","7499","1"
"1","2018","31","Otros","16","27","156","292","3","63","159","355","13.818181818182"
"1","2018","30","Hotel","6","28","248","375","93","103","341","478","2.4"
"1","2018","31","Hotel","8","34","2142","3170","558","967","2700","4137","1"
"1","2018","31","Otros","12","35","24","24","12","14","36","38","2.6666666666667"
"1","2018","31","Otros","9","30","12","14","0","0","12","14","2.3333333333333"
"1","2018","31","Hotel","10","18","109","109","212","212","321","321","1"
"1","2018","31","Hotel","9","30","113","285","1","2","114","287","1"
"1","2018","31","Hotel","15","27","51","85","6","6","57","91","1"
"1","2018","31","Hotel","9","22","83","309","0","0","83","309","2.5555555555556"
"1","2018","31","","11","15","409","974","0","0","409","974","1"
"1","2018","31","Otros","6","12","17","35","4","12","21","47","1.8256578947368"
"1","2018","31","Otros","6","28","0","0","24","744","24","744","1"
"1","2018","31","Hotel","15","27","30","930","0","0","30","930","1"
"1","2018","31","Otros","15","27","74","119","0","0","74","119","1.4222222222222"
"1","2018","31","Otros","15","27","7","217","0","0","7","217","1.4222222222222"
"1","2018","31","Otros","12","35","14","18","10","10","24","28","2.6666666666667"
"1","2018","31","Otros","2","1","16","16","12","12","28","28","1"
"1","2018","31","Otros","12","24","10","12","7","11","17","23","9.2"
"1","2018","31","Otros","5","5","27","42","37","81","64","123","3.65625"
"1","2018","31","Otros","6","28","278","332","18","20","296","352","1"
"1","2018","31","Hotel","7","27","193","225","110","110","303","335","1"
"1","2018","31","Otros","16","20","191","422","13","30","204","452","3.0769230769231"
"1","2018","31","Otros","10","11","0","0","0","0","0","0","1"
"1","2018","31","","10","11","203","337","34","61","237","398","1"
"1","2018","31","Hotel","16","40","82","125","31","71","113","196","16.333333333333"
"1","2018","31","Otros","12","35","27","30","4","6","31","36","3.5"
"1","2018","31","Hotel","6","27","45","54","2","2","47","56","3"
"1","2018","31","Otros","5","5","25","43","22","48","47","91","3.65625"
"1","2018","31","Hotel","6","27","107","111","12","12","119","123","3"
"1","2018","31","Otros","6","25","62","140","2","2","64","142","2.3846153846154"
"1","2018","31","Otros","9","37","34","57","0","0","34","57","19"
"1","2018","0","Hotel","15","27","0","0","0","0","0","0","1"
"1","2018","31","Otros","16","19","275","424","6","18","281","442","1"
"1","2018","31","Otros","5","9","43","44","67","71","110","115","4.0454545454545"
"1","2018","31","Hotel","15","27","60","60","0","0","60","60","1"
"1","2018","31","Hotel","5","9","33","75","5","10","38","85","1"
"1","2018","31","Hotel","8","34","89","188","0","0","89","188","2.5714285714286"
"1","2018","0","Hotel","15","27","0","0","0","0","0","0","1"
"1","2018","31","Hotel","6","27","382","1376","0","0","382","1376","3"
"1","2018","31","Otros","6","27","52","320","0","0","52","320","1"
"1","2018","31","Hotel","7","17","73","158","11","11","84","169","1"
"1","2018","31","Otros","12","27","3","3","10","10","13","13","3.4285714285714"
"1","2018","31","Hotel","12","35","133","258","1382","2626","1515","2884","1"
"1","2018","31","Hotel","2","27","404","447","496","527","900","974","1"
"1","2018","31","Hotel","10","27","24","76","151","412","175","488","1"
"1","2018","30","Hotel","2","6","435","435","0","0","435","435","1"
"1","2018","31","Otros","2","6","32","72","0","0","32","72","1"
"1","2018","31","Hotel","4","39","139","139","0","0","139","139","1"
"1","2018","31","Otros","16","27","95","325","0","0","95","325","1"
"1","2018","31","Hotel","6","10","703","798","120","126","823","924","1"
"1","2018","31","Hotel","8","3","12","22","215","665","227","687","1"
"1","2018","31","Otros","5","8","36","47","112","128","148","175","5"
"1","2018","0","Hotel","13","33","0","0","0","0","0","0","1"
"1","2018","31","Hotel","13","33","103","206","24","48","127","254","1"
"1","2018","31","Otros","11","32","146","422","97","241","243","663","2.2857142857143"
"1","2018","31","Hotel","9","26","366","578","236","308","602","886","1"
"1","2018","31","Hotel","16","20","150","263","27","71","177","334","1"
"1","2018","31","Hotel","9","37","143","422","0","0","143","422","1"
"1","2018","31","Otros","16","20","9","16","15","15","24","31","3.0769230769231"
"1","2018","31","","16","40","794","2390","161","1144","955","3534","1"
"1","2018","31","Hotel","12","24","18","34","3081","5774","3099","5808","1"
"1","2018","31","Hotel","15","16","1494","4013","674","3517","2168","7530","1"
"1","2018","31","Hotel","5","9","23","38","100","149","123","187","1"
"1","2018","31","Otros","7","38","134","299","23","27","157","326","2.75"
"1","2018","31","Otros","2","6","2388","2388","0","0","2388","2388","1"
"1","2018","31","Otros","2","6","104","355","0","0","104","355","1"
"1","2018","31","Hotel","12","24","273","527","1511","3900","1784","4427","1"
"1","2018","0","Hotel","8","34","0","0","0","0","0","0","1"
"1","2018","31","Hotel","15","27","269","1051","52","53","321","1104","1"
"1","2018","31","Otros","7","38","145","233","7","14","152","247","2.75"
"1","2018","31","Otros","2","1","20","71","7","18","27","89","1"
"1","2018","31","Otros","8","3","151","337","20","35","171","372","10"
"1","2018","31","Hotel","12","35","14","28","135","256","149","284","2"
"1","2018","31","Otros","11","36","23","64","0","0","23","64","5.1904761904762"
"1","2018","31","Otros","16","20","89","311","0","0","89","311","3.0769230769231"
"1","2018","31","Otros","8","3","334","633","0","0","334","633","1"
"1","2018","31","Otros","4","39","53","254","0","0","53","254","2.2222222222222"
"1","2018","31","Otros","5","5","212","345","89","179","301","524","3.65625"
"1","2018","31","Otros","12","27","1","1","22","24","23","25","3.4285714285714"
"1","2018","31","Otros","7","27","57","120","27","175","84","295","1"
"1","2018","31","Hotel","2","6","378","782","42","48","420","830","1"
"1","2018","31","Otros","12","24","14","32","61","115","75","147","1"
"1","2018","31","Hotel","14","27","59","194","139","373","198","567","1"
"1","2018","31","Hotel","16","19","298","664","0","0","298","664","1"
"1","2018","31","","2","1","13","182","0","0","13","182","1"
"1","2018","31","Hotel","2","27","61","114","15","20","76","134","1"
"1","2018","31","Otros","16","20","184","345","14","86","198","431","1"
"1","2018","31","Otros","13","14","50","115","0","0","50","115","1"
"1","2018","31","Hotel","11","36","143","316","15","25","158","341","2.375"
"1","2018","31","Otros","13","14","4","124","0","0","4","124","7.3846153846154"
"1","2018","31","Otros","12","27","47","67","0","0","47","67","3.4285714285714"
"1","2018","31","Hotel","2","6","200","433","55","61","255","494","2.2"
"1","2018","31","Otros","2","6","806","2418","0","0","806","2418","1"
"1","2018","31","Otros","10","27","19","73","0","0","19","73","4.84"
"1","2018","31","Otros","12","27","4","4","15","16","19","20","3.4285714285714"
"1","2018","31","Otros","13","14","74","74","0","0","74","74","7.3846153846154"
"1","2018","31","Otros","6","12","109","251","41","77","150","328","1.8256578947368"
"1","2018","31","Otros","2","6","668","1004","78","185","746","1189","1"
"1","2018","31","Hotel","16","40","90","93","63","67","153","160","1"
"1","2018","31","Hotel","12","35","13","35","5","8","18","43","1.7272727272727"
"1","2018","31","Otros","5","5","28","54","34","51","62","105","3.65625"
"1","2018","18","Otros","11","32","23","66","3","9","26","75","1"
"1","2018","31","Otros","9","30","0","0","5","155","5","155","2.3333333333333"
"1","2018","31","Otros","11","15","16","16","0","0","16","16","1"
"1","2018","0","Hotel","8","2","0","0","0","0","0","0","1"
"1","2018","31","Otros","9","30","12","12","0","0","12","12","2.3333333333333"
"1","2018","31","Otros","10","27","82","185","6","16","88","201","3"
"1","2018","31","Hotel","15","27","117","150","0","0","117","150","1"
"1","2018","31","Hotel","3","7","9","67","1","2","10","69","1"
"1","2018","31","Otros","6","12","278","422","0","0","278","422","1.8256578947368"
"1","2018","31","Otros","12","27","34","45","25","30","59","75","3.4285714285714"
"1","2018","31","Otros","2","6","39","56","0","0","39","56","5"
"1","2018","12","Otros","6","27","18","34","0","0","18","34","3.960088691796"
"1","2018","31","Hotel","10","11","69","182","16","28","85","210","1"
"1","2018","31","Otros","2","1","5","40","0","0","5","40","1"
"1","2018","31","Hotel","4","13","1","7","0","0","1","7","1"
"1","2018","31","Otros","11","36","97","162","3","3","100","165","5.1904761904762"
"1","2018","31","Hotel","11","32","0","0","0","0","0","0","1"
"1","2018","0","Otros","2","27","0","0","0","0","0","0","1"
"1","2018","31","Otros","12","27","16","20","10","12","26","32","3.4285714285714"
"1","2018","31","Hotel","8","2","46","66","14","14","60","80","3"
"1","2018","31","Hotel","16","20","139","147","1","3","140","150","1"
"1","2018","31","Otros","12","35","28","50","86","146","114","196","3.5"
"1","2018","31","Otros","13","14","160","416","0","0","160","416","1"
"1","2018","31","Hotel","16","19","63","182","0","0","63","182","1"
"1","2018","31","Otros","2","27","44","133","0","0","44","133","3.2"
"1","2018","31","Hotel","6","27","17","17","0","0","17","17","3"
"1","2018","31","Hotel","8","3","167","546","89","230","256","776","4.1111111111111"
"1","2018","31","Hotel","12","24","83","249","290","870","373","1119","1"
"1","2018","0","Hotel","15","27","0","0","0","0","0","0","1"
"1","2018","31","Otros","8","3","74","305","25","85","99","390","10"
"1","2018","31","Hotel","16","20","74","184","0","0","74","184","1"
"1","2018","31","Hotel","6","28","111","200","6","13","117","213","2.4"
"1","2018","31","Otros","7","17","81","240","2","8","83","248","3"
"1","2018","31","Otros","2","1","37","67","5","9","42","76","5.5"
"1","2018","31","Hotel","11","36","132","223","272","401","404","624","2.375"
"1","2018","31","Otros","4","13","369","1475","0","0","369","1475","1"
"1","2018","31","Hotel","12","35","128","243","127","232","255","475","2"
"1","2018","31","Otros","2","6","197","1479","0","0","197","1479","1"
"1","2018","31","Otros","8","34","236","263","129","199","365","462","5.75"
"1","2018","31","Hotel","11","15","33","310","0","0","33","310","1"
"1","2018","31","Otros","12","27","84","168","46","92","130","260","1"
"1","2018","31","Otros","15","27","4","4","0","0","4","4","1.4222222222222"
"1","2018","31","Otros","16","40","8","11","41","106","49","117","1"
"1","2018","31","Otros","12","27","5","5","3","3","8","8","1"
"1","2018","31","Hotel","13","14","309","459","24","42","333","501","1"
"1","2018","31","Otros","3","4","43","43","26","26","69","69","1"
"1","2018","31","Hotel","13","14","294","538","51","101","345","639","1"
"1","2018","31","Hotel","9","30","130","218","13","26","143","244","1"
"1","2018","31","Hotel","4","13","201","370","112","145","313","515","5.4"
"1","2018","31","Otros","6","27","10","18","0","0","10","18","3.960088691796"
"1","2018","0","Hotel","15","27","0","0","0","0","0","0","1"
"1","2018","31","Hotel","2","29","9","35","56","260","65","295","2"
"1","2018","31","Hotel","13","33","34","52","56","59","90","111","2"
"1","2018","31","Hotel","12","35","103","210","377","646","480","856","1.7272727272727"
"1","2018","31","Hotel","13","14","271","442","14","37","285","479","1"
"1","2018","31","Otros","6","25","65","130","0","0","65","130","2.3846153846154"
"1","2018","31","Hotel","8","2","111","165","28","71","139","236","3"
"1","2018","31","Otros","2","29","17","52","55","221","72","273","1"
"1","2018","31","Otros","4","39","58","125","0","0","58","125","2.2222222222222"
"1","2018","31","Otros","6","12","146","176","40","83","186","259","1.8256578947368"
"1","2018","31","Otros","13","33","123","264","11","26","134","290","1"
"1","2018","31","Otros","13","33","45","69","26","30","71","99","5.125"
"1","2018","31","Hotel","4","13","175","336","77","160","252","496","5.4"
"1","2018","31","Otros","12","24","27","181","54","118","81","299","1"
"1","2018","31","Hotel","7","27","162","194","0","0","162","194","4.1666666666667"
"1","2018","31","Hotel","4","13","661","1869","155","327","816","2196","1"
"1","2018","31","","5","8","21","33","19","34","40","67","1"
"1","2018","31","Otros","8","2","46","165","2","6","48","171","6.4285714285714"
"1","2018","31","Otros","6","27","199","650","0","0","199","650","3.6666666666667"
"1","2018","31","Otros","2","6","41","41","27","27","68","68","1"
"1","2018","31","","6","10","222","452","0","0","222","452","1"
"1","2018","31","Hotel","2","29","58","80","119","175","177","255","2"
"1","2018","31","","14","31","110","147","554","1692","664","1839","1"
"1","2018","31","Hotel","16","27","7820","23462","0","0","7820","23462","1"
"1","2018","31","Hotel","12","35","85","111","55","63","140","174","1.7272727272727"
"1","2018","31","","12","35","1580","1842","4831","5515","6411","7357","1"
"1","2018","31","","9","26","151","176","24","30","175","206","1"
"1","2018","31","Otros","11","32","147","373","0","0","147","373","2.2857142857143"
"1","2018","31","Otros","12","24","91","179","101","196","192","375","9.2"
"1","2018","31","Hotel","6","25","33","93","0","0","33","93","1"
"1","2018","31","Otros","7","17","40","204","0","0","40","204","3"
"1","2018","31","Otros","11","32","77","305","9","21","86","326","2.2857142857143"
"1","2018","31","Hotel","16","19","80","101","8","17","88","118","4"
"1","2018","31","Otros","8","3","51","185","29","47","80","232","14.75"
"1","2018","31","Hotel","7","17","8","10","0","0","8","10","1"
"1","2018","31","Otros","13","33","113","131","15","19","128","150","5.125"
"1","2018","31","Otros","16","27","16","68","2","19","18","87","13.818181818182"
"1","2018","31","Otros","6","12","108","212","14","35","122","247","1.8256578947368"
"1","2018","31","Otros","2","29","6","18","10","44","16","62","3.28"
"1","2018","31","Hotel","14","27","474","572","333","409","807","981","1"
"1","2018","31","Otros","2","1","1","1","0","0","1","1","1"
"1","2018","31","Otros","11","32","66","76","0","0","66","76","2.2857142857143"
"1","2018","31","Otros","2","27","61","64","0","0","61","64","1"
"1","2018","31","Hotel","2","29","160","320","107","243","267","563","1"
"1","2018","31","Hotel","4","13","49","495","0","0","49","495","3.2"
"1","2018","31","Hotel","4","21","36","156","10","22","46","178","3"
"1","2018","31","Otros","7","27","58","68","2","4","60","72","4.8333333333333"
"1","2018","31","","3","4","112","277","38","80","150","357","1"
"1","2018","31","Hotel","6","27","32","33","20","27","52","60","3"
"1","2018","31","Otros","16","19","71","125","0","0","71","125","10.263157894737"
"1","2018","31","Otros","11","32","48","162","2","2","50","164","2.2857142857143"
"1","2018","31","Otros","3","7","62","88","68","120","130","208","2"
"1","2018","31","Otros","5","5","49","92","25","43","74","135","3.65625"
"1","2018","24","Otros","15","27","1198","1948","0","0","1198","1948","1.4222222222222"
"1","2018","31","Otros","6","25","273","593","8","13","281","606","2.3846153846154"
"1","2018","31","","10","27","127","197","36","54","163","251","1"
"1","2018","31","Otros","2","29","54","97","163","245","217","342","3.28"
"1","2018","31","Otros","12","35","6","6","48","48","54","54","3.5"
"1","2018","31","Otros","16","19","58","73","0","0","58","73","10.263157894737"
"1","2018","31","Otros","9","26","110","141","4","4","114","145","3.8888888888889"
"1","2018","31","Hotel","13","33","34","46","11","11","45","57","2"
"1","2018","31","Otros","11","32","66","255","16","32","82","287","2.2857142857143"
"1","2018","31","Otros","9","22","35","53","0","0","35","53","7.6428571428571"
"1","2018","31","Otros","6","27","32","135","0","0","32","135","3.960088691796"
"1","2018","31","Otros","15","27","7","7","0","0","7","7","1.4222222222222"
"1","2018","31","Otros","11","32","160","165","33","33","193","198","2.2857142857143"
"1","2018","31","Otros","11","15","51","64","0","0","51","64","2.3571428571429"
"1","2018","14","Otros","9","37","3","6","0","0","3","6","4.5"
"1","2018","31","Otros","5","9","18","27","25","30","43","57","4.0454545454545"
"1","2018","31","Hotel","10","27","49","600","0","0","49","600","2.25"
"1","2018","31","Otros","6","28","28","90","2","10","30","100","4.65"
"1","2018","31","Otros","4","13","24","35","18","20","42","55","3.4"
"1","2018","31","Otros","2","1","1","1","0","0","1","1","1"
"1","2018","31","Otros","2","29","55","105","78","148","133","253","3.28"
"1","2018","31","Hotel","8","3","128","317","40","61","168","378","4.1111111111111"
"1","2018","31","Otros","16","19","279","1392","0","0","279","1392","1.3333333333333"
"1","2018","31","Otros","12","35","17","18","73","98","90","116","3.5"
"1","2018","31","Hotel","12","35","20","36","307","418","327","454","1.7272727272727"
"1","2018","31","Otros","12","35","19","47","70","111","89","158","3.5"
"1","2018","31","Otros","2","29","48","158","123","346","171","504","3.28"
"1","2018","31","Hotel","7","27","198","292","19","19","217","311","1"
"1","2018","31","Hotel","9","22","48","64","2","5","50","69","2.5555555555556"
"1","2018","31","Hotel","12","35","37","67","222","360","259","427","1.7272727272727"
"1","2018","31","Otros","15","16","140","286","48","136","188","422","2"
"1","2018","31","Hotel","15","27","12","24","2","4","14","28","1"
"1","2018","31","Otros","4","13","69","71","17","17","86","88","3.4"
"1","2018","31","Hotel","8","34","120","195","49","87","169","282","2.5714285714286"
"1","2018","31","Hotel","16","20","12","60","0","0","12","60","1"
"1","2018","31","Hotel","6","28","141","231","44","90","185","321","2.4"
"1","2018","31","Hotel","15","27","83","153","40","78","123","231","1"
"1","2018","31","Otros","12","35","172","373","140","295","312","668","3.5"
"1","2018","31","Otros","11","15","57","63","2","3","59","66","2.3571428571429"
"1","2018","31","Otros","11","15","126","514","5","60","131","574","2.3571428571429"
"1","2018","31","Otros","11","36","100","222","114","210","214","432","5.1904761904762"
"1","2018","31","Hotel","11","36","80","178","10","16","90","194","2.375"
"1","2018","31","Hotel","6","12","130","302","0","0","130","302","5"
"1","2018","31","Otros","8","3","110","216","56","94","166","310","10"
"1","2018","31","Otros","10","27","17","27","34","55","51","82","4.84"
"1","2018","31","Otros","8","3","30","141","5","5","35","146","10"
"1","2018","31","Otros","6","25","90","286","0","0","90","286","2.3846153846154"
"1","2018","31","Hotel","2","27","70","142","0","0","70","142","1"
"1","2018","31","Hotel","10","18","118","343","187","561","305","904","3.2"
"1","2018","31","Otros","11","32","189","942","12","28","201","970","1"
"1","2018","31","Hotel","6","10","3030","3738","541","877","3571","4615","1"
"1","2018","31","Otros","4","13","293","311","56","58","349","369","1"
"1","2018","31","Otros","11","32","89","428","26","88","115","516","2.2857142857143"
"1","2018","0","Otros","2","27","0","0","0","0","0","0","1"
"1","2018","0","Otros","4","13","0","0","0","0","0","0","1"
"1","2018","31","","12","24","85","240","555","1504","640","1744","1"
"1","2018","31","Hotel","16","27","522","644","13","16","535","660","5.8571428571429"
"1","2018","31","Hotel","7","38","74","151","1","1","75","152","1"
"1","2018","31","Hotel","6","12","2569","2604","60","69","2629","2673","1"
"2","2018","28","Hotel","14","31","2153","3680","6415","8895","8568","12575","1"
"2","2018","28","Hotel","14","31","957","1266","2524","7384","3481","8650","1"
"2","2018","28","Hotel","14","31","692","1018","926","3052","1618","4070","1"
"2","2018","28","Hotel","11","32","125","217","85","173","210","390","1"
"2","2018","28","Hotel","14","27","3589","4869","732","997","4321","5866","1"
"2","2018","28","Otros","11","32","198","374","0","0","198","374","2.2857142857143"
"2","2018","28","Hotel","14","31","439","552","3107","4578","3546","5130","5.4"
"2","2018","28","Hotel","15","16","1589","4175","287","1125","1876","5300","1"
"2","2018","28","Hotel","14","31","929","1504","818","2487","1747","3991","5.4"
"2","2018","28","Hotel","12","24","2699","4580","4015","6834","6714","11414","1"
"2","2018","28","Hotel","16","40","1336","2672","567","1420","1903","4092","1"
"2","2018","28","Hotel","6","12","1626","1755","144","261","1770","2016","1"
"2","2018","28","Hotel","10","23","1543","1842","683","1297","2226","3139","1"
"2","2018","28","Hotel","14","31","1420","3590","291","735","1711","4325","5.4"
"2","2018","28","Hotel","3","4","1358","3307","219","526","1577","3833","1"
"2","2018","28","","11","32","860","1472","139","233","999","1705","1"
"2","2018","28","Hotel","6","12","399","868","36","80","435","948","1"
"2","2018","28","Hotel","6","12","2246","3355","359","492","2605","3847","1"
"2","2018","28","Hotel","9","26","3664","7387","125","219","3789","7606","1"
"2","2018","28","Hotel","2","1","254","1574","49","455","303","2029","1"
"2","2018","28","Hotel","9","26","2077","5707","772","2345","2849","8052","1"
"2","2018","28","Hotel","6","12","589","956","60","139","649","1095","1"
"2","2018","28","Hotel","14","31","47","60","4177","7278","4224","7338","5.4"
"2","2018","28","Hotel","11","32","737","1158","119","195","856","1353","1"
"2","2018","28","Hotel","2","6","1001","1295","94","121","1095","1416","1"
"2","2018","28","Hotel","16","40","1965","3793","1332","2520","3297","6313","1"
"2","2018","28","Hotel","14","27","1361","1924","705","1058","2066","2982","1"
"2","2018","28","Otros","11","36","696","1342","34","50","730","1392","1"
"2","2018","28","Hotel","10","23","1489","2950","1214","2345","2703","5295","1"
"2","2018","28","Hotel","14","31","182","489","618","3089","800","3578","7.8"
"2","2018","28","Hotel","7","17","610","1320","381","1015","991","2335","1"
"2","2018","28","Hotel","2","1","1749","2403","0","0","1749","2403","2"
"2","2018","28","Hotel","2","1","1182","1843","310","810","1492","2653","2"
"2","2018","28","Hotel","4","13","746","1197","131","209","877","1406","1"
"2","2018","28","Hotel","2","1","624","1161","85","354","709","1515","2"
"2","2018","28","Hotel","10","27","1449","5793","401","931","1850","6724","1"
"2","2018","28","Hotel","14","27","420","481","1766","1987","2186","2468","1"
"2","2018","28","Hotel","14","27","2172","2887","1243","1980","3415","4867","1"
"2","2018","28","Hotel","6","12","1841","2308","100","130","1941","2438","1"
"2","2018","28","Hotel","6","12","1454","2431","444","614","1898","3045","1"
"2","2018","28","Hotel","13","27","2965","8352","9","18","2974","8370","1"
"2","2018","28","Hotel","14","31","410","849","509","1333","919","2182","7.8"
"2","2018","28","Hotel","6","12","1476","4511","303","923","1779","5434","1"
"2","2018","28","Hotel","16","27","2671","5149","155","300","2826","5449","1"
"2","2018","28","","10","27","466","1076","47","65","513","1141","1"
"2","2018","28","Hotel","10","18","828","1982","723","1648","1551","3630","1"
"2","2018","28","Hotel","9","37","2060","3566","367","756","2427","4322","1"
"2","2018","28","Hotel","16","27","2526","10106","0","0","2526","10106","1"
"2","2018","28","Hotel","15","16","947","1702","155","504","1102","2206","2"
"2","2018","28","Hotel","2","1","1602","2684","304","508","1906","3192","2"
"2","2018","28","Hotel","3","4","664","1238","173","353","837","1591","1"
"2","2018","28","Hotel","16","40","369","512","1861","3434","2230","3946","1"
"2","2018","28","Hotel","7","17","4715","5464","679","770","5394","6234","1"
"2","2018","28","Hotel","12","24","896","1408","2961","3552","3857","4960","1"
"2","2018","28","Hotel","12","35","748","1634","2486","3685","3234","5319","1"
"2","2018","28","Hotel","2","6","356","921","65","74","421","995","1"
"2","2018","28","Hotel","13","33","658","683","310","446","968","1129","1"
"2","2018","28","Hotel","10","27","1295","1835","807","1111","2102","2946","1"
"2","2018","28","Hotel","10","23","1533","2734","315","559","1848","3293","1"
"2","2018","28","Hotel","11","36","1742","4001","696","971","2438","4972","1"
"2","2018","28","Hotel","8","34","1160","1818","141","332","1301","2150","1"
"2","2018","28","Hotel","2","6","477","1270","176","305","653","1575","1"
"2","2018","28","Hotel","14","31","473","724","1241","1732","1714","2456","7.8"
"2","2018","28","Hotel","11","36","2379","4407","172","310","2551","4717","1"
"2","2018","28","","10","27","86","148","431","984","517","1132","1"
"2","2018","28","Hotel","14","31","2547","3636","1968","4917","4515","8553","5.4"
"2","2018","28","Hotel","4","13","2407","2421","4","8","2411","2429","1"
"2","2018","28","Hotel","6","28","1517","1777","123","159","1640","1936","1"
"2","2018","28","Otros","14","31","176","222","172","329","348","551","2.8"
"2","2018","28","Otros","16","27","70","100","0","0","70","100","2"
"2","2018","28","Hotel","2","1","919","1588","101","159","1020","1747","2"
"2","2018","28","Hotel","10","18","1937","2331","819","1429","2756","3760","1"
"2","2018","28","Hotel","7","17","1082","1784","313","799","1395","2583","1"
"2","2018","28","Hotel","12","24","406","1296","950","2435","1356","3731","1"
"2","2018","28","Hotel","10","18","1764","3797","595","1038","2359","4835","1"
"2","2018","28","Hotel","2","1","1967","2225","23","39","1990","2264","1"
"2","2018","28","Hotel","10","18","2130","3539","0","0","2130","3539","1"
"2","2018","28","Hotel","6","28","1898","3141","421","614","2319","3755","1"
"2","2018","28","Hotel","5","5","552","2152","578","1035","1130","3187","1"
"2","2018","28","Hotel","4","13","247","477","60","107","307","584","1"
"2","2018","28","Hotel","10","18","1255","2242","872","1558","2127","3800","1"
"2","2018","28","Hotel","16","40","1566","2905","270","526","1836","3431","1"
"2","2018","28","Hotel","8","3","3569","8913","184","422","3753","9335","1"
"2","2018","28","Hotel","15","16","835","1553","183","464","1018","2017","2"
"2","2018","28","Hotel","14","31","16","60","464","1323","480","1383","7.8"
"2","2018","28","Hotel","13","33","732","872","615","747","1347","1619","1"
"2","2018","28","Hotel","15","16","443","1584","168","830","611","2414","2"
"2","2018","28","Otros","4","21","995","1927","19","46","1014","1973","1"
"2","2018","28","Hotel","6","10","816","1746","0","0","816","1746","1"
"2","2018","28","Hotel","16","19","939","2280","42","153","981","2433","1"
"2","2018","28","Hotel","16","27","1439","3544","4","8","1443","3552","1"
"2","2018","28","Hotel","10","11","3550","4246","190","355","3740","4601","1"
"2","2018","28","Otros","10","23","703","1955","48","155","751","2110","1"
"2","2018","28","Hotel","12","35","194","486","766","1507","960","1993","1"
"2","2018","28","Hotel","11","36","1088","2237","376","683","1464","2920","1"
"2","2018","28","Hotel","14","31","17","55","97","618","114","673","17.4"
"2","2018","28","Hotel","10","18","598","1607","767","1842","1365","3449","3.2"
"2","2018","28","Hotel","4","13","417","617","102","160","519","777","1"
"2","2018","28","Hotel","6","12","615","969","109","248","724","1217","5"
"2","2018","28","Hotel","6","10","996","1320","101","189","1097","1509","1"
"2","2018","28","Otros","5","5","428","683","171","304","599","987","3.65625"
"2","2018","28","Hotel","12","24","1066","1225","1334","1795","2400","3020","1"
"2","2018","28","Hotel","8","3","1493","3377","197","408","1690","3785","1"
"2","2018","28","Hotel","13","27","1005","2649","0","0","1005","2649","2.75"
"2","2018","28","Hotel","15","16","130","1168","32","440","162","1608","4"
"2","2018","28","Otros","15","16","224","567","158","574","382","1141","2"
"2","2018","28","Otros","16","20","930","2177","74","142","1004","2319","1"
"2","2018","28","Hotel","3","4","1578","3388","4","12","1582","3400","1"
"2","2018","28","Hotel","11","36","154","180","0","0","154","180","1"
"2","2018","28","Hotel","2","6","155","1153","38","237","193","1390","1"
"2","2018","28","Hotel","8","34","853","1640","175","334","1028","1974","1"
"2","2018","28","Hotel","4","13","34","50","10","13","44","63","3.2"
"2","2018","28","Hotel","13","27","671","1540","6","16","677","1556","2.75"
"2","2018","28","Hotel","2","29","237","517","1038","2588","1275","3105","1"
"2","2018","28","Otros","11","36","193","603","7","7","200","610","1"
"2","2018","28","Otros","7","17","409","915","2","2","411","917","1"
"2","2018","28","","10","11","29","29","3","3","32","32","1"
"2","2018","28","Hotel","4","13","890","1322","35","88","925","1410","1"
"2","2018","28","Hotel","16","40","2437","3657","826","1241","3263","4898","5.6666666666667"
"2","2018","28","Hotel","10","23","805","1312","893","1747","1698","3059","2.8"
"2","2018","28","Hotel","8","34","672","839","370","552","1042","1391","1"
"2","2018","28","Hotel","5","5","710","2132","275","614","985","2746","1"
"2","2018","28","Hotel","3","4","104","197","100","197","204","394","3"
"2","2018","28","Hotel","9","26","58","95","8","22","66","117","1"
"2","2018","28","Hotel","8","34","514","640","241","412","755","1052","1"
"2","2018","28","Hotel","7","17","507","1333","201","796","708","2129","4"
"2","2018","28","Hotel","4","13","191","470","53","82","244","552","3.2"
"2","2018","28","Hotel","12","35","27","123","645","2169","672","2292","1"
"2","2018","28","Hotel","16","40","2350","4833","2009","4191","4359","9024","1"
"2","2018","28","Hotel","9","26","313","559","110","467","423","1026","1"
"2","2018","28","","6","27","258","500","13","27","271","527","1"
"2","2018","28","Hotel","9","26","287","500","2","2","289","502","1"
"2","2018","28","Hotel","4","13","98","121","33","41","131","162","3.2"
"2","2018","28","Hotel","6","28","1787","2009","35","41","1822","2050","1"
"2","2018","28","","2","29","94","270","700","2074","794","2344","1"
"2","2018","28","Hotel","16","19","53","173","0","0","53","173","1"
"2","2018","28","Hotel","13","33","1386","1872","248","380","1634","2252","1"
"2","2018","28","Hotel","8","3","585","1377","198","450","783","1827","1"
"2","2018","28","Hotel","14","27","517","1320","950","1503","1467","2823","1"
"2","2018","28","Hotel","16","40","653","1306","93","187","746","1493","5.6666666666667"
"2","2018","28","Hotel","12","24","292","475","687","949","979","1424","1"
"2","2018","28","Hotel","10","18","1871","2196","366","587","2237","2783","3.2"
"2","2018","28","Otros","15","16","181","194","25","25","206","219","9"
"2","2018","28","Hotel","6","10","944","1231","10","10","954","1241","1"
"2","2018","28","Hotel","10","11","754","1693","162","356","916","2049","1"
"2","2018","28","Otros","6","10","66","182","0","0","66","182","3.8518518518518"
"2","2018","28","Otros","10","23","255","1374","5","12","260","1386","1"
"2","2018","28","Otros","8","2","81","327","4","14","85","341","1"
"2","2018","28","Otros","10","11","57","78","16","40","73","118","1"
"2","2018","28","Hotel","10","23","529","967","497","1071","1026","2038","2.8"
"2","2018","28","Hotel","6","12","456","668","0","0","456","668","5"
"2","2018","28","Hotel","6","27","359","748","34","44","393","792","3"
"2","2018","28","Hotel","10","23","459","927","435","1030","894","1957","2.8"
"2","2018","28","","4","39","122","311","0","0","122","311","1"
"2","2018","28","Hotel","8","34","446","584","429","429","875","1013","1"
"2","2018","28","Hotel","8","34","636","828","392","659","1028","1487","1"
"2","2018","28","Otros","4","39","9","12","0","0","9","12","2.2222222222222"
"2","2018","28","Otros","13","14","562","1124","0","0","562","1124","1"
"2","2018","28","Hotel","10","23","278","624","35","122","313","746","2.8"
"2","2018","28","Otros","13","14","550","2185","0","0","550","2185","1"
"2","2018","28","Hotel","12","24","492","779","563","1086","1055","1865","1"
"2","2018","28","","6","25","302","504","0","0","302","504","1"
"2","2018","28","Hotel","15","27","910","1545","9","16","919","1561","1"
"2","2018","28","Hotel","12","35","149","266","940","1415","1089","1681","1"
"2","2018","28","Hotel","16","40","40","50","420","730","460","780","1"
"2","2018","28","Hotel","16","27","17","27","116","183","133","210","1"
"2","2018","28","Hotel","9","30","86","377","0","0","86","377","1"
"2","2018","28","Hotel","4","13","286","542","53","92","339","634","3.2"
"2","2018","28","Hotel","2","29","23","72","319","1159","342","1231","1"
"2","2018","28","Hotel","16","20","536","1062","358","708","894","1770","1"
"2","2018","28","Hotel","5","5","444","824","104","220","548","1044","1"
"2","2018","28","Hotel","13","33","461","731","56","100","517","831","1"
"2","2018","28","Otros","16","19","400","885","2","4","402","889","1.3333333333333"
"2","2018","28","Hotel","12","24","147","476","308","611","455","1087","1"
"2","2018","28","","8","2","642","1437","38","50","680","1487","1"
"2","2018","28","Hotel","12","35","2","22","208","1918","210","1940","1"
"2","2018","28","Hotel","16","27","56","69","570","655","626","724","2.5"
"2","2018","28","Otros","9","37","93","220","0","0","93","220","2"
"2","2018","28","Otros","16","27","600","1729","24","97","624","1826","2"
"2","2018","28","Hotel","8","34","534","745","321","465","855","1210","1"
"2","2018","28","Otros","8","3","1562","6903","8","40","1570","6943","1"
"2","2018","28","Hotel","7","27","275","687","117","242","392","929","1"
"2","2018","28","Hotel","4","39","173","265","4","13","177","278","1"
"2","2018","28","Hotel","15","16","170","344","29","61","199","405","4"
"2","2018","28","Hotel","4","39","94","154","6","6","100","160","1"
"2","2018","28","Hotel","4","39","152","213","6","7","158","220","1"
"2","2018","28","Hotel","15","16","285","824","143","581","428","1405","4"
"2","2018","28","Hotel","14","31","14","22","365","970","379","992","17.4"
"2","2018","28","Hotel","8","34","344","514","326","457","670","971","1"
"2","2018","28","Hotel","6","28","327","394","68","108","395","502","1"
"2","2018","28","Hotel","7","17","384","1239","97","205","481","1444","4"
"2","2018","28","Otros","7","27","14","52","0","0","14","52","1"
"2","2018","28","Hotel","11","36","1925","2126","83","149","2008","2275","1"
"2","2018","28","Otros","7","17","536","1117","15","21","551","1138","1"
"2","2018","28","Otros","4","21","538","1738","140","363","678","2101","1"
"2","2018","28","Otros","15","16","125","132","48","49","173","181","2"
"2","2018","28","Otros","7","17","623","2371","65","389","688","2760","3"
"2","2018","28","Hotel","7","38","185","253","16","20","201","273","1"
"2","2018","28","Hotel","16","27","534","599","10","17","544","616","2.5"
"2","2018","28","Hotel","2","6","18","45","15","18","33","63","2.2"
"2","2018","28","Hotel","11","36","587","1349","122","214","709","1563","1"
"2","2018","28","Otros","13","14","16","26","6","10","22","36","1"
"2","2018","28","Hotel","6","28","70","83","6","6","76","89","1"
"2","2018","28","Hotel","6","12","64","112","0","0","64","112","5"
"2","2018","28","Otros","9","22","195","952","5","10","200","962","1"
"2","2018","28","","13","14","318","636","15","15","333","651","2"
"2","2018","28","Hotel","2","29","43","147","621","1643","664","1790","1"
"2","2018","28","Hotel","2","29","34","128","159","505","193","633","1"
"2","2018","28","Otros","4","13","335","362","26","26","361","388","1"
"2","2018","28","Hotel","15","16","103","229","48","101","151","330","4"
"2","2018","28","Hotel","2","1","127","244","7","25","134","269","6.4"
"2","2018","28","Otros","7","27","372","745","0","0","372","745","1"
"2","2018","28","Otros","13","33","178","194","0","0","178","194","5.125"
"2","2018","28","","4","21","1065","1486","116","226","1181","1712","1"
"2","2018","28","Hotel","6","10","399","399","11","11","410","410","1"
"2","2018","28","Hotel","11","36","476","1122","0","0","476","1122","1"
"2","2018","28","Otros","14","31","140","560","120","240","260","800","2.8"
"2","2018","28","Hotel","7","27","373","725","13","27","386","752","1"
"2","2018","28","Otros","6","10","95","323","0","0","95","323","3.8518518518518"
"2","2018","28","Hotel","4","39","40","70","8","10","48","80","2.6"
"2","2018","28","Otros","8","2","89","204","45","114","134","318","6.4285714285714"
"2","2018","28","Otros","11","36","50","106","10","22","60","128","5.1904761904762"
"2","2018","28","Hotel","13","33","418","418","9","9","427","427","1"
"2","2018","28","Hotel","10","18","176","176","60","60","236","236","1"
"2","2018","28","Otros","9","37","142","237","0","0","142","237","2"
"2","2018","28","","3","4","95","189","87","127","182","316","1"
"2","2018","28","Hotel","7","17","282","705","99","327","381","1032","4"
"2","2018","28","Hotel","8","2","495","819","42","68","537","887","1"
"2","2018","28","Otros","9","37","16","25","0","0","16","25","2"
"2","2018","28","Otros","15","16","257","500","42","67","299","567","2"
"2","2018","28","Hotel","10","11","1104","1424","10","12","1114","1436","1"
"2","2018","28","Hotel","16","19","234","869","0","0","234","869","1"
"2","2018","28","Hotel","10","23","258","310","146","224","404","534","4"
"2","2018","28","","7","38","411","663","65","103","476","766","1"
"2","2018","28","Hotel","7","27","420","627","8","11","428","638","1"
"2","2018","28","Hotel","11","36","604","1520","91","156","695","1676","1"
"2","2018","28","Hotel","16","40","274","402","12","42","286","444","16.333333333333"
"2","2018","28","Hotel","16","19","567","1407","29","74","596","1481","1"
"2","2018","28","Hotel","12","35","102","141","300","345","402","486","1"
"2","2018","28","Hotel","16","19","55","87","0","0","55","87","1"
"2","2018","28","Hotel","16","20","43","94","2","8","45","102","1"
"2","2018","28","Hotel","10","11","591","962","34","58","625","1020","1"
"2","2018","28","Otros","7","27","140","228","7","7","147","235","4.8333333333333"
"2","2018","28","Otros","7","27","28","96","0","0","28","96","1"
"2","2018","28","Hotel","7","27","25","34","0","0","25","34","4.1666666666667"
"2","2018","0","Otros","16","19","0","0","0","0","0","0","1"
"2","2018","28","Otros","13","14","943","2333","0","0","943","2333","1"
"2","2018","28","Otros","11","15","51","51","0","0","51","51","2.3571428571429"
"2","2018","28","Otros","10","27","138","193","116","221","254","414","4.84"
"2","2018","28","Otros","14","31","382","382","1121","1474","1503","1856","2.8"
"2","2018","28","Otros","11","36","65","168","6","14","71","182","5.1904761904762"
"2","2018","28","Hotel","16","19","328","582","10","32","338","614","1"
"2","2018","28","","14","27","360","500","24","42","384","542","2.6666666666667"
"2","2018","28","Hotel","16","40","122","144","6","6","128","150","5.6666666666667"
"2","2018","28","Hotel","10","27","10","33","0","0","10","33","2.25"
"2","2018","28","Otros","2","29","225","590","245","701","470","1291","3.28"
"2","2018","28","Hotel","13","27","10","20","11","26","21","46","1"
"2","2018","28","Otros","9","22","174","232","4","4","178","236","1"
"2","2018","28","Hotel","2","27","321","446","51","69","372","515","1"
"2","2018","28","Hotel","8","34","428","590","334","585","762","1175","1"
"2","2018","28","Hotel","7","27","413","567","20","45","433","612","1"
"2","2018","28","Hotel","15","16","213","482","121","235","334","717","4"
"2","2018","28","Hotel","16","20","96","264","11","32","107","296","1"
"2","2018","28","Otros","4","13","60","216","2","29","62","245","1"
"2","2018","28","Otros","5","9","335","477","129","229","464","706","1"
"2","2018","28","Hotel","2","1","186","511","2","2","188","513","6.4"
"2","2018","26","Otros","11","32","76","376","0","0","76","376","2.2857142857143"
"2","2018","28","Hotel","2","29","5","65","223","1432","228","1497","1"
"2","2018","28","Hotel","16","27","224","229","100","115","324","344","2.5"
"2","2018","28","Hotel","10","18","196","879","0","0","196","879","3.2"
"2","2018","28","Otros","11","36","917","1366","74","117","991","1483","1"
"2","2018","28","Otros","13","14","216","320","0","0","216","320","1"
"2","2018","0","Hotel","7","27","0","0","0","0","0","0","1"
"2","2018","28","Otros","7","17","248","506","2","2","250","508","3"
"2","2018","28","Otros","14","31","206","370","277","639","483","1009","2.8"
"2","2018","28","Hotel","12","35","180","460","224","427","404","887","1"
"2","2018","28","Hotel","2","29","336","1058","292","833","628","1891","1"
"2","2018","28","Hotel","8","3","376","988","151","380","527","1368","1"
"2","2018","28","Hotel","8","34","387","489","229","273","616","762","2.5714285714286"
"2","2018","28","Hotel","8","34","183","319","115","341","298","660","2.5714285714286"
"2","2018","28","Hotel","12","35","186","388","571","1133","757","1521","1"
"2","2018","28","Hotel","12","35","103","181","264","422","367","603","1"
"2","2018","28","Hotel","11","32","335","712","43","96","378","808","1"
"2","2018","28","Hotel","13","33","194","424","53","66","247","490","2"
"2","2018","28","Hotel","10","23","166","298","169","207","335","505","2.8"
"2","2018","28","Hotel","12","35","227","606","103","167","330","773","1"
"2","2018","28","","16","40","476","789","215","523","691","1312","3.0555555555556"
"2","2018","28","Otros","16","19","127","239","0","0","127","239","1.3333333333333"
"2","2018","28","Otros","16","20","50","200","18","72","68","272","1"
"2","2018","28","Hotel","6","12","149","319","13","33","162","352","5"
"2","2018","28","Hotel","16","19","272","549","0","0","272","549","4"
"2","2018","28","Hotel","12","24","157","352","268","473","425","825","1"
"2","2018","28","Hotel","12","24","150","212","415","479","565","691","3"
"2","2018","28","Hotel","8","3","60","420","0","0","60","420","1"
"2","2018","28","Hotel","5","9","20","21","3","3","23","24","1"
"2","2018","28","Hotel","16","27","237","311","22","118","259","429","2.5"
"2","2018","28","Otros","10","23","64","64","0","0","64","64","7"
"2","2018","28","Otros","13","14","471","996","0","0","471","996","7.3846153846154"
"2","2018","28","Otros","2","6","30","66","14","23","44","89","1"
"2","2018","24","Hotel","15","16","6","8","55","69","61","77","7.8"
"2","2018","28","Hotel","8","3","178","380","6","12","184","392","1"
"2","2018","28","Hotel","8","34","549","757","408","879","957","1636","1"
"2","2018","28","Hotel","8","3","246","700","115","229","361","929","1"
"2","2018","28","","2","29","162","440","103","279","265","719","1"
"2","2018","28","Hotel","2","1","361","530","33","56","394","586","6.4"
"2","2018","28","Hotel","7","17","199","445","12","12","211","457","4"
"2","2018","28","Otros","7","17","189","992","28","179","217","1171","3"
"2","2018","28","Hotel","16","40","159","358","302","689","461","1047","5.6666666666667"
"2","2018","28","Hotel","12","24","388","673","425","583","813","1256","1"
"2","2018","28","Hotel","14","31","129","230","299","1139","428","1369","17.4"
"2","2018","0","Hotel","9","26","0","0","0","0","0","0","1"
"2","2018","28","Hotel","6","12","10","10","0","0","10","10","5"
"2","2018","28","Otros","5","9","32","32","15","15","47","47","4.0454545454545"
"2","2018","28","Otros","5","9","18","18","0","0","18","18","4.0454545454545"
"2","2018","28","Otros","15","27","236","323","0","0","236","323","1.4222222222222"
"2","2018","28","Hotel","8","34","57","57","27","27","84","84","2.5714285714286"
"2","2018","28","Hotel","10","18","410","1110","126","338","536","1448","7.75"
"2","2018","28","Hotel","15","16","260","677","46","120","306","797","7.8"
"2","2018","28","Hotel","2","29","38","100","450","1346","488","1446","1"
"2","2018","28","Hotel","4","39","78","171","3","10","81","181","2.6"
"2","2018","28","Otros","4","39","141","141","0","0","141","141","2.2222222222222"
"2","2018","28","Hotel","4","13","156","345","65","125","221","470","5.4"
"2","2018","28","Otros","10","23","107","148","0","0","107","148","7"
"2","2018","28","Otros","14","31","53","108","507","981","560","1089","20.2"
"2","2018","28","Hotel","3","4","108","180","69","95","177","275","2.6"
"2","2018","28","Hotel","10","23","217","468","94","182","311","650","4"
"2","2018","28","Otros","9","22","612","2114","3","21","615","2135","1"
"2","2018","28","Hotel","12","24","168","389","437","613","605","1002","3"
"2","2018","28","Hotel","13","14","69","165","2","8","71","173","1"
"2","2018","28","Hotel","12","35","282","642","211","301","493","943","1.7272727272727"
"2","2018","28","Hotel","6","28","374","579","0","0","374","579","1"
"2","2018","28","","6","28","154","326","0","0","154","326","1"
"2","2018","28","Hotel","12","24","293","653","244","675","537","1328","3"
"2","2018","28","Otros","5","9","24","38","30","35","54","73","4.0454545454545"
"2","2018","28","Hotel","16","20","169","302","17","22","186","324","1"
"2","2018","28","Hotel","4","21","493","904","71","170","564","1074","3"
"2","2018","28","Otros","10","11","105","168","3","6","108","174","11.764705882353"
"2","2018","28","Otros","13","14","251","251","0","0","251","251","7.3846153846154"
"2","2018","28","Otros","6","27","337","1220","0","0","337","1220","1"
"2","2018","28","Otros","16","27","183","583","0","0","183","583","13.818181818182"
"2","2018","28","Hotel","9","26","230","430","0","0","230","430","1"
"2","2018","28","Hotel","16","27","669","714","667","830","1336","1544","2.5"
"2","2018","28","Hotel","3","4","804","1062","178","323","982","1385","3"
"2","2018","28","Otros","16","27","100","250","0","0","100","250","2"
"2","2018","28","Otros","16","19","1185","5691","6","6","1191","5697","1.3333333333333"
"2","2018","28","Hotel","6","12","617","900","35","35","652","935","5"
"2","2018","28","Hotel","2","1","237","316","40","45","277","361","6.4"
"2","2018","28","Hotel","10","11","602","1127","136","240","738","1367","1"
"2","2018","28","Otros","10","23","151","151","16","16","167","167","1"
"2","2018","28","Otros","10","27","1030","1302","174","205","1204","1507","4.84"
"2","2018","28","Hotel","16","27","300","561","62","212","362","773","2.5"
"2","2018","28","Hotel","6","28","279","330","29","51","308","381","1"
"2","2018","28","Hotel","4","13","110","245","12","17","122","262","5.4"
"2","2018","28","Hotel","14","27","642","892","37","51","679","943","8.5"
"2","2018","28","Hotel","10","27","138","191","565","686","703","877","1"
"2","2018","28","Hotel","13","27","93","115","64","92","157","207","4.2"
"2","2018","28","Hotel","3","4","776","866","9","24","785","890","3"
"2","2018","28","Otros","4","13","236","486","7","25","243","511","3.4"
"2","2018","28","Otros","11","15","61","115","0","0","61","115","2.3571428571429"
"2","2018","28","Otros","6","10","350","955","0","0","350","955","3.8518518518518"
"2","2018","28","Otros","2","1","135","165","6","9","141","174","1"
"2","2018","28","","6","12","93","295","0","0","93","295","1"
"2","2018","28","Otros","10","23","283","701","51","138","334","839","1"
"2","2018","28","Hotel","16","19","313","415","0","0","313","415","4"
"2","2018","28","Hotel","10","11","18","67","37","140","55","207","5.6666666666667"
"2","2018","28","Hotel","10","23","115","133","21","23","136","156","4"
"2","2018","28","Otros","14","31","43","134","266","630","309","764","2.8"
"2","2018","28","Otros","13","27","7","9","0","0","7","9","12.2"
"2","2018","28","Hotel","2","1","308","827","0","0","308","827","6.4"
"2","2018","28","Hotel","16","19","102","215","0","0","102","215","4"
"2","2018","28","Otros","12","35","72","116","13","15","85","131","3.5"
"2","2018","28","Otros","15","16","165","493","57","159","222","652","2"
"2","2018","28","Otros","9","22","1057","2114","243","486","1300","2600","1"
"2","2018","28","Hotel","10","27","390","464","613","812","1003","1276","1"
"2","2018","28","Hotel","2","27","156","208","11","35","167","243","3.6"
"2","2018","28","Hotel","16","20","249","270","13","28","262","298","1"
"2","2018","28","Hotel","10","18","0","0","25","74","25","74","7.75"
"2","2018","28","Hotel","6","12","206","206","0","0","206","206","5"
"2","2018","28","Hotel","2","27","94","228","7","8","101","236","3.6"
"2","2018","28","Hotel","15","16","198","461","33","132","231","593","7.8"
"2","2018","28","Hotel","10","23","75","75","27","27","102","102","4"
"2","2018","28","Hotel","11","32","334","494","56","89","390","583","1"
"2","2018","28","Hotel","14","27","99","258","45","144","144","402","8.5"
"2","2018","28","Otros","16","19","88","115","0","0","88","115","4"
"2","2018","28","Otros","10","11","202","345","15","19","217","364","11.764705882353"
"2","2018","28","Otros","13","14","127","490","0","0","127","490","1"
"2","2018","28","Hotel","2","27","123","318","16","24","139","342","3.6"
"2","2018","28","Otros","13","14","200","943","16","56","216","999","7.3846153846154"
"2","2018","28","Hotel","2","1","161","169","5","5","166","174","6.4"
"2","2018","28","Otros","7","17","235","1003","32","166","267","1169","17.166666666667"
"2","2018","28","Otros","10","23","53","131","9","36","62","167","7"
"2","2018","28","Hotel","13","27","141","255","0","0","141","255","2.75"
"2","2018","28","Otros","10","18","191","610","53","107","244","717","10.25"
"2","2018","28","Otros","5","9","45","52","12","19","57","71","4.0454545454545"
"2","2018","28","Hotel","4","39","107","233","11","25","118","258","2.6"
"2","2018","28","Otros","16","27","27","80","0","0","27","80","13.818181818182"
"2","2018","28","Hotel","14","27","13","23","8","21","21","44","8.5"
"2","2018","28","Hotel","10","11","312","579","72","109","384","688","5.6666666666667"
"2","2018","28","Hotel","10","18","164","499","118","296","282","795","7.75"
"2","2018","28","Otros","14","31","90","125","119","231","209","356","20.2"
"2","2018","28","Otros","11","32","75","351","0","0","75","351","2.2857142857143"
"2","2018","28","Otros","5","5","64","129","40","68","104","197","3.65625"
"2","2018","28","Otros","6","25","214","526","0","0","214","526","2.3846153846154"
"2","2018","28","Hotel","3","4","36","151","8","35","44","186","2.6"
"2","2018","28","Otros","7","27","361","1152","19","30","380","1182","4.8333333333333"
"2","2018","28","Otros","2","29","142","307","180","419","322","726","3.28"
"2","2018","28","Hotel","2","29","61","191","165","518","226","709","1"
"2","2018","28","Otros","4","21","213","443","24","64","237","507","1"
"2","2018","28","Hotel","7","27","325","375","0","0","325","375","4.1666666666667"
"2","2018","28","Otros","5","5","35","101","16","22","51","123","3.65625"
"2","2018","28","Otros","11","36","283","766","135","286","418","1052","5.1904761904762"
"2","2018","28","Otros","6","27","204","550","0","0","204","550","1"
"2","2018","28","Hotel","7","27","258","258","0","0","258","258","4.1666666666667"
"2","2018","28","Hotel","16","20","305","542","47","85","352","627","1"
"2","2018","28","Hotel","12","24","179","334","171","349","350","683","3"
"2","2018","28","Hotel","9","26","74","101","20","20","94","121","1.5"
"2","2018","28","Hotel","7","17","535","1447","96","305","631","1752","10"
"2","2018","28","Hotel","9","37","185","250","38","105","223","355","3.4"
"2","2018","28","Hotel","5","5","445","640","152","174","597","814","2.1428571428571"
"2","2018","28","Otros","6","27","185","664","2","4","187","668","3.960088691796"
"2","2018","28","Hotel","9","37","46","74","8","50","54","124","3.4"
"2","2018","28","Otros","10","27","110","110","178","179","288","289","4.84"
"2","2018","28","Otros","8","3","218","478","10","19","228","497","10"
"2","2018","28","Otros","16","20","61","76","0","0","61","76","3.0769230769231"
"2","2018","28","Otros","9","22","83","115","0","0","83","115","7.6428571428571"
"2","2018","28","Otros","10","27","367","433","90","101","457","534","4.84"
"2","2018","28","Otros","10","23","221","284","26","40","247","324","7"
"2","2018","28","Otros","2","6","420","420","110","110","530","530","1"
"2","2018","28","Otros","5","5","56","77","86","140","142","217","4"
"2","2018","28","Otros","4","39","19","24","0","0","19","24","2.2222222222222"
"2","2018","28","Hotel","2","27","272","322","86","90","358","412","1"
"2","2018","28","Hotel","14","31","45","122","78","693","123","815","24"
"2","2018","28","Otros","12","35","22","30","247","376","269","406","2.6666666666667"
"2","2018","28","Otros","2","29","228","415","114","251","342","666","3.28"
"2","2018","28","Otros","8","3","1331","3283","170","564","1501","3847","10"
"2","2018","28","Hotel","7","27","60","124","0","0","60","124","1"
"2","2018","28","","13","14","28","104","36","132","64","236","1"
"2","2018","28","Hotel","6","10","617","693","37","46","654","739","6.6"
"2","2018","28","Hotel","8","34","142","165","113","153","255","318","2.5714285714286"
"2","2018","28","Hotel","9","22","313","568","3","6","316","574","2.5555555555556"
"2","2018","28","Hotel","2","6","66","121","42","119","108","240","2.2"
"2","2018","28","Hotel","10","27","83","122","327","399","410","521","2.25"
"2","2018","28","Otros","14","27","272","272","0","0","272","272","11.833333333333"
"2","2018","28","Otros","6","12","390","647","8","24","398","671","1.8256578947368"
"2","2018","28","Hotel","6","27","156","222","0","0","156","222","3"
"2","2018","28","Hotel","5","5","79","184","39","52","118","236","2.1428571428571"
"2","2018","28","Hotel","5","5","126","174","98","155","224","329","2.1428571428571"
"2","2018","28","Hotel","13","27","110","217","0","0","110","217","4.2"
"2","2018","28","Hotel","2","27","124","180","2","4","126","184","3.6"
"2","2018","28","Hotel","8","3","86","126","118","118","204","244","4.1111111111111"
"2","2018","28","Otros","11","36","133","531","0","0","133","531","5.1904761904762"
"2","2018","28","Otros","9","30","348","802","0","0","348","802","2.3333333333333"
"2","2018","28","Otros","16","19","104","361","0","0","104","361","10.263157894737"
"2","2018","28","Hotel","14","31","49","72","246","725","295","797","17.4"
"2","2018","28","Hotel","2","1","237","270","6","8","243","278","6.4"
"2","2018","28","Hotel","16","40","863","1751","665","1261","1528","3012","5.6666666666667"
"2","2018","28","Otros","7","17","313","746","90","343","403","1089","17.166666666667"
"2","2018","28","Hotel","13","27","303","371","206","353","509","724","2.75"
"2","2018","28","Hotel","14","31","178","259","327","550","505","809","24"
"2","2018","28","Otros","3","4","48","99","15","29","63","128","12.2"
"2","2018","28","Otros","8","34","221","306","336","496","557","802","5.75"
"2","2018","28","Hotel","9","22","341","565","6","14","347","579","2.5555555555556"
"2","2018","28","Hotel","4","21","198","386","32","83","230","469","3"
"2","2018","28","Hotel","6","27","93","133","0","0","93","133","3"
"2","2018","28","Hotel","12","35","121","234","234","342","355","576","1.7272727272727"
"2","2018","28","Hotel","2","29","30","71","145","293","175","364","2"
"2","2018","28","Otros","10","11","73","121","10","16","83","137","11.764705882353"
"2","2018","28","Hotel","6","10","176","226","10","10","186","236","6.6"
"2","2018","28","Hotel","13","14","165","385","66","198","231","583","2"
"2","2018","28","Otros","16","27","228","423","0","0","228","423","13.818181818182"
"2","2018","28","Otros","6","27","29","31","0","0","29","31","3.960088691796"
"2","2018","28","Hotel","16","40","79","136","454","948","533","1084","5.6666666666667"
"2","2018","28","Otros","6","10","341","960","7","15","348","975","3.8518518518518"
"2","2018","28","Otros","10","23","83","152","0","0","83","152","7"
"2","2018","28","Hotel","6","28","363","480","27","33","390","513","1"
"2","2018","28","Otros","7","38","506","952","123","271","629","1223","2.75"
"2","2018","28","Hotel","6","12","223","295","1","14","224","309","5"
"2","2018","28","Hotel","13","27","561","1005","21","36","582","1041","4.2"
"2","2018","28","Otros","4","21","122","301","6","15","128","316","4.8333333333333"
"2","2018","28","Otros","13","14","95","129","0","0","95","129","1"
"2","2018","28","Hotel","16","27","74","166","7","23","81","189","5.8571428571429"
"2","2018","28","Hotel","5","5","96","179","88","170","184","349","2.1428571428571"
"2","2018","28","Otros","12","24","82","181","123","188","205","369","9.2"
"2","2018","28","Otros","15","16","124","186","48","53","172","239","9"
"2","2018","28","Hotel","8","27","225","225","6","6","231","231","4.5"
"2","2018","28","Hotel","9","22","120","151","6","6","126","157","2.5555555555556"
"2","2018","28","Hotel","10","11","237","391","74","147","311","538","5.6666666666667"
"2","2018","28","Hotel","8","3","234","679","46","124","280","803","4.1111111111111"
"2","2018","28","Hotel","6","10","472","555","2","2","474","557","6.6"
"2","2018","28","Otros","9","26","51","52","14","72","65","124","3.8888888888889"
"2","2018","28","Hotel","4","39","85","161","9","44","94","205","2.6"
"2","2018","28","Otros","6","27","4","12","0","0","4","12","3.960088691796"
"2","2018","28","Otros","6","12","185","231","25","30","210","261","1.8256578947368"
"2","2018","28","Hotel","6","27","107","222","4","6","111","228","3"
"2","2018","28","Otros","5","9","139","190","39","71","178","261","4.0454545454545"
"2","2018","28","Otros","5","9","374","766","198","318","572","1084","1"
"2","2018","28","Hotel","2","27","120","120","23","23","143","143","3.6"
"2","2018","28","Hotel","2","29","94","282","148","444","242","726","1"
"2","2018","28","Hotel","4","13","245","387","17","26","262","413","5.4"
"2","2018","28","","11","15","65","287","0","0","65","287","1"
"2","2018","28","Hotel","6","10","464","548","33","39","497","587","6.6"
"2","2018","28","Otros","6","12","48","63","0","0","48","63","1.8256578947368"
"2","2018","28","Otros","10","18","51","51","20","20","71","71","10.25"
"2","2018","28","Otros","9","22","358","1189","2","4","360","1193","7.6428571428571"
"2","2018","28","Otros","7","27","312","827","0","0","312","827","1"
"2","2018","28","","14","27","380","421","0","0","380","421","1"
"2","2018","28","Hotel","16","27","74","149","8","11","82","160","5.8571428571429"
"2","2018","28","Otros","2","29","15","42","20","36","35","78","3.28"
"2","2018","28","Hotel","8","27","19","21","3","3","22","24","1"
"2","2018","28","Otros","13","33","64","66","2","2","66","68","5.125"
"2","2018","28","Hotel","9","22","312","840","0","0","312","840","1"
"2","2018","28","Otros","10","23","59","253","0","0","59","253","1"
"2","2018","28","Otros","13","33","17","20","5","5","22","25","5.125"
"2","2018","28","Otros","6","10","97","425","0","0","97","425","3.8518518518518"
"2","2018","28","Hotel","10","18","230","451","82","157","312","608","7.75"
"2","2018","28","Hotel","14","31","56","93","37","95","93","188","24"
"2","2018","28","Hotel","4","21","67","67","3","3","70","70","3"
"2","2018","28","Hotel","3","4","33","153","36","220","69","373","2.6"
"2","2018","28","Otros","8","27","297","579","13","26","310","605","1"
"2","2018","28","Otros","6","27","29","90","0","0","29","90","3.960088691796"
"2","2018","28","Hotel","6","25","222","368","1","3","223","371","1"
"2","2018","28","Otros","6","12","216","436","17","33","233","469","1.8256578947368"
"2","2018","28","Hotel","6","27","37","55","0","0","37","55","3"
"2","2018","28","Otros","6","27","12","25","0","0","12","25","3.960088691796"
"2","2018","28","Otros","6","10","353","636","0","0","353","636","3.8518518518518"
"2","2018","28","Otros","6","12","77","122","0","0","77","122","1.8256578947368"
"2","2018","28","Otros","5","5","67","107","15","16","82","123","3.65625"
"2","2018","28","Hotel","12","24","106","298","38","111","144","409","3"
"2","2018","28","Hotel","12","35","45","117","30","82","75","199","2"
"2","2018","28","Hotel","15","16","117","181","6","12","123","193","7.8"
"2","2018","28","Otros","4","13","71","131","0","0","71","131","3.4"
"2","2018","28","Hotel","2","29","208","898","87","366","295","1264","1"
"2","2018","28","Hotel","4","21","133","310","8","15","141","325","3"
"2","2018","28","Hotel","10","27","199","385","311","403","510","788","2.25"
"2","2018","28","Hotel","8","3","271","662","82","173","353","835","4.1111111111111"
"2","2018","28","Hotel","12","27","71","90","52","69","123","159","1"
"2","2018","28","Otros","5","5","139","404","34","79","173","483","3.65625"
"2","2018","28","Otros","13","14","100","146","0","0","100","146","7.3846153846154"
"2","2018","28","Otros","10","11","14","178","0","0","14","178","11.764705882353"
"2","2018","28","Otros","16","40","338","836","28","68","366","904","28.142857142857"
"2","2018","28","Hotel","11","36","425","824","27","52","452","876","1"
"2","2018","28","Otros","12","35","64","165","141","321","205","486","2.6666666666667"
"2","2018","28","Otros","8","34","51","57","58","60","109","117","5.75"
"2","2018","28","Hotel","7","17","165","244","17","23","182","267","10"
"2","2018","28","Otros","12","35","168","353","23","42","191","395","3.5"
"2","2018","28","Otros","5","9","52","87","46","93","98","180","4.0454545454545"
"2","2018","28","Hotel","9","22","121","177","0","0","121","177","2.5555555555556"
"2","2018","28","Otros","2","29","38","88","33","75","71","163","3.28"
"2","2018","28","Otros","2","29","156","292","223","675","379","967","3.28"
"2","2018","28","Otros","10","23","37","54","12","12","49","66","1"
"2","2018","28","Hotel","10","27","167","217","227","262","394","479","2.25"
"2","2018","28","Hotel","16","19","157","222","45","53","202","275","4"
"2","2018","28","Hotel","16","40","189","402","52","126","241","528","16.333333333333"
"2","2018","28","Hotel","8","27","384","539","47","68","431","607","4.5"
"2","2018","28","Otros","13","14","21","21","12","12","33","33","7.3846153846154"
"2","2018","28","Hotel","7","27","33","53","3","11","36","64","4.1666666666667"
"2","2018","28","Otros","2","6","0","0","1","1","1","1","5"
"2","2018","28","Hotel","7","17","330","571","31","126","361","697","10"
"2","2018","28","Hotel","3","4","54","108","57","161","111","269","2.6"
"2","2018","28","Otros","6","12","14","152","0","0","14","152","1.8256578947368"
"2","2018","28","Otros","6","10","100","100","0","0","100","100","3.8518518518518"
"2","2018","28","Hotel","16","40","86","120","62","106","148","226","16.333333333333"
"2","2018","28","Otros","4","39","52","91","8","15","60","106","2.2222222222222"
"2","2018","28","Otros","13","14","134","356","0","0","134","356","7.3846153846154"
"2","2018","28","Otros","7","38","174","315","7","11","181","326","2.75"
"2","2018","28","Hotel","11","32","92","132","0","0","92","132","1"
"2","2018","28","Otros","11","36","249","540","2","2","251","542","5.1904761904762"
"2","2018","28","Hotel","4","21","181","346","9","17","190","363","3"
"2","2018","28","Otros","3","4","14","38","5","9","19","47","12.2"
"2","2018","28","Otros","5","9","65","91","35","39","100","130","4.0454545454545"
"2","2018","28","Otros","16","19","40","80","0","0","40","80","4"
"2","2018","28","Hotel","8","27","107","220","1","1","108","221","4.5"
"2","2018","28","Otros","16","40","52","123","22","69","74","192","1"
"2","2018","28","","7","17","206","664","25","217","231","881","1"
"2","2018","28","Otros","16","20","162","975","20","202","182","1177","3.0769230769231"
"2","2018","28","Otros","4","21","204","411","14","57","218","468","4.8333333333333"
"2","2018","28","Otros","13","33","85","93","27","34","112","127","5.125"
"2","2018","28","","12","35","40","78","1192","1757","1232","1835","1"
"2","2018","28","Hotel","13","33","1","1","1","2","2","3","2"
"2","2018","28","Otros","4","39","17","28","0","0","17","28","2.2222222222222"
"2","2018","28","Otros","10","18","65","145","14","46","79","191","10.25"
"2","2018","28","Otros","6","27","104","151","14","20","118","171","3.960088691796"
"2","2018","28","Otros","12","35","22","30","289","429","311","459","2.6666666666667"
"2","2018","28","Hotel","4","39","61","219","0","0","61","219","2.6"
"2","2018","13","Otros","14","31","35","61","168","398","203","459","20.2"
"2","2018","28","Hotel","2","29","21","70","85","858","106","928","2"
"2","2018","28","Hotel","13","14","75","75","0","0","75","75","1"
"2","2018","28","Hotel","9","26","153","192","0","0","153","192","1.5"
"2","2018","28","Otros","8","2","58","182","0","0","58","182","1"
"2","2018","28","Otros","12","35","7","11","5","5","12","16","3.5"
"2","2018","28","Hotel","14","27","121","140","50","60","171","200","8.5"
"2","2018","28","Otros","11","36","166","797","0","0","166","797","5.1904761904762"
"2","2018","28","Otros","16","20","196","990","24","94","220","1084","3.0769230769231"
"2","2018","28","Otros","4","39","6","11","0","0","6","11","2.2222222222222"
"2","2018","28","Otros","7","27","179","320","2","2","181","322","4.8333333333333"
"2","2018","28","Otros","6","27","163","282","9","9","172","291","3.960088691796"
"2","2018","28","Otros","5","8","5","140","0","0","5","140","5"
"2","2018","28","Otros","9","37","128","260","9","9","137","269","4.5"
"2","2018","28","Hotel","2","6","36","69","0","0","36","69","5.5"
"2","2018","28","Hotel","10","27","393","531","143","180","536","711","2.25"
"2","2018","28","Hotel","9","30","198","383","10","23","208","406","1"
"2","2018","28","Otros","4","13","52","54","9","14","61","68","3.4"
"2","2018","28","Hotel","5","5","304","304","0","0","304","304","1"
"2","2018","28","Otros","7","38","327","909","7","20","334","929","2.75"
"2","2018","28","Hotel","13","14","69","207","0","0","69","207","1"
"2","2018","28","Otros","5","9","186","199","164","214","350","413","4.0454545454545"
"2","2018","28","Otros","5","8","3","3","7","10","10","13","5"
"2","2018","28","Otros","10","27","0","0","311","560","311","560","4.84"
"2","2018","28","Hotel","13","14","20","28","2","2","22","30","1"
"2","2018","28","Otros","11","15","14","178","0","0","14","178","2.3571428571429"
"2","2018","28","Hotel","9","22","615","956","0","0","615","956","2.5555555555556"
"2","2018","28","Otros","11","36","340","615","40","55","380","670","5.1904761904762"
"2","2018","28","Hotel","10","18","1680","4252","2266","4288","3946","8540","1"
"2","2018","28","Hotel","6","12","236","300","0","0","236","300","5"
"2","2018","28","","2","29","274","741","722","1846","996","2587","1"
"2","2018","28","Hotel","16","27","1381","3217","101","218","1482","3435","1"
"2","2018","28","","14","31","266","593","394","1541","660","2134","1"
"2","2018","28","Hotel","8","3","69","253","35","170","104","423","4.1111111111111"
"2","2018","28","Otros","13","33","107","142","66","96","173","238","5.125"
"2","2018","28","","14","27","97","155","0","0","97","155","2.6666666666667"
"2","2018","28","Otros","9","22","135","257","0","0","135","257","7.6428571428571"
"2","2018","28","Hotel","10","11","77","218","7","57","84","275","5.6666666666667"
"2","2018","28","Otros","6","12","34","38","0","0","34","38","1.8256578947368"
"2","2018","28","Hotel","8","3","242","569","66","90","308","659","4.1111111111111"
"2","2018","28","Otros","9","22","132","819","0","0","132","819","3.25"
"2","2018","28","Hotel","7","17","195","493","33","62","228","555","1"
"2","2018","28","Otros","6","12","337","976","0","0","337","976","1.8256578947368"
"2","2018","28","Hotel","8","27","145","145","0","0","145","145","4.5"
"2","2018","28","Hotel","6","28","280","284","52","52","332","336","2.4"
"2","2018","28","Otros","8","2","220","669","100","164","320","833","1"
"2","2018","28","Hotel","8","27","120","122","2","2","122","124","1"
"2","2018","28","Otros","6","25","203","1394","0","0","203","1394","2.3846153846154"
"2","2018","28","Otros","6","25","147","270","0","0","147","270","2.3846153846154"
"2","2018","28","Hotel","11","36","1035","1867","0","0","1035","1867","1"
"2","2018","28","Otros","16","20","37","112","8","21","45","133","1"
"2","2018","28","Otros","2","6","30","77","236","633","266","710","5"
"2","2018","28","Hotel","14","31","46","86","92","234","138","320","24"
"2","2018","28","Otros","4","21","62","98","21","35","83","133","4.8333333333333"
"2","2018","28","Otros","7","38","238","374","4","6","242","380","2.75"
"2","2018","28","Otros","13","14","205","334","0","0","205","334","7.3846153846154"
"2","2018","28","Otros","2","29","40","50","32","35","72","85","3.28"
"2","2018","28","Otros","3","4","86","86","34","34","120","120","12.2"
"2","2018","28","Hotel","3","4","161","310","18","52","179","362","3"
"2","2018","28","Otros","7","27","549","755","54","66","603","821","1"
"2","2018","28","Otros","7","17","257","465","13","13","270","478","3"
"2","2018","28","Hotel","12","27","193","402","12","12","205","414","1"
"2","2018","28","Otros","5","5","45","89","28","53","73","142","3.65625"
"2","2018","28","Hotel","6","10","416","501","12","16","428","517","6.6"
"2","2018","28","Otros","10","18","263","744","55","146","318","890","10.25"
"2","2018","28","Otros","8","27","77","109","0","0","77","109","9.4"
"2","2018","28","Otros","8","3","189","686","17","38","206","724","10"
"2","2018","28","Hotel","16","27","40","59","0","0","40","59","5.8571428571429"
"2","2018","28","Otros","16","40","113","235","0","0","113","235","1"
"2","2018","28","Otros","8","27","454","584","27","37","481","621","1"
"2","2018","28","Otros","6","10","53","134","0","0","53","134","3.8518518518518"
"2","2018","28","Otros","7","17","258","989","19","55","277","1044","3"
"2","2018","28","Otros","16","40","33","38","26","44","59","82","1"
"2","2018","28","Hotel","2","6","21","46","6","7","27","53","5.5"
"2","2018","28","Hotel","8","3","112","447","19","67","131","514","4.1111111111111"
"2","2018","28","Otros","7","38","398","997","5","5","403","1002","1"
"2","2018","28","Otros","10","11","127","177","29","47","156","224","11.764705882353"
"2","2018","28","Otros","6","27","146","297","0","0","146","297","3.960088691796"
"2","2018","28","Otros","15","16","11","21","3","16","14","37","9"
"2","2018","28","Otros","6","25","229","547","0","0","229","547","1"
"2","2018","28","Otros","5","5","42","63","58","104","100","167","3.65625"
"2","2018","28","Otros","10","27","360","537","131","162","491","699","4.84"
"2","2018","28","Hotel","7","38","210","369","42","50","252","419","1"
"2","2018","28","Hotel","12","35","95","191","277","383","372","574","2"
"2","2018","28","Hotel","13","27","8","88","0","0","8","88","4.2"
"2","2018","28","Hotel","16","20","152","356","0","0","152","356","1"
"2","2018","28","Otros","10","27","89","117","275","361","364","478","4.84"
"2","2018","28","Otros","16","40","71","143","11","28","82","171","1"
"2","2018","28","Hotel","3","7","23","35","8","13","31","48","1"
"2","2018","28","Otros","2","29","128","271","38","50","166","321","3.28"
"2","2018","28","Otros","10","18","139","383","14","24","153","407","10.25"
"2","2018","28","Otros","5","5","75","194","76","105","151","299","4"
"2","2018","28","Otros","9","22","342","1636","0","0","342","1636","7.6428571428571"
"2","2018","28","Otros","15","27","162","162","2","2","164","164","1.4222222222222"
"2","2018","28","Otros","5","5","30","41","17","31","47","72","4"
"2","2018","28","Hotel","16","19","106","161","7","17","113","178","1"
"2","2018","28","Otros","11","36","23","50","1","1","24","51","5.1904761904762"
"2","2018","28","Otros","5","5","33","51","15","24","48","75","3.65625"
"2","2018","28","Otros","2","29","10","30","32","76","42","106","3.28"
"2","2018","28","Hotel","9","22","113","214","24","24","137","238","2.5555555555556"
"2","2018","28","Otros","11","32","12","36","0","0","12","36","2.2857142857143"
"2","2018","28","Hotel","10","27","531","590","317","419","848","1009","1"
"2","2018","28","Otros","16","27","526","1287","0","0","526","1287","2"
"2","2018","28","Otros","13","33","19","25","28","61","47","86","1"
"2","2018","28","Hotel","16","20","78","195","4","16","82","211","1"
"2","2018","28","Otros","11","15","86","106","1","1","87","107","2.3571428571429"
"2","2018","28","Otros","7","17","58","354","3","84","61","438","3"
"2","2018","28","Otros","5","8","37","51","16","32","53","83","5"
"2","2018","28","Otros","8","27","357","360","4","4","361","364","1"
"2","2018","28","Otros","8","3","24","67","80","216","104","283","14.75"
"2","2018","28","Otros","16","27","20","80","0","0","20","80","1"
"2","2018","0","Otros","13","14","0","0","0","0","0","0","1"
"2","2018","28","Hotel","13","33","57","92","20","28","77","120","2"
"2","2018","28","Otros","5","9","106","182","37","78","143","260","4.0454545454545"
"2","2018","28","Otros","10","27","123","170","99","127","222","297","4.84"
"2","2018","28","Otros","9","22","146","486","7","26","153","512","7.6428571428571"
"2","2018","28","Otros","16","40","150","300","5","10","155","310","28.142857142857"
"2","2018","28","Hotel","16","40","175","205","25","27","200","232","1"
"2","2018","28","Otros","15","16","15","30","9","30","24","60","9"
"2","2018","28","Hotel","8","2","86","92","32","32","118","124","3"
"2","2018","28","Otros","8","3","135","400","0","0","135","400","10"
"2","2018","28","Otros","7","17","83","96","0","0","83","96","17.166666666667"
"2","2018","28","Otros","16","20","98","196","0","0","98","196","3.0769230769231"
"2","2018","28","Otros","6","27","117","394","5","15","122","409","3.960088691796"
"2","2018","28","Otros","12","35","90","204","238","344","328","548","3.5"
"2","2018","28","Otros","6","28","141","457","28","55","169","512","4.65"
"2","2018","28","Otros","6","28","720","1328","95","215","815","1543","4.65"
"2","2018","28","Hotel","8","34","140","231","169","205","309","436","2.5714285714286"
"2","2018","28","Hotel","16","20","2169","4047","15","50","2184","4097","1"
"2","2018","28","Hotel","2","6","149","405","0","0","149","405","2.2"
"2","2018","28","Hotel","7","27","69","644","0","0","69","644","4.1666666666667"
"2","2018","28","Hotel","10","23","230","304","12","13","242","317","4"
"2","2018","28","Hotel","9","26","158","215","31","64","189","279","1.5"
"2","2018","28","Otros","13","14","183","229","0","0","183","229","1"
"2","2018","28","Otros","8","27","258","373","8","8","266","381","9.4"
"2","2018","28","Otros","10","27","146","188","23","26","169","214","4.84"
"2","2018","28","Otros","11","15","59","101","5","9","64","110","2.3571428571429"
"2","2018","28","Otros","16","20","138","173","19","23","157","196","3.0769230769231"
"2","2018","28","Otros","11","32","73","97","0","0","73","97","1"
"2","2018","28","Otros","16","27","90","90","6","6","96","96","13.818181818182"
"2","2018","28","Otros","7","38","43","127","0","0","43","127","1"
"2","2018","28","Otros","9","37","100","100","0","0","100","100","4.5"
"2","2018","28","Hotel","2","29","48","191","50","173","98","364","2"
"2","2018","28","Hotel","2","1","167","556","16","45","183","601","6.4"
"2","2018","28","Otros","5","8","5","5","2","4","7","9","5"
"2","2018","28","Otros","9","37","106","185","21","33","127","218","4.5"
"2","2018","28","Otros","7","38","266","1084","0","0","266","1084","2.75"
"2","2018","28","Otros","11","32","137","641","0","0","137","641","1"
"2","2018","28","Otros","4","39","106","110","0","0","106","110","2.2222222222222"
"2","2018","28","Hotel","11","36","101","216","48","96","149","312","2.375"
"2","2018","28","Otros","10","23","71","308","25","145","96","453","7"
"2","2018","28","Otros","6","28","236","452","17","23","253","475","1"
"2","2018","28","Otros","7","38","171","410","52","102","223","512","1"
"2","2018","28","Hotel","15","16","611","2122","413","2311","1024","4433","2"
"2","2018","28","Otros","2","29","89","207","212","430","301","637","3.28"
"2","2018","28","Hotel","8","3","36","36","4","4","40","40","1"
"2","2018","28","Hotel","6","12","930","1206","39","47","969","1253","1"
"2","2018","28","Hotel","11","15","248","2794","0","0","248","2794","1"
"2","2018","28","Otros","4","21","934","2658","64","154","998","2812","1"
"2","2018","28","Otros","16","19","166","457","0","0","166","457","10.263157894737"
"2","2018","28","","9","37","331","616","27","50","358","666","1"
"2","2018","28","Otros","10","27","246","426","218","326","464","752","4.84"
"2","2018","28","Otros","11","15","150","150","0","0","150","150","2.3571428571429"
"2","2018","28","Hotel","8","3","17","33","1","1","18","34","1"
"2","2018","28","Hotel","2","29","73","218","84","252","157","470","2"
"2","2018","28","Otros","9","22","225","525","0","0","225","525","3.25"
"2","2018","28","Hotel","10","27","234","376","149","295","383","671","1"
"2","2018","28","Hotel","11","36","209","676","44","155","253","831","2.375"
"2","2018","28","Hotel","9","37","136","266","36","63","172","329","3.4"
"2","2018","28","Otros","14","27","30","60","4","8","34","68","11.833333333333"
"2","2018","28","Otros","7","38","520","1359","2","2","522","1361","1"
"2","2018","28","Hotel","2","1","10","150","0","0","10","150","6.4"
"2","2018","28","Otros","2","29","0","0","52","212","52","212","3.28"
"2","2018","28","Hotel","6","27","4","31","0","0","4","31","3"
"2","2018","28","Otros","5","9","21","161","0","0","21","161","4.0454545454545"
"2","2018","28","Hotel","2","1","103","163","0","0","103","163","6.4"
"2","2018","28","Hotel","10","27","160","327","160","196","320","523","1"
"2","2018","28","Hotel","3","7","9","12","26","37","35","49","1"
"2","2018","28","Otros","7","38","22","25","21","27","43","52","2.75"
"2","2018","0","Otros","12","24","0","0","0","0","0","0","1"
"2","2018","28","Otros","7","17","29","47","7","23","36","70","17.166666666667"
"2","2018","28","Otros","7","38","94","206","0","0","94","206","2.75"
"2","2018","28","Otros","4","21","121","132","2","2","123","134","4.8333333333333"
"2","2018","28","Otros","2","1","43","43","7","7","50","50","5.5"
"2","2018","28","Otros","12","35","229","347","82","100","311","447","3.5"
"2","2018","28","Otros","3","4","6","14","0","0","6","14","1"
"2","2018","28","Otros","12","35","32","128","33","98","65","226","3.5"
"2","2018","28","Otros","4","21","52","112","8","28","60","140","4.8333333333333"
"2","2018","28","Otros","12","24","40","60","55","90","95","150","9.2"
"2","2018","28","Otros","16","19","20","34","8","14","28","48","10.263157894737"
"2","2018","28","Otros","9","30","40","159","0","0","40","159","1"
"2","2018","28","Otros","10","11","348","618","12","18","360","636","11.764705882353"
"2","2018","28","Otros","16","19","141","372","0","0","141","372","10.263157894737"
"2","2018","28","Hotel","2","27","87","206","3","6","90","212","1"
"2","2018","28","Otros","6","28","300","553","15","24","315","577","4.65"
"2","2018","28","Otros","10","18","224","608","53","153","277","761","10.25"
"2","2018","28","Otros","14","27","35","239","4","12","39","251","11.833333333333"
"2","2018","28","Hotel","16","19","155","376","0","0","155","376","1"
"2","2018","28","Hotel","11","32","243","477","0","0","243","477","1"
"2","2018","28","Hotel","7","17","93","357","8","38","101","395","1"
"2","2018","28","Otros","8","27","18","18","0","0","18","18","9.4"
"2","2018","28","Hotel","12","35","122","267","102","159","224","426","1.7272727272727"
"2","2018","28","Otros","13","14","96","136","0","0","96","136","7.3846153846154"
"2","2018","28","Hotel","11","15","135","1063","0","0","135","1063","1"
"2","2018","28","Otros","16","19","123","420","20","55","143","475","4"
"2","2018","28","Otros","11","36","114","221","12","12","126","233","5.1904761904762"
"2","2018","28","Otros","10","23","50","79","23","35","73","114","1"
"2","2018","28","Otros","16","20","231","445","5","8","236","453","3.0769230769231"
"2","2018","28","Hotel","14","31","73","117","490","744","563","861","7.8"
"2","2018","28","Otros","2","27","227","573","9","15","236","588","3.2"
"2","2018","28","","16","40","578","3721","0","0","578","3721","3.0555555555556"
"2","2018","28","Hotel","11","36","142","224","37","70","179","294","2.375"
"2","2018","28","Hotel","9","22","84","135","4","6","88","141","2.5555555555556"
"2","2018","28","Otros","6","10","490","1062","0","0","490","1062","1"
"2","2018","28","Otros","2","29","43","78","38","60","81","138","3.28"
"2","2018","28","Hotel","10","27","63","73","206","251","269","324","2.25"
"2","2018","28","Hotel","10","18","82","148","55","100","137","248","1"
"2","2018","28","Otros","10","27","8","55","0","0","8","55","4.84"
"2","2018","28","Hotel","16","19","88","118","4","8","92","126","4"
"2","2018","20","Otros","2","6","6","17","0","0","6","17","5"
"2","2018","28","Otros","7","27","383","1478","9","51","392","1529","4.8333333333333"
"2","2018","28","Hotel","2","6","75","705","0","0","75","705","5.5"
"2","2018","28","Hotel","6","28","5","5","5","5","10","10","2.4"
"2","2018","28","Otros","6","10","321","972","0","0","321","972","3.8518518518518"
"2","2018","28","Hotel","6","27","60","93","4","7","64","100","3"
"2","2018","28","Otros","6","10","170","368","14","33","184","401","1"
"2","2018","28","Otros","5","9","130","194","46","69","176","263","5.5"
"2","2018","28","Otros","5","5","43","63","12","17","55","80","3.65625"
"2","2018","28","Otros","12","24","54","140","52","103","106","243","9.2"
"2","2018","28","Hotel","8","2","174","312","12","12","186","324","3"
"2","2018","28","Hotel","11","32","14","60","3","6","17","66","1"
"2","2018","28","Otros","10","18","64","202","42","145","106","347","10.25"
"2","2018","28","Hotel","9","37","96","161","29","48","125","209","3.4"
"2","2018","28","Otros","5","9","137","234","123","168","260","402","4.0454545454545"
"2","2018","28","Otros","12","24","38","96","30","61","68","157","9.2"
"2","2018","28","Otros","9","22","54","71","0","0","54","71","7.6428571428571"
"2","2018","28","Otros","2","29","17","21","21","41","38","62","3.28"
"2","2018","28","Otros","10","23","25","444","4","4","29","448","7"
"2","2018","28","Otros","7","27","172","260","0","0","172","260","1"
"2","2018","28","Otros","10","27","48","48","17","17","65","65","3"
"2","2018","28","Otros","10","27","75","297","2","6","77","303","4.84"
"2","2018","28","Otros","10","11","88","88","0","0","88","88","11.764705882353"
"2","2018","28","Otros","10","11","40","397","2","30","42","427","1"
"2","2018","28","Otros","8","3","156","930","15","75","171","1005","10"
"2","2018","28","Otros","14","31","58","116","359","611","417","727","20.2"
"2","2018","28","Otros","2","29","372","1006","166","418","538","1424","3.28"
"2","2018","28","Otros","6","25","188","391","0","0","188","391","1"
"2","2018","28","Otros","10","18","115","348","87","306","202","654","4.6"
"2","2018","28","Hotel","15","16","27","70","25","75","52","145","7.8"
"2","2018","28","Otros","13","33","95","196","19","42","114","238","1"
"2","2018","28","Otros","8","27","51","56","0","0","51","56","1"
"2","2018","28","Hotel","15","27","212","321","13","94","225","415","1"
"2","2018","28","Otros","10","27","15","30","7","39","22","69","4.84"
"2","2018","28","Otros","10","23","108","108","2","2","110","110","7"
"2","2018","28","Otros","6","27","56","177","0","0","56","177","3.960088691796"
"2","2018","28","Otros","16","40","148","236","0","0","148","236","28.142857142857"
"2","2018","28","Otros","11","36","384","744","39","62","423","806","5.1904761904762"
"2","2018","28","Otros","8","34","40","78","37","39","77","117","5.75"
"2","2018","28","Otros","6","12","89","131","1","1","90","132","1.8256578947368"
"2","2018","28","Otros","6","10","168","294","0","0","168","294","3.8518518518518"
"2","2018","28","Otros","8","27","362","709","14","14","376","723","1"
"2","2018","28","Otros","8","2","77","231","31","45","108","276","1"
"2","2018","28","Hotel","12","24","40","40","193","193","233","233","1"
"2","2018","28","Hotel","4","21","273","372","21","23","294","395","3"
"2","2018","28","Otros","7","27","186","266","2","10","188","276","1"
"2","2018","28","Hotel","11","36","207","463","24","36","231","499","2.375"
"2","2018","28","Otros","5","8","173","238","131","174","304","412","5"
"2","2018","28","Hotel","7","17","156","214","0","0","156","214","10"
"2","2018","24","Hotel","11","36","545","899","10","28","555","927","1"
"2","2018","28","Otros","9","30","146","225","0","0","146","225","2.3333333333333"
"2","2018","28","Otros","5","8","0","0","38","179","38","179","9"
"2","2018","28","Hotel","12","35","66","152","117","230","183","382","1.7272727272727"
"2","2018","28","Otros","2","1","63","218","4","10","67","228","5.5"
"2","2018","28","Hotel","6","25","173","193","0","0","173","193","1"
"2","2018","28","Otros","5","5","22","32","39","76","61","108","3.65625"
"2","2018","28","Otros","2","29","62","104","127","232","189","336","3.28"
"2","2018","28","Hotel","2","6","14","17","32","33","46","50","5.5"
"2","2018","28","Otros","7","17","53","149","8","25","61","174","17.166666666667"
"2","2018","28","Hotel","8","2","54","78","19","19","73","97","3"
"2","2018","28","Hotel","13","14","91","228","0","0","91","228","1"
"2","2018","28","Otros","7","38","135","356","14","36","149","392","2.75"
"2","2018","28","Hotel","14","31","5","5","70","158","75","163","24"
"2","2018","28","Hotel","5","5","73","98","111","188","184","286","2.1428571428571"
"2","2018","28","Otros","2","27","6","8","20","22","26","30","3.2"
"2","2018","28","Otros","12","24","38","84","65","120","103","204","1"
"2","2018","28","Otros","5","8","20","37","43","69","63","106","5"
"2","2018","28","Otros","3","4","89","279","22","74","111","353","12.2"
"2","2018","28","Otros","13","14","55","122","0","0","55","122","7.3846153846154"
"2","2018","28","Otros","9","37","54","102","0","0","54","102","4.5"
"2","2018","28","Hotel","10","23","1329","1598","150","221","1479","1819","1"
"2","2018","28","Otros","11","32","58","68","0","0","58","68","2.2857142857143"
"2","2018","28","Otros","10","11","139","227","0","0","139","227","1"
"2","2018","28","Otros","11","15","5","7","0","0","5","7","2.3571428571429"
"2","2018","28","Otros","8","3","174","662","26","79","200","741","10"
"2","2018","28","Otros","16","20","197","988","0","0","197","988","3.0769230769231"
"2","2018","28","Otros","10","18","67","81","11","21","78","102","4.6"
"2","2018","28","Otros","8","3","119","468","0","0","119","468","10"
"2","2018","28","Otros","16","27","537","2010","0","0","537","2010","2"
"2","2018","28","Otros","16","19","47","95","0","0","47","95","4"
"2","2018","28","Hotel","16","19","27","35","2","2","29","37","4"
"2","2018","28","Hotel","16","27","71","233","4","24","75","257","5.8571428571429"
"2","2018","28","Otros","12","35","39","39","39","39","78","78","2.6666666666667"
"2","2018","28","Otros","9","26","58","75","33","98","91","173","3.8888888888889"
"2","2018","28","Otros","5","5","14","24","9","16","23","40","3.65625"
"2","2018","28","Otros","14","27","13","42","2","8","15","50","11.833333333333"
"2","2018","28","Hotel","5","5","7","12","53","291","60","303","2.1428571428571"
"2","2018","28","Hotel","12","24","100","318","88","224","188","542","3"
"2","2018","28","Otros","16","27","76","352","0","0","76","352","13.818181818182"
"2","2018","28","Otros","7","27","44","56","0","0","44","56","1"
"2","2018","28","Otros","8","3","123","420","36","128","159","548","1"
"2","2018","28","Otros","9","37","106","411","0","0","106","411","2"
"2","2018","28","Otros","13","27","299","404","16","25","315","429","12.2"
"2","2018","28","Hotel","16","40","67","92","31","69","98","161","16.333333333333"
"2","2018","28","Otros","11","36","34","261","0","0","34","261","1"
"2","2018","28","Otros","10","27","114","287","61","87","175","374","4.84"
"2","2018","28","Hotel","7","38","101","177","7","14","108","191","1"
"2","2018","28","Otros","13","33","291","424","0","0","291","424","1"
"2","2018","28","Otros","9","22","135","288","0","0","135","288","7.6428571428571"
"2","2018","28","Hotel","8","3","30","43","0","0","30","43","1"
"2","2018","28","Hotel","5","5","31","35","44","61","75","96","2.1428571428571"
"2","2018","28","Otros","2","29","66","186","83","197","149","383","3.28"
"2","2018","28","Otros","2","29","6","10","9","20","15","30","3.28"
"2","2018","28","Otros","2","29","25","88","20","54","45","142","1"
"2","2018","28","Hotel","7","17","68","167","30","155","98","322","1"
"2","2018","28","Hotel","13","14","173","308","9","9","182","317","1"
"2","2018","28","Otros","6","25","1","2","0","0","1","2","2.3846153846154"
"2","2018","28","Otros","2","1","8","10","2","4","10","14","5.5"
"2","2018","28","Hotel","12","27","53","90","70","82","123","172","1"
"2","2018","28","Hotel","13","27","19","22","0","0","19","22","4.2"
"2","2018","28","Otros","6","12","83","230","1","2","84","232","1.8256578947368"
"2","2018","28","Otros","6","27","56","67","0","0","56","67","3.960088691796"
"2","2018","28","Otros","6","25","182","287","0","0","182","287","2.3846153846154"
"2","2018","28","Otros","6","25","55","163","15","49","70","212","1"
"2","2018","28","Hotel","6","28","18","62","0","0","18","62","2.5833333333333"
"2","2018","19","Otros","6","27","14","42","0","0","14","42","3.6666666666667"
"2","2018","28","Otros","5","5","3","5","2","2","5","7","3.65625"
"2","2018","28","Otros","5","9","11","13","3","4","14","17","4.0454545454545"
"2","2018","28","Otros","5","8","21","37","13","19","34","56","5"
"2","2018","28","Hotel","2","29","181","440","171","472","352","912","1"
"2","2018","28","Otros","5","5","213","332","62","97","275","429","3.65625"
"2","2018","28","Hotel","9","26","34","87","6","13","40","100","1.5"
"2","2018","28","Otros","9","30","15","20","0","0","15","20","2.3333333333333"
"2","2018","28","Otros","11","15","33","261","2","4","35","265","2.3571428571429"
"2","2018","28","Hotel","16","27","0","0","8","12","8","12","5.8571428571429"
"2","2018","28","Otros","9","30","43","87","3","12","46","99","2.3333333333333"
"2","2018","28","Otros","11","15","194","288","7","8","201","296","1"
"2","2018","28","Otros","2","29","13","24","48","144","61","168","3.28"
"2","2018","28","Otros","7","38","78","195","8","13","86","208","2.75"
"2","2018","28","Otros","4","21","160","595","13","32","173","627","4.8333333333333"
"2","2018","28","Otros","9","22","108","311","0","0","108","311","7.6428571428571"
"2","2018","28","Otros","9","22","176","408","0","0","176","408","7.6428571428571"
"2","2018","28","Otros","13","27","35","181","0","0","35","181","12.2"
"2","2018","28","Otros","8","3","155","348","8","28","163","376","14.75"
"2","2018","28","Otros","11","32","14","16","0","0","14","16","1"
"2","2018","28","Hotel","11","36","3999","4099","148","217","4147","4316","1"
"2","2018","28","Otros","13","33","21","30","3","3","24","33","5.125"
"2","2018","28","Otros","11","36","109","301","95","265","204","566","5.1904761904762"
"2","2018","28","Otros","12","35","102","180","217","301","319","481","3.5"
"2","2018","28","Otros","12","35","17","61","23","42","40","103","3.5"
"2","2018","28","Otros","16","40","21","56","0","0","21","56","1"
"2","2018","28","Otros","10","11","104","285","21","60","125","345","11.764705882353"
"2","2018","28","Otros","12","24","12","32","30","60","42","92","9.2"
"2","2018","28","Otros","16","20","65","310","0","0","65","310","3.0769230769231"
"2","2018","28","Hotel","7","27","27","29","2","2","29","31","1"
"2","2018","28","Otros","13","27","66","114","0","0","66","114","9"
"2","2018","28","Otros","6","12","12","19","0","0","12","19","1.8256578947368"
"2","2018","28","Otros","11","32","205","400","31","115","236","515","2.2857142857143"
"2","2018","28","Otros","6","28","396","517","0","0","396","517","4.65"
"2","2018","28","Otros","8","34","1","1","0","0","1","1","5.75"
"2","2018","28","Otros","16","27","76","103","0","0","76","103","13.818181818182"
"2","2018","28","Otros","10","27","18","18","6","12","24","30","3"
"2","2018","28","Otros","10","11","21","21","0","0","21","21","11.764705882353"
"2","2018","28","Otros","6","10","115","420","10","20","125","440","3.8518518518518"
"2","2018","28","Otros","8","3","6","6","0","0","6","6","10"
"2","2018","28","Hotel","16","20","49","184","34","154","83","338","1"
"2","2018","28","Hotel","11","32","74","179","0","0","74","179","1"
"2","2018","28","Otros","8","27","45","255","13","13","58","268","9.4"
"2","2018","28","Otros","12","27","57","122","44","74","101","196","3.4285714285714"
"2","2018","28","Otros","6","10","92","337","2","2","94","339","3.8518518518518"
"2","2018","28","Otros","6","10","11","95","0","0","11","95","3.8518518518518"
"2","2018","28","Otros","5","8","107","126","24","24","131","150","5"
"2","2018","28","Otros","5","8","104","121","36","38","140","159","5"
"2","2018","18","Otros","5","9","13","17","4","7","17","24","5.5"
"2","2018","28","Hotel","9","26","58","79","14","18","72","97","1.5"
"2","2018","28","Hotel","13","14","6","52","4","6","10","58","1"
"2","2018","28","Otros","10","18","92","432","10","30","102","462","10.25"
"2","2018","28","Otros","8","2","92","95","25","26","117","121","6.4285714285714"
"2","2018","28","Otros","7","27","27","35","2","2","29","37","4.8333333333333"
"2","2018","28","Otros","2","29","6","24","44","174","50","198","1"
"2","2018","28","Otros","2","29","34","108","21","57","55","165","3.28"
"2","2018","28","Otros","11","32","51","59","18","20","69","79","2.2857142857143"
"2","2018","28","Otros","9","30","55","190","0","0","55","190","2.3333333333333"
"2","2018","28","Otros","2","29","31","83","5","19","36","102","3.28"
"2","2018","28","Otros","5","5","36","44","15","20","51","64","3.65625"
"2","2018","28","Otros","11","15","22","24","3","3","25","27","2.3571428571429"
"2","2018","28","Otros","10","23","120","120","64","64","184","184","7"
"2","2018","28","Otros","11","36","123","193","28","34","151","227","5.1904761904762"
"2","2018","28","Hotel","3","7","26","52","32","48","58","100","1"
"2","2018","28","Otros","10","27","63","71","18","22","81","93","4.84"
"2","2018","28","Otros","2","27","12","12","0","0","12","12","3.2"
"2","2018","28","Otros","12","35","50","134","33","69","83","203","3.5"
"2","2018","28","Otros","10","27","41","116","24","45","65","161","4.84"
"2","2018","28","Otros","16","40","19","40","113","226","132","266","28.142857142857"
"2","2018","28","Hotel","8","3","240","696","63","120","303","816","4.1111111111111"
"2","2018","28","Otros","9","22","192","541","0","0","192","541","7.6428571428571"
"2","2018","28","Otros","13","14","95","252","0","0","95","252","7.3846153846154"
"2","2018","28","Otros","5","9","18","29","6","15","24","44","4.0454545454545"
"2","2018","28","Otros","10","18","121","199","34","78","155","277","10.25"
"2","2018","28","Otros","6","25","195","549","14","24","209","573","2.3846153846154"
"2","2018","28","Otros","9","22","126","422","0","0","126","422","7.6428571428571"
"2","2018","28","Otros","10","27","128","183","12","12","140","195","4.84"
"2","2018","28","Otros","9","22","74","211","0","0","74","211","3.25"
"2","2018","28","Otros","16","20","100","240","5","5","105","245","3.0769230769231"
"2","2018","28","Otros","13","14","139","375","0","0","139","375","1"
"2","2018","28","Otros","16","19","20","44","0","0","20","44","4"
"2","2018","28","Hotel","7","17","235","684","18","27","253","711","10"
"2","2018","28","Otros","15","27","73","132","12","12","85","144","1.4222222222222"
"2","2018","28","Otros","12","35","43","58","23","36","66","94","3.5"
"2","2018","28","Otros","12","35","18","24","137","181","155","205","3.5"
"2","2018","28","Otros","3","7","22","36","1","6","23","42","2"
"2","2018","28","Otros","10","11","36","56","12","20","48","76","11.764705882353"
"2","2018","19","Otros","12","24","9","15","23","40","32","55","9.2"
"2","2018","28","Otros","10","23","56","100","0","0","56","100","7"
"2","2018","28","Otros","7","27","17","31","0","0","17","31","4.8333333333333"
"2","2018","28","","10","18","22","28","6","6","28","34","1"
"2","2018","28","Otros","10","18","32","190","0","0","32","190","4.6"
"2","2018","28","Otros","8","2","11","11","0","0","11","11","1"
"2","2018","28","Otros","16","27","0","0","11","11","11","11","13.818181818182"
"2","2018","20","Hotel","2","29","0","0","35","122","35","122","1"
"2","2018","28","Otros","14","27","15","17","0","0","15","17","11.833333333333"
"2","2018","28","Otros","11","32","179","236","5","5","184","241","2.2857142857143"
"2","2018","28","Otros","16","19","700","1580","0","0","700","1580","1"
"2","2018","28","Otros","16","27","32","71","0","0","32","71","13.818181818182"
"2","2018","28","Otros","8","3","77","561","3","9","80","570","10"
"2","2018","28","Otros","16","27","111","552","0","0","111","552","13.818181818182"
"2","2018","28","Otros","16","20","60","193","8","8","68","201","3.0769230769231"
"2","2018","28","Otros","11","36","34","93","5","10","39","103","3.25"
"2","2018","28","Otros","8","2","160","386","22","39","182","425","1"
"2","2018","28","Otros","16","40","169","541","36","70","205","611","28.142857142857"
"2","2018","28","Hotel","11","36","115","200","32","61","147","261","2.375"
"2","2018","28","Otros","7","17","88","464","0","0","88","464","3"
"2","2018","28","Otros","6","10","62","108","0","0","62","108","3.8518518518518"
"2","2018","28","Otros","7","38","197","561","15","55","212","616","2.75"
"2","2018","28","Otros","13","14","127","214","2","2","129","216","7.3846153846154"
"2","2018","28","Otros","9","30","35","44","10","10","45","54","2.3333333333333"
"2","2018","28","Otros","13","27","17","40","0","0","17","40","12.2"
"2","2018","28","Otros","10","27","10","20","32","32","42","52","4.84"
"2","2018","28","Otros","6","25","118","136","65","79","183","215","2.3846153846154"
"2","2018","28","Otros","9","26","23","472","0","0","23","472","3.8888888888889"
"2","2018","28","Otros","10","18","33","134","18","45","51","179","10.25"
"2","2018","28","Otros","2","29","50","134","0","0","50","134","3.28"
"2","2018","28","Otros","6","25","170","331","0","0","170","331","2.3846153846154"
"2","2018","28","Otros","6","25","43","49","0","0","43","49","1"
"2","2018","28","Otros","6","27","129","339","0","0","129","339","3.6666666666667"
"2","2018","28","Otros","5","9","20","26","0","0","20","26","4.0454545454545"
"2","2018","28","Otros","5","9","62","102","27","44","89","146","4.0454545454545"
"2","2018","28","Hotel","9","37","43","75","0","0","43","75","3.4"
"2","2018","28","Hotel","7","38","154","254","18","23","172","277","1"
"2","2018","28","Otros","7","27","101","118","0","0","101","118","4.8333333333333"
"2","2018","28","Otros","5","9","16","16","0","0","16","16","4.0454545454545"
"2","2018","28","Otros","10","27","36","302","6","6","42","308","4.84"
"2","2018","28","Otros","7","27","36","36","0","0","36","36","4.8333333333333"
"2","2018","28","Otros","16","40","16","38","29","61","45","99","28.142857142857"
"2","2018","28","Otros","10","23","35","35","4","4","39","39","7"
"2","2018","28","Otros","15","16","76","403","2","40","78","443","9"
"2","2018","27","Otros","3","7","6","14","78","176","84","190","2"
"2","2018","28","Otros","7","17","44","123","22","58","66","181","17.166666666667"
"2","2018","28","Otros","8","27","172","183","5","5","177","188","9.4"
"2","2018","24","Otros","11","36","112","245","0","0","112","245","3.25"
"2","2018","28","Otros","9","22","85","520","0","0","85","520","7.6428571428571"
"2","2018","28","Otros","16","19","20","100","0","0","20","100","10.263157894737"
"2","2018","28","Otros","13","14","87","215","0","0","87","215","1"
"2","2018","28","Otros","5","9","148","191","35","70","183","261","5.5"
"2","2018","0","","15","27","0","0","0","0","0","0","1"
"2","2018","28","Hotel","16","19","210","379","13","23","223","402","1"
"2","2018","28","Hotel","10","11","68","68","41","41","109","109","5.6666666666667"
"2","2018","28","Otros","2","27","3","4","2","2","5","6","3.2"
"2","2018","28","Otros","8","2","87","105","76","89","163","194","6.4285714285714"
"2","2018","28","Otros","5","5","7","7","0","0","7","7","3.65625"
"2","2018","28","Otros","12","35","17","20","27","48","44","68","3.5"
"2","2018","28","Otros","8","3","32","130","54","153","86","283","10"
"2","2018","28","Otros","12","24","0","0","89","105","89","105","9.2"
"2","2018","28","Otros","11","32","107","501","6","8","113","509","2.2857142857143"
"2","2018","28","Otros","10","27","228","387","124","194","352","581","4.84"
"2","2018","28","Hotel","9","22","83","260","0","0","83","260","1"
"2","2018","28","Otros","11","15","84","385","4","16","88","401","2.3571428571429"
"2","2018","28","Otros","5","8","46","102","10","18","56","120","5"
"2","2018","28","Otros","14","27","34","34","0","0","34","34","11.833333333333"
"2","2018","28","Otros","13","27","320","604","31","60","351","664","12.2"
"2","2018","28","Otros","13","33","53","162","0","0","53","162","1"
"2","2018","28","Hotel","10","18","246","249","111","111","357","360","3.2"
"2","2018","28","Otros","6","25","213","349","0","0","213","349","1"
"2","2018","28","Otros","13","14","6","6","2","2","8","8","3.25"
"2","2018","28","Otros","10","23","7","16","1","2","8","18","1"
"2","2018","28","Otros","10","27","39","39","26","26","65","65","4.84"
"2","2018","28","Otros","13","14","41","316","4","12","45","328","3.25"
"2","2018","28","Otros","10","11","113","332","2","2","115","334","1"
"2","2018","28","Otros","15","16","7","11","0","0","7","11","1"
"2","2018","28","Otros","11","32","25","30","0","0","25","30","1"
"2","2018","28","Otros","9","37","29","50","0","0","29","50","4.5"
"2","2018","28","Otros","12","35","71","71","238","239","309","310","3.5"
"2","2018","28","Otros","8","34","85","169","28","83","113","252","5.75"
"2","2018","28","Hotel","16","40","32","38","42","70","74","108","16.333333333333"
"2","2018","28","Hotel","10","11","67","323","26","190","93","513","5.6666666666667"
"2","2018","28","Otros","7","27","12","62","0","0","12","62","4.8333333333333"
"2","2018","28","Hotel","7","38","25","29","0","0","25","29","1"
"2","2018","28","Otros","6","27","1","1","0","0","1","1","3.960088691796"
"2","2018","28","Otros","6","10","130","412","0","0","130","412","3.8518518518518"
"2","2018","28","Otros","6","25","418","1410","0","0","418","1410","1"
"2","2018","28","Otros","6","25","35","56","6","22","41","78","2.3846153846154"
"2","2018","28","Otros","6","27","8","224","0","0","8","224","3.960088691796"
"2","2018","28","Otros","6","10","165","450","0","0","165","450","1"
"2","2018","28","Otros","6","25","212","442","0","0","212","442","1"
"2","2018","28","Otros","6","27","191","547","0","0","191","547","3.960088691796"
"2","2018","28","Otros","5","5","15","18","5","8","20","26","3.65625"
"2","2018","28","Otros","5","5","11","16","0","0","11","16","3.65625"
"2","2018","28","Otros","5","8","38","60","13","20","51","80","9"
"2","2018","28","Otros","10","23","30","37","2","2","32","39","1"
"2","2018","28","Otros","3","4","82","121","12","32","94","153","12.2"
"2","2018","28","Otros","10","23","41","64","136","229","177","293","1"
"2","2018","28","Otros","10","23","27","64","2","2","29","66","7"
"2","2018","28","Otros","8","3","38","164","0","0","38","164","10"
"2","2018","28","Otros","13","14","30","46","14","42","44","88","3.25"
"2","2018","28","Otros","5","5","40","87","0","0","40","87","3.65625"
"2","2018","28","Otros","5","8","39","62","22","35","61","97","5"
"2","2018","28","Otros","6","10","142","428","4","16","146","444","3.8518518518518"
"2","2018","28","Otros","16","19","64","213","0","0","64","213","10.263157894737"
"2","2018","28","Otros","10","18","67","256","22","104","89","360","4.6"
"2","2018","28","Otros","11","15","72","183","2","4","74","187","2.3571428571429"
"2","2018","28","Otros","7","38","99","151","0","0","99","151","2.75"
"2","2018","28","Otros","11","32","224","578","22","43","246","621","2.2857142857143"
"2","2018","28","Otros","8","2","90","219","11","11","101","230","6.4285714285714"
"2","2018","28","Otros","10","27","43","145","7","8","50","153","4.84"
"2","2018","28","Otros","6","27","101","207","0","0","101","207","3.960088691796"
"2","2018","28","Otros","6","28","30","70","0","0","30","70","1"
"2","2018","28","Otros","13","14","86","199","6","12","92","211","1"
"2","2018","28","Otros","11","32","117","274","0","0","117","274","2.2857142857143"
"2","2018","28","Otros","8","34","71","85","40","62","111","147","5.75"
"2","2018","28","Otros","11","32","41","61","2","2","43","63","2.2857142857143"
"2","2018","28","Otros","10","18","54","57","20","37","74","94","4.6"
"2","2018","28","Otros","10","11","50","78","4","4","54","82","11.764705882353"
"2","2018","28","Otros","11","32","67","171","3","6","70","177","2.2857142857143"
"2","2018","28","Otros","14","31","0","0","18","34","18","34","20.2"
"2","2018","28","Hotel","8","3","251","671","51","116","302","787","1"
"2","2018","28","Hotel","14","31","78","176","656","2534","734","2710","17.4"
"2","2018","28","Otros","11","36","501","926","21","55","522","981","5.1904761904762"
"2","2018","28","Hotel","15","16","1317","2848","271","582","1588","3430","2"
"2","2018","28","Otros","15","27","15","20","2","2","17","22","1.4222222222222"
"2","2018","28","Otros","5","5","7","7","24","49","31","56","3.65625"
"2","2018","28","Otros","8","34","19","20","5","5","24","25","5.75"
"2","2018","28","Otros","13","14","30","72","0","0","30","72","3.25"
"2","2018","28","Otros","7","27","51","214","0","0","51","214","4.8333333333333"
"2","2018","28","Otros","12","35","10","20","22","46","32","66","3.5"
"2","2018","28","Otros","5","5","62","86","8","12","70","98","3.65625"
"2","2018","28","Otros","10","11","5","14","9","18","14","32","11.764705882353"
"2","2018","28","Otros","10","11","9","21","3","4","12","25","11.764705882353"
"2","2018","28","Otros","9","30","5","100","0","0","5","100","2.3333333333333"
"2","2018","28","Otros","8","2","74","239","0","0","74","239","6.4285714285714"
"2","2018","28","Otros","10","27","113","179","61","83","174","262","4.84"
"2","2018","28","Otros","5","9","0","0","46","60","46","60","4.0454545454545"
"2","2018","3","Otros","10","27","0","0","4","6","4","6","3"
"2","2018","28","Otros","6","27","99","356","0","0","99","356","3.960088691796"
"2","2018","28","Otros","6","10","208","479","8","32","216","511","3.8518518518518"
"2","2018","28","Otros","6","10","146","395","0","0","146","395","3.8518518518518"
"2","2018","28","Otros","6","27","63","96","0","0","63","96","3.960088691796"
"2","2018","28","Otros","6","12","5","46","0","0","5","46","1.8256578947368"
"2","2018","28","Otros","6","10","81","333","0","0","81","333","3.8518518518518"
"2","2018","28","Otros","6","10","97","286","0","0","97","286","3.8518518518518"
"2","2018","28","Otros","6","27","39","78","0","0","39","78","3.960088691796"
"2","2018","28","Otros","6","12","169","359","0","0","169","359","1.8256578947368"
"2","2018","28","Otros","6","10","32","45","0","0","32","45","3.8518518518518"
"2","2018","28","Hotel","6","25","161","402","0","0","161","402","1"
"2","2018","28","Otros","6","10","32","90","0","0","32","90","1"
"2","2018","11","Otros","6","27","16","16","0","0","16","16","3.960088691796"
"2","2018","28","Otros","5","9","29","60","4","9","33","69","4.0454545454545"
"2","2018","28","Otros","5","5","28","75","16","47","44","122","3.65625"
"2","2018","28","Otros","5","5","37","70","3","12","40","82","3.65625"
"2","2018","28","Otros","5","5","99","194","43","88","142","282","3.65625"
"2","2018","28","Otros","5","9","75","144","43","70","118","214","5.5"
"2","2018","28","Otros","11","36","118","530","23","60","141","590","5.1904761904762"
"2","2018","28","Otros","10","27","4","8","0","0","4","8","3"
"2","2018","28","Otros","10","11","53","84","2","4","55","88","1"
"2","2018","28","Hotel","6","10","1089","3081","38","67","1127","3148","1"
"2","2018","28","Otros","5","9","37","61","7","17","44","78","4.0454545454545"
"2","2018","28","Otros","5","8","28","47","55","108","83","155","5"
"2","2018","0","Hotel","15","27","0","0","0","0","0","0","1"
"2","2018","28","Hotel","3","4","240","1041","21","74","261","1115","3"
"2","2018","28","Otros","3","7","19","19","9","9","28","28","1"
"2","2018","28","Otros","7","38","176","519","4","6","180","525","2.75"
"2","2018","28","Hotel","10","27","200","242","178","243","378","485","1"
"2","2018","28","Hotel","12","35","11","13","148","283","159","296","1.7272727272727"
"2","2018","28","Hotel","10","27","6","6","0","0","6","6","2.25"
"2","2018","28","Hotel","7","17","718","1631","92","187","810","1818","4"
"2","2018","15","Hotel","16","19","48","66","10","24","58","90","4"
"2","2018","28","Hotel","2","6","640","1390","0","0","640","1390","2.2"
"2","2018","28","Otros","5","5","84","513","27","160","111","673","3.65625"
"2","2018","28","Hotel","10","18","65","175","91","270","156","445","1"
"2","2018","28","Otros","12","24","45","66","164","200","209","266","9.2"
"2","2018","28","Otros","5","8","30","43","19","23","49","66","5"
"2","2018","28","Otros","4","13","186","206","8","10","194","216","1"
"2","2018","28","Otros","10","11","263","263","0","0","263","263","11.764705882353"
"2","2018","28","Otros","12","35","173","316","268","414","441","730","3.5"
"2","2018","28","Otros","10","23","192","202","36","36","228","238","7"
"2","2018","28","Otros","11","36","969","2047","133","209","1102","2256","5.1904761904762"
"2","2018","28","Otros","12","35","84","137","229","253","313","390","3.5"
"2","2018","28","Otros","11","36","169","357","8","20","177","377","5.1904761904762"
"2","2018","28","Otros","8","2","97","151","6","18","103","169","6.4285714285714"
"2","2018","28","Otros","9","30","112","411","0","0","112","411","2.3333333333333"
"2","2018","28","Otros","11","36","269","638","40","120","309","758","5.1904761904762"
"2","2018","28","Otros","6","10","93","304","0","0","93","304","3.8518518518518"
"2","2018","28","Otros","10","18","45","204","0","0","45","204","10.25"
"2","2018","28","Otros","10","11","59","267","0","0","59","267","1"
"2","2018","28","Otros","7","27","49","147","2","4","51","151","4.8333333333333"
"2","2018","28","Otros","16","20","46","184","23","92","69","276","1"
"2","2018","28","Otros","9","22","144","265","0","0","144","265","7.6428571428571"
"2","2018","28","Otros","15","16","618","700","0","0","618","700","1"
"2","2018","28","Otros","5","5","124","215","14","30","138","245","3.65625"
"2","2018","28","Otros","12","35","53","70","75","84","128","154","3.5"
"2","2018","28","Otros","10","11","29","53","0","0","29","53","11.764705882353"
"2","2018","28","Otros","10","11","17","25","0","0","17","25","11.764705882353"
"2","2018","24","Otros","5","9","50","62","26","30","76","92","4.0454545454545"
"2","2018","28","Otros","5","5","10","280","0","0","10","280","3.65625"
"2","2018","28","Otros","10","11","71","89","35","46","106","135","1"
"2","2018","28","Otros","12","35","2","2","73","116","75","118","3.5"
"2","2018","28","Otros","7","38","115","310","2","4","117","314","2.75"
"2","2018","28","Hotel","12","35","24","48","236","433","260","481","1.7272727272727"
"2","2018","28","Otros","13","14","324","651","5","20","329","671","1"
"2","2018","28","Otros","5","5","28","55","15","39","43","94","3.65625"
"2","2018","28","Otros","8","3","66","279","11","43","77","322","14.75"
"2","2018","28","Hotel","9","26","8","18","1","2","9","20","1.5"
"2","2018","28","Hotel","16","19","135","135","0","0","135","135","1"
"2","2018","28","Otros","9","22","160","240","0","0","160","240","3.25"
"2","2018","28","Otros","16","19","70","100","3","3","73","103","10.263157894737"
"2","2018","28","Otros","9","30","24","25","9","12","33","37","2.3333333333333"
"2","2018","28","Otros","16","19","39","47","0","0","39","47","10.263157894737"
"2","2018","28","Otros","16","19","153","715","0","0","153","715","10.263157894737"
"2","2018","28","Otros","9","26","17","19","0","0","17","19","3.8888888888889"
"2","2018","28","Otros","16","40","4","10","0","0","4","10","28.142857142857"
"2","2018","28","Hotel","16","27","14","23","0","0","14","23","5.8571428571429"
"2","2018","28","Otros","16","19","45","183","0","0","45","183","10.263157894737"
"2","2018","28","Otros","16","19","233","619","0","0","233","619","10.263157894737"
"2","2018","28","","9","30","213","520","51","95","264","615","1"
"2","2018","28","Otros","16","19","166","447","0","0","166","447","10.263157894737"
"2","2018","28","Otros","10","11","22","22","0","0","22","22","11.764705882353"
"2","2018","28","Otros","11","36","28","28","0","0","28","28","5.1904761904762"
"2","2018","28","Otros","16","19","10","46","0","0","10","46","10.263157894737"
"2","2018","28","Otros","16","19","192","469","3","9","195","478","1.3333333333333"
"2","2018","28","Otros","16","19","43","136","0","0","43","136","10.263157894737"
"2","2018","28","Otros","10","18","40","65","81","176","121","241","10.25"
"2","2018","28","Otros","16","19","38","38","0","0","38","38","10.263157894737"
"2","2018","28","Otros","16","19","65","157","0","0","65","157","1.3333333333333"
"2","2018","28","","9","26","210","714","0","0","210","714","1"
"2","2018","28","Otros","16","19","10","26","0","0","10","26","10.263157894737"
"2","2018","28","Otros","16","19","101","144","13","17","114","161","10.263157894737"
"2","2018","28","Hotel","8","2","820","2107","40","70","860","2177","1"
"2","2018","28","Otros","6","10","72","184","8","8","80","192","3.8518518518518"
"2","2018","28","Otros","6","25","413","1044","0","0","413","1044","1"
"2","2018","28","Otros","6","12","190","318","0","0","190","318","1.8256578947368"
"2","2018","28","Hotel","16","19","57","94","26","35","83","129","1"
"2","2018","28","Otros","3","7","6","6","18","18","24","24","2"
"2","2018","28","Hotel","2","6","722","3703","251","504","973","4207","1"
"2","2018","28","Hotel","3","4","427","569","163","247","590","816","2.6"
"2","2018","28","Hotel","16","40","2316","3888","1616","2756","3932","6644","1"
"2","2018","28","Otros","16","27","128","342","0","0","128","342","13.818181818182"
"2","2018","28","Hotel","6","28","348","467","38","48","386","515","2.4"
"2","2018","28","Hotel","8","34","2932","4090","493","871","3425","4961","1"
"2","2018","28","Otros","12","35","30","30","9","11","39","41","2.6666666666667"
"2","2018","28","Otros","9","30","12","18","0","0","12","18","2.3333333333333"
"2","2018","28","Hotel","10","18","812","812","216","216","1028","1028","1"
"2","2018","28","Hotel","9","30","241","644","0","0","241","644","1"
"2","2018","28","Hotel","15","27","32","56","0","0","32","56","1"
"2","2018","28","Hotel","9","22","143","271","0","0","143","271","2.5555555555556"
"2","2018","28","","11","15","810","1792","0","0","810","1792","1"
"2","2018","28","Otros","6","12","14","14","1","1","15","15","1.8256578947368"
"2","2018","28","Otros","6","28","0","0","24","672","24","672","1"
"2","2018","28","Hotel","15","27","30","840","0","0","30","840","1"
"2","2018","28","Otros","15","27","60","95","0","0","60","95","1.4222222222222"
"2","2018","28","Otros","15","27","7","196","0","0","7","196","1.4222222222222"
"2","2018","28","Otros","12","35","15","15","3","4","18","19","2.6666666666667"
"2","2018","28","Otros","2","1","19","19","11","11","30","30","1"
"2","2018","28","Otros","12","24","7","17","15","33","22","50","9.2"
"2","2018","28","Otros","5","5","43","68","46","107","89","175","3.65625"
"2","2018","28","Otros","6","28","224","274","2","6","226","280","1"
"2","2018","28","Hotel","7","27","409","468","80","82","489","550","1"
"2","2018","28","Otros","16","20","202","508","6","6","208","514","3.0769230769231"
"2","2018","28","Otros","10","11","7","7","0","0","7","7","1"
"2","2018","28","","10","11","400","593","32","38","432","631","1"
"2","2018","28","Hotel","16","40","63","108","35","57","98","165","16.333333333333"
"2","2018","28","Otros","12","35","19","21","4","4","23","25","3.5"
"2","2018","28","Hotel","6","27","43","64","6","11","49","75","3"
"2","2018","28","Otros","5","5","34","79","22","49","56","128","3.65625"
"2","2018","28","Hotel","6","27","155","189","4","4","159","193","3"
"2","2018","28","Otros","6","25","137","243","13","19","150","262","2.3846153846154"
"2","2018","28","Otros","9","37","49","122","0","0","49","122","19"
"2","2018","0","Hotel","15","27","0","0","0","0","0","0","1"
"2","2018","28","Otros","16","19","505","1015","5","30","510","1045","1"
"2","2018","28","Otros","5","9","57","73","41","54","98","127","4.0454545454545"
"2","2018","28","Hotel","15","27","40","80","0","0","40","80","1"
"2","2018","28","Hotel","5","9","53","99","3","12","56","111","1"
"2","2018","28","Hotel","8","34","71","168","82","132","153","300","2.5714285714286"
"2","2018","0","Hotel","15","27","0","0","0","0","0","0","1"
"2","2018","28","Hotel","6","27","303","1620","14","68","317","1688","3"
"2","2018","28","Otros","6","27","52","336","0","0","52","336","1"
"2","2018","28","Hotel","7","17","64","160","2","2","66","162","1"
"2","2018","28","Otros","12","27","5","5","53","55","58","60","3.4285714285714"
"2","2018","28","Hotel","12","35","150","228","760","1094","910","1322","1"
"2","2018","28","Hotel","2","27","457","538","257","273","714","811","1"
"2","2018","28","Hotel","10","27","104","260","89","153","193","413","1"
"2","2018","28","Hotel","2","6","348","348","0","0","348","348","1"
"2","2018","28","Otros","2","6","70","70","0","0","70","70","1"
"2","2018","28","Hotel","4","39","124","124","0","0","124","124","1"
"2","2018","28","Otros","16","27","110","154","0","0","110","154","1"
"2","2018","28","Hotel","6","10","1064","1181","84","92","1148","1273","1"
"2","2018","28","Hotel","8","3","10","29","208","599","218","628","1"
"2","2018","28","Otros","5","8","56","81","90","123","146","204","5"
"2","2018","0","Hotel","13","33","0","0","0","0","0","0","1"
"2","2018","28","Hotel","13","33","103","206","24","48","127","254","1"
"2","2018","28","Otros","11","32","242","782","10","36","252","818","2.2857142857143"
"2","2018","28","Hotel","9","26","159","258","159","197","318","455","1"
"2","2018","28","Hotel","16","20","242","449","6","15","248","464","1"
"2","2018","28","Hotel","9","37","326","826","0","0","326","826","1"
"2","2018","28","Otros","16","20","49","62","2","4","51","66","3.0769230769231"
"2","2018","28","","16","40","1042","3262","39","214","1081","3476","1"
"2","2018","28","Hotel","12","24","121","186","1976","4711","2097","4897","1"
"2","2018","28","Hotel","15","16","1505","4124","374","1771","1879","5895","1"
"2","2018","28","Hotel","5","9","29","47","89","151","118","198","1"
"2","2018","28","Otros","7","38","141","395","7","7","148","402","2.75"
"2","2018","28","Otros","2","6","2015","2015","0","0","2015","2015","1"
"2","2018","28","Otros","2","6","87","210","0","0","87","210","1"
"2","2018","28","Hotel","12","24","256","576","1595","3210","1851","3786","1"
"2","2018","0","Hotel","8","34","0","0","0","0","0","0","1"
"2","2018","28","Hotel","15","27","304","1010","44","44","348","1054","1"
"2","2018","28","Otros","7","38","178","426","0","0","178","426","2.75"
"2","2018","28","Otros","2","1","18","74","12","32","30","106","1"
"2","2018","28","Otros","8","3","175","308","16","18","191","326","10"
"2","2018","28","Hotel","12","35","14","28","100","200","114","228","2"
"2","2018","28","Otros","11","36","31","279","0","0","31","279","5.1904761904762"
"2","2018","28","Otros","16","20","112","350","0","0","112","350","3.0769230769231"
"2","2018","28","Otros","8","3","335","580","6","12","341","592","1"
"2","2018","28","Otros","4","39","136","187","0","0","136","187","2.2222222222222"
"2","2018","28","Otros","5","5","202","350","128","216","330","566","3.65625"
"2","2018","28","Otros","12","27","16","19","22","24","38","43","3.4285714285714"
"2","2018","28","Otros","7","27","92","147","19","122","111","269","1"
"2","2018","28","Hotel","2","6","345","709","41","58","386","767","1"
"2","2018","28","Otros","12","24","11","22","42","92","53","114","1"
"2","2018","28","Hotel","14","27","28","83","189","601","217","684","1"
"2","2018","28","Hotel","16","19","472","1055","0","0","472","1055","1"
"2","2018","28","","2","1","15","210","0","0","15","210","1"
"2","2018","28","Hotel","2","27","98","220","2","3","100","223","1"
"2","2018","28","Otros","16","20","158","329","0","0","158","329","1"
"2","2018","28","Otros","13","14","75","173","12","21","87","194","1"
"2","2018","28","Hotel","11","36","232","341","1","1","233","342","2.375"
"2","2018","28","Otros","13","14","19","285","0","0","19","285","7.3846153846154"
"2","2018","28","Otros","12","27","31","47","0","0","31","47","3.4285714285714"
"2","2018","28","Hotel","2","6","155","300","40","54","195","354","2.2"
"2","2018","28","Otros","2","6","871","2408","0","0","871","2408","1"
"2","2018","28","Otros","10","27","0","0","9","15","9","15","4.84"
"2","2018","28","Otros","12","27","8","11","1","1","9","12","3.4285714285714"
"2","2018","28","Otros","13","14","80","240","0","0","80","240","7.3846153846154"
"2","2018","28","Otros","6","12","100","159","11","16","111","175","1.8256578947368"
"2","2018","28","Otros","2","6","1437","3352","114","332","1551","3684","1"
"2","2018","28","Hotel","16","40","139","163","52","59","191","222","1"
"2","2018","28","Hotel","12","35","15","33","3","5","18","38","1.7272727272727"
"2","2018","28","Otros","5","5","29","41","15","35","44","76","3.65625"
"2","2018","28","Otros","11","32","59","170","0","0","59","170","1"
"2","2018","28","Otros","9","30","0","0","9","252","9","252","2.3333333333333"
"2","2018","28","Otros","11","15","11","19","0","0","11","19","1"
"2","2018","0","Hotel","8","2","0","0","0","0","0","0","1"
"2","2018","28","Otros","9","30","12","16","0","0","12","16","2.3333333333333"
"2","2018","28","Otros","10","27","15","29","5","10","20","39","3"
"2","2018","28","Hotel","15","27","70","74","0","0","70","74","1"
"2","2018","15","Hotel","3","7","6","6","0","0","6","6","1"
"2","2018","28","Otros","6","12","426","672","0","0","426","672","1.8256578947368"
"2","2018","28","Otros","12","27","31","61","24","34","55","95","3.4285714285714"
"2","2018","10","Otros","2","6","8","12","0","0","8","12","5"
"2","2018","9","Otros","6","27","19","24","0","0","19","24","3.960088691796"
"2","2018","28","Hotel","10","11","96","610","23","63","119","673","1"
"2","2018","28","Otros","2","1","6","42","0","0","6","42","1"
"2","2018","28","Hotel","4","13","2","14","0","0","2","14","1"
"2","2018","28","Otros","11","36","87","117","13","13","100","130","5.1904761904762"
"2","2018","11","Hotel","11","32","0","0","0","0","0","0","1"
"2","2018","28","Otros","2","27","6","120","0","0","6","120","1"
"2","2018","28","Otros","12","27","9","11","6","9","15","20","3.4285714285714"
"2","2018","28","Hotel","8","2","55","57","2","4","57","61","3"
"2","2018","28","Hotel","16","20","168","406","15","29","183","435","1"
"2","2018","28","Otros","12","35","42","54","108","158","150","212","3.5"
"2","2018","28","Otros","13","14","415","550","0","0","415","550","1"
"2","2018","28","Hotel","16","19","62","232","0","0","62","232","1"
"2","2018","28","Otros","2","27","53","197","0","0","53","197","3.2"
"2","2018","28","Hotel","6","27","19","19","0","0","19","19","3"
"2","2018","28","Hotel","8","3","227","641","55","165","282","806","4.1111111111111"
"2","2018","28","Hotel","12","24","145","288","178","354","323","642","1"
"2","2018","0","Hotel","15","27","0","0","0","0","0","0","1"
"2","2018","28","Otros","8","3","144","333","0","0","144","333","10"
"2","2018","28","Hotel","16","20","78","169","0","0","78","169","1"
"2","2018","28","Hotel","6","28","120","200","14","25","134","225","2.4"
"2","2018","28","Otros","7","17","80","231","0","0","80","231","3"
"2","2018","28","Otros","2","1","44","82","7","11","51","93","5.5"
"2","2018","28","Hotel","11","36","215","348","186","271","401","619","2.375"
"2","2018","28","Otros","4","13","175","786","0","0","175","786","1"
"2","2018","28","Hotel","12","35","146","377","98","169","244","546","2"
"2","2018","28","Otros","2","6","172","1204","0","0","172","1204","1"
"2","2018","28","Otros","8","34","268","369","115","187","383","556","5.75"
"2","2018","28","Hotel","11","15","33","269","0","0","33","269","1"
"2","2018","28","Otros","12","27","55","110","54","108","109","218","1"
"2","2018","28","Otros","15","27","6","30","0","0","6","30","1.4222222222222"
"2","2018","28","Otros","16","40","13","30","23","42","36","72","1"
"2","2018","28","Otros","12","27","6","24","6","36","12","60","1"
"2","2018","28","Hotel","13","14","420","642","36","62","456","704","1"
"2","2018","28","Otros","3","4","37","37","13","13","50","50","1"
"2","2018","28","Hotel","13","14","364","774","90","114","454","888","1"
"2","2018","28","Hotel","9","30","159","333","31","62","190","395","1"
"2","2018","28","Hotel","4","13","185","299","52","112","237","411","5.4"
"2","2018","28","Otros","6","27","9","20","0","0","9","20","3.960088691796"
"2","2018","0","Hotel","15","27","0","0","0","0","0","0","1"
"2","2018","28","Hotel","2","29","37","162","71","219","108","381","2"
"2","2018","28","Hotel","13","33","11","30","56","78","67","108","2"
"2","2018","28","Hotel","12","35","71","233","105","227","176","460","1.7272727272727"
"2","2018","28","Hotel","13","14","264","447","18","67","282","514","1"
"2","2018","28","Otros","6","25","64","144","0","0","64","144","2.3846153846154"
"2","2018","28","Hotel","8","2","233","385","21","22","254","407","3"
"2","2018","28","Otros","2","29","25","69","58","143","83","212","1"
"2","2018","28","Otros","4","39","65","100","0","0","65","100","2.2222222222222"
"2","2018","28","Otros","6","12","177","190","35","43","212","233","1.8256578947368"
"2","2018","28","Otros","13","33","122","395","0","0","122","395","1"
"2","2018","28","Otros","13","33","88","136","20","24","108","160","5.125"
"2","2018","28","Hotel","4","13","136","256","80","166","216","422","5.4"
"2","2018","28","Otros","12","24","21","48","27","54","48","102","1"
"2","2018","28","Hotel","7","27","166","329","0","0","166","329","4.1666666666667"
"2","2018","28","Hotel","4","13","579","1493","128","376","707","1869","1"
"2","2018","28","","5","8","39","51","12","30","51","81","1"
"2","2018","28","Otros","8","2","41","143","3","12","44","155","6.4285714285714"
"2","2018","28","Otros","6","27","176","734","8","19","184","753","3.6666666666667"
"2","2018","28","Otros","2","6","60","60","58","58","118","118","1"
"2","2018","28","","6","10","174","644","0","0","174","644","1"
"2","2018","28","Hotel","2","29","56","96","92","153","148","249","2"
"2","2018","28","","14","31","213","313","520","1586","733","1899","1"
"2","2018","28","Hotel","16","27","7691","23074","0","0","7691","23074","1"
"2","2018","28","Hotel","12","35","105","145","36","53","141","198","1.7272727272727"
"2","2018","28","","12","35","2301","3152","4388","5215","6689","8367","1"
"2","2018","28","","9","26","140","182","15","22","155","204","1"
"2","2018","28","Otros","11","32","238","390","0","0","238","390","2.2857142857143"
"2","2018","28","Otros","12","24","90","154","95","133","185","287","9.2"
"2","2018","28","Hotel","6","25","81","109","1","1","82","110","1"
"2","2018","28","Otros","7","17","46","303","0","0","46","303","3"
"2","2018","28","Otros","11","32","108","208","0","0","108","208","2.2857142857143"
"2","2018","28","Hotel","16","19","60","78","2","4","62","82","4"
"2","2018","28","Otros","8","3","77","274","24","59","101","333","14.75"
"2","2018","28","Hotel","7","17","36","58","3","3","39","61","1"
"2","2018","28","Otros","13","33","0","0","90","103","90","103","5.125"
"2","2018","28","Otros","16","27","24","89","4","27","28","116","13.818181818182"
"2","2018","28","Otros","6","12","67","198","6","9","73","207","1.8256578947368"
"2","2018","28","Otros","2","29","8","17","2","6","10","23","3.28"
"2","2018","28","Hotel","14","27","527","650","260","377","787","1027","1"
"2","2018","28","Otros","2","1","1","1","0","0","1","1","1"
"2","2018","28","Otros","11","32","99","236","0","0","99","236","2.2857142857143"
"2","2018","28","Otros","2","27","63","67","1","1","64","68","1"
"2","2018","28","Hotel","2","29","195","761","36","126","231","887","1"
"2","2018","28","Hotel","4","13","22","268","0","0","22","268","3.2"
"2","2018","28","Hotel","4","21","31","52","7","11","38","63","3"
"2","2018","28","Otros","7","27","145","180","0","0","145","180","4.8333333333333"
"2","2018","28","","3","4","94","222","23","63","117","285","1"
"2","2018","28","Hotel","6","27","38","57","12","19","50","76","3"
"2","2018","28","Otros","16","19","79","134","0","0","79","134","10.263157894737"
"2","2018","28","Otros","11","32","48","151","0","0","48","151","2.2857142857143"
"2","2018","28","Otros","3","7","14","18","18","37","32","55","2"
"2","2018","28","Otros","5","5","53","92","45","84","98","176","3.65625"
"2","2018","24","Otros","15","27","943","1534","0","0","943","1534","1.4222222222222"
"2","2018","28","Otros","6","25","309","737","0","0","309","737","2.3846153846154"
"2","2018","28","","10","27","128","268","4","4","132","272","1"
"2","2018","28","Otros","2","29","40","53","131","216","171","269","3.28"
"2","2018","28","Otros","12","35","43","87","34","55","77","142","3.5"
"2","2018","28","Otros","16","19","63","223","0","0","63","223","10.263157894737"
"2","2018","28","Otros","9","26","75","140","2","5","77","145","3.8888888888889"
"2","2018","28","Hotel","13","33","77","77","18","18","95","95","2"
"2","2018","25","Otros","11","32","48","162","2","4","50","166","2.2857142857143"
"2","2018","28","Otros","9","22","40","92","0","0","40","92","7.6428571428571"
"2","2018","28","Otros","6","27","7","65","0","0","7","65","3.960088691796"
"2","2018","28","Otros","15","27","7","7","0","0","7","7","1.4222222222222"
"2","2018","28","Otros","11","32","448","448","27","27","475","475","2.2857142857143"
"2","2018","28","Otros","11","15","61","171","3","6","64","177","2.3571428571429"
"2","2018","21","Otros","9","37","18","61","0","0","18","61","4.5"
"2","2018","28","Otros","5","9","51","78","36","53","87","131","4.0454545454545"
"2","2018","28","Hotel","10","27","26","48","0","0","26","48","2.25"
"2","2018","28","Otros","6","28","24","70","0","0","24","70","4.65"
"2","2018","28","Otros","4","13","37","63","12","18","49","81","3.4"
"2","2018","28","Otros","2","1","1","1","0","0","1","1","1"
"2","2018","28","Otros","2","29","51","102","71","128","122","230","3.28"
"2","2018","28","Hotel","8","3","132","301","13","40","145","341","4.1111111111111"
"2","2018","28","Otros","16","19","282","1515","0","0","282","1515","1.3333333333333"
"2","2018","28","Otros","12","35","12","14","35","46","47","60","3.5"
"2","2018","28","Hotel","12","35","48","62","236","265","284","327","1.7272727272727"
"2","2018","28","Otros","12","35","26","47","57","127","83","174","3.5"
"2","2018","28","Otros","2","29","30","92","69","182","99","274","3.28"
"2","2018","28","Hotel","7","27","310","475","9","13","319","488","1"
"2","2018","28","Hotel","9","22","71","108","4","4","75","112","2.5555555555556"
"2","2018","28","Hotel","12","35","52","110","204","332","256","442","1.7272727272727"
"2","2018","28","Otros","15","16","163","419","39","101","202","520","2"
"2","2018","28","Hotel","15","27","40","75","0","0","40","75","1"
"2","2018","28","Otros","4","13","112","114","30","30","142","144","3.4"
"2","2018","28","Hotel","8","34","70","208","33","50","103","258","2.5714285714286"
"2","2018","28","Hotel","16","20","80","240","0","0","80","240","1"
"2","2018","28","Hotel","6","28","167","331","31","101","198","432","2.4"
"2","2018","28","Hotel","15","27","74","290","12","19","86","309","1"
"2","2018","28","Otros","12","35","283","791","81","210","364","1001","3.5"
"2","2018","28","Otros","11","15","37","146","5","8","42","154","2.3571428571429"
"2","2018","28","Otros","11","15","119","511","9","45","128","556","2.3571428571429"
"2","2018","28","Otros","11","36","169","401","83","148","252","549","5.1904761904762"
"2","2018","28","Hotel","11","36","84","152","6","8","90","160","2.375"
"2","2018","28","Hotel","6","12","140","302","0","0","140","302","5"
"2","2018","28","Otros","8","3","216","368","62","95","278","463","10"
"2","2018","28","Otros","10","27","14","26","32","55","46","81","4.84"
"2","2018","28","Otros","8","3","65","333","4","16","69","349","10"
"2","2018","28","Otros","6","25","101","455","0","0","101","455","2.3846153846154"
"2","2018","28","Hotel","2","27","55","94","1","9","56","103","1"
"2","2018","28","Hotel","10","18","110","305","149","447","259","752","3.2"
"2","2018","28","Otros","11","32","146","1088","3","6","149","1094","1"
"2","2018","28","Hotel","6","10","3153","3713","225","322","3378","4035","1"
"2","2018","28","Otros","4","13","354","373","24","24","378","397","1"
"2","2018","28","Otros","11","32","66","144","13","31","79","175","2.2857142857143"
"2","2018","0","Otros","2","27","0","0","0","0","0","0","1"
"2","2018","0","Otros","4","13","0","0","0","0","0","0","1"
"2","2018","28","","12","24","110","316","455","1313","565","1629","1"
"2","2018","28","Hotel","16","27","660","821","8","8","668","829","5.8571428571429"
"2","2018","28","Hotel","7","38","83","207","9","14","92","221","1"
"2","2018","28","Hotel","6","12","1911","1983","13","20","1924","2003","1"
"3","2018","31","Hotel","14","31","2275","3725","8510","10325","10785","14050","1"
"3","2018","31","Hotel","14","31","1220","1747","3337","8927","4557","10674","1"
"3","2018","31","Hotel","14","31","873","1054","816","3226","1689","4280","1"
"3","2018","31","Hotel","11","32","83","186","18","32","101","218","1"
"3","2018","31","Hotel","14","27","4099","5574","842","1136","4941","6710","1"
"3","2018","31","Otros","11","32","134","269","0","0","134","269","2.2857142857143"
"3","2018","31","Hotel","14","31","622","780","3865","5341","4487","6121","5.4"
"3","2018","31","Hotel","15","16","1242","2197","120","237","1362","2434","1"
"3","2018","31","Hotel","14","31","919","1635","1021","3115","1940","4750","5.4"
"3","2018","31","Hotel","12","24","2511","3526","2896","4043","5407","7569","1"
"3","2018","31","Hotel","16","40","1285","1748","652","1174","1937","2922","1"
"3","2018","31","Hotel","6","12","1306","1841","93","199","1399","2040","1"
"3","2018","31","Hotel","10","23","1738","2266","308","412","2046","2678","1"
"3","2018","31","Hotel","14","31","1713","4328","354","893","2067","5221","5.4"
"3","2018","31","Hotel","3","4","832","1688","195","370","1027","2058","1"
"3","2018","31","","11","32","384","658","89","154","473","812","1"
"3","2018","31","Hotel","6","12","419","768","50","136","469","904","1"
"3","2018","31","Hotel","6","12","2499","3332","333","420","2832","3752","1"
"3","2018","31","Hotel","9","26","3487","6601","95","174","3582","6775","1"
"3","2018","31","Hotel","2","1","439","1683","52","421","491","2104","1"
"3","2018","31","Hotel","9","26","1131","1693","150","551","1281","2244","1"
"3","2018","31","Hotel","6","12","852","1376","127","285","979","1661","1"
"3","2018","31","Hotel","14","31","108","143","4577","8553","4685","8696","5.4"
"3","2018","31","Hotel","11","32","258","377","40","82","298","459","1"
"3","2018","31","Hotel","2","6","1346","1819","113","189","1459","2008","1"
"3","2018","31","Hotel","16","40","1739","3262","1293","2165","3032","5427","1"
"3","2018","31","Hotel","14","27","876","1450","699","1050","1575","2500","1"
"3","2018","31","Otros","11","36","47","282","0","0","47","282","1"
"3","2018","31","Hotel","10","23","1261","1695","481","788","1742","2483","1"
"3","2018","31","Hotel","14","31","631","1700","872","3338","1503","5038","7.8"
"3","2018","31","Hotel","7","17","311","741","105","239","416","980","1"
"3","2018","31","Hotel","2","1","1785","3266","0","0","1785","3266","2"
"3","2018","31","Hotel","2","1","1744","2699","317","717","2061","3416","2"
"3","2018","31","Hotel","4","13","876","1375","66","104","942","1479","1"
"3","2018","31","Hotel","2","1","834","1626","85","334","919","1960","2"
"3","2018","31","Hotel","10","27","1530","3864","1011","1951","2541","5815","1"
"3","2018","31","Hotel","14","27","399","493","1882","2117","2281","2610","1"
"3","2018","31","Hotel","14","27","2027","2771","1243","2210","3270","4981","1"
"3","2018","31","Hotel","6","12","2092","2168","115","158","2207","2326","1"
"3","2018","31","Hotel","6","12","1723","2475","653","876","2376","3351","1"
"3","2018","31","Hotel","13","27","2400","5387","5","15","2405","5402","1"
"3","2018","31","Hotel","14","31","39","63","1120","3138","1159","3201","7.8"
"3","2018","31","Hotel","6","12","1385","3930","285","870","1670","4800","1"
"3","2018","31","Hotel","16","27","2312","4288","137","265","2449","4553","1"
"3","2018","31","","10","27","59","116","0","0","59","116","1"
"3","2018","31","Hotel","10","18","730","1501","724","1522","1454","3023","1"
"3","2018","31","Hotel","9","37","2188","3467","339","710","2527","4177","1"
"3","2018","31","Hotel","16","27","1176","4708","0","0","1176","4708","1"
"3","2018","31","Hotel","15","16","846","1691","134","289","980","1980","2"
"3","2018","31","Hotel","2","1","1455","2439","277","463","1732","2902","2"
"3","2018","31","Hotel","3","4","565","1474","252","485","817","1959","1"
"3","2018","31","Hotel","16","40","1855","2286","1256","1598","3111","3884","1"
"3","2018","31","Hotel","7","17","4937","5677","504","603","5441","6280","1"
"3","2018","31","Hotel","12","24","954","1533","2331","3025","3285","4558","1"
"3","2018","31","Hotel","12","35","897","1612","1883","3239","2780","4851","1"
"3","2018","31","Hotel","2","6","462","1646","10","28","472","1674","1"
"3","2018","31","Hotel","13","33","619","825","405","589","1024","1414","1"
"3","2018","31","Hotel","10","27","1260","1736","793","1094","2053","2830","1"
"3","2018","31","Hotel","10","23","1544","2752","314","557","1858","3309","1"
"3","2018","31","Hotel","11","36","1865","2514","284","327","2149","2841","1"
"3","2018","31","Hotel","8","34","1260","2286","79","79","1339","2365","1"
"3","2018","31","Hotel","2","6","675","1536","133","275","808","1811","1"
"3","2018","31","Hotel","14","31","687","989","1337","1807","2024","2796","7.8"
"3","2018","31","Hotel","11","36","1932","2985","383","614","2315","3599","1"
"3","2018","31","","10","27","230","346","327","508","557","854","1"
"3","2018","31","Hotel","14","31","2229","3334","2409","6966","4638","10300","5.4"
"3","2018","31","Hotel","4","13","2453","2469","5","10","2458","2479","1"
"3","2018","31","Hotel","6","28","1406","1814","106","173","1512","1987","1"
"3","2018","31","Otros","14","31","201","315","146","309","347","624","2.8"
"3","2018","31","Otros","16","27","50","120","0","0","50","120","2"
"3","2018","31","Hotel","2","1","957","1638","83","130","1040","1768","2"
"3","2018","31","Hotel","10","18","882","1430","819","1373","1701","2803","1"
"3","2018","31","Hotel","7","17","1218","1683","327","511","1545","2194","1"
"3","2018","31","Hotel","12","24","595","1545","597","1512","1192","3057","1"
"3","2018","31","Hotel","10","18","1437","2404","640","1450","2077","3854","1"
"3","2018","31","Hotel","2","1","2926","3959","42","74","2968","4033","1"
"3","2018","31","Hotel","10","18","628","1405","791","1213","1419","2618","1"
"3","2018","31","Hotel","6","28","1585","1970","623","708","2208","2678","1"
"3","2018","31","Hotel","5","5","1040","1726","343","493","1383","2219","1"
"3","2018","31","Hotel","4","13","361","626","34","82","395","708","1"
"3","2018","31","Hotel","10","18","825","1344","703","1144","1528","2488","1"
"3","2018","31","Hotel","16","40","797","1452","111","199","908","1651","1"
"3","2018","31","Hotel","8","3","2889","6600","780","1727","3669","8327","1"
"3","2018","31","Hotel","15","16","741","1257","236","475","977","1732","2"
"3","2018","31","Hotel","14","31","19","44","421","1201","440","1245","7.8"
"3","2018","31","Hotel","13","33","559","749","249","560","808","1309","1"
"3","2018","31","Hotel","15","16","607","1169","156","317","763","1486","2"
"3","2018","31","Otros","4","21","677","1354","4","14","681","1368","1"
"3","2018","31","Hotel","6","10","841","1502","0","0","841","1502","1"
"3","2018","31","Hotel","16","19","281","423","26","46","307","469","1"
"3","2018","31","Hotel","16","27","972","2214","17","47","989","2261","1"
"3","2018","31","Hotel","10","11","1933","2804","189","345","2122","3149","1"
"3","2018","31","Otros","10","23","584","1248","15","45","599","1293","1"
"3","2018","31","Hotel","12","35","133","242","521","974","654","1216","1"
"3","2018","31","Hotel","11","36","629","1388","221","430","850","1818","1"
"3","2018","31","Hotel","14","31","29","48","304","1248","333","1296","17.4"
"3","2018","31","Hotel","10","18","527","1153","814","1911","1341","3064","3.2"
"3","2018","31","Hotel","4","13","201","569","68","68","269","637","1"
"3","2018","31","Hotel","6","12","261","366","48","79","309","445","5"
"3","2018","31","Hotel","6","10","524","816","78","136","602","952","1"
"3","2018","31","Otros","5","5","287","437","152","237","439","674","3.65625"
"3","2018","31","Hotel","12","24","891","1095","1426","2405","2317","3500","1"
"3","2018","31","Hotel","8","3","1213","2505","394","716","1607","3221","1"
"3","2018","31","Hotel","13","27","591","910","0","0","591","910","2.75"
"3","2018","31","Hotel","15","16","224","1045","117","455","341","1500","4"
"3","2018","31","Otros","15","16","162","621","213","828","375","1449","2"
"3","2018","31","Otros","16","20","411","649","0","0","411","649","1"
"3","2018","31","Hotel","3","4","613","1210","8","16","621","1226","1"
"3","2018","31","Hotel","11","36","83","101","0","0","83","101","1"
"3","2018","31","Hotel","2","6","332","1023","34","167","366","1190","1"
"3","2018","31","Hotel","8","34","726","1395","149","284","875","1679","1"
"3","2018","31","Hotel","4","13","30","55","0","0","30","55","3.2"
"3","2018","31","Hotel","13","27","1153","2503","6","12","1159","2515","2.75"
"3","2018","31","Hotel","2","29","195","546","602","1718","797","2264","1"
"3","2018","31","Otros","11","36","237","1217","0","0","237","1217","1"
"3","2018","31","","10","11","0","0","0","0","0","0","1"
"3","2018","30","Hotel","4","13","852","1116","86","180","938","1296","1"
"3","2018","31","Hotel","16","40","2205","3311","897","1348","3102","4659","5.6666666666667"
"3","2018","31","Hotel","10","23","638","1039","994","2214","1632","3253","2.8"
"3","2018","31","Hotel","8","34","882","1262","371","611","1253","1873","1"
"3","2018","31","Hotel","5","5","466","1483","277","667","743","2150","1"
"3","2018","31","Hotel","3","4","89","180","88","151","177","331","3"
"3","2018","31","Hotel","9","26","48","89","4","10","52","99","1"
"3","2018","31","Hotel","8","34","473","592","320","386","793","978","1"
"3","2018","31","Hotel","7","17","268","549","92","276","360","825","4"
"3","2018","31","Hotel","4","13","309","653","25","48","334","701","3.2"
"3","2018","31","Hotel","12","35","16","50","663","2343","679","2393","1"
"3","2018","31","Hotel","16","40","1192","2374","1419","3060","2611","5434","1"
"3","2018","31","Hotel","9","26","337","566","110","635","447","1201","1"
"3","2018","31","","6","27","144","564","47","357","191","921","1"
"3","2018","31","Hotel","9","26","62","119","0","0","62","119","1"
"3","2018","31","Hotel","4","13","77","139","17","23","94","162","3.2"
"3","2018","31","Hotel","6","28","628","714","45","51","673","765","1"
"3","2018","31","","2","29","85","204","706","2238","791","2442","1"
"3","2018","31","Hotel","13","33","1321","1554","179","336","1500","1890","1"
"3","2018","31","Hotel","8","3","1114","2573","445","859","1559","3432","1"
"3","2018","31","Hotel","14","27","1697","2563","996","1628","2693","4191","1"
"3","2018","31","Hotel","16","40","414","828","12","24","426","852","5.6666666666667"
"3","2018","31","Hotel","12","24","341","506","193","621","534","1127","1"
"3","2018","31","Hotel","10","18","1131","1723","265","614","1396","2337","3.2"
"3","2018","31","Otros","15","16","153","153","17","17","170","170","9"
"3","2018","31","Hotel","6","10","595","648","0","0","595","648","1"
"3","2018","31","Hotel","10","11","586","1105","235","637","821","1742","1"
"3","2018","31","Otros","6","10","258","1548","0","0","258","1548","3.8518518518518"
"3","2018","31","Otros","10","23","78","192","0","0","78","192","1"
"3","2018","31","Hotel","10","23","384","693","442","925","826","1618","2.8"
"3","2018","31","Hotel","6","12","307","409","14","22","321","431","5"
"3","2018","31","Hotel","6","27","211","425","10","10","221","435","3"
"3","2018","31","Hotel","10","23","412","785","405","864","817","1649","2.8"
"3","2018","31","","4","39","253","906","0","0","253","906","1"
"3","2018","31","Hotel","8","34","154","273","285","536","439","809","1"
"3","2018","31","Hotel","8","34","525","726","280","430","805","1156","1"
"3","2018","31","Otros","4","39","32","51","0","0","32","51","2.2222222222222"
"3","2018","31","Otros","13","14","300","600","0","0","300","600","1"
"3","2018","31","Hotel","10","23","225","304","34","42","259","346","2.8"
"3","2018","31","Otros","13","14","643","2147","0","0","643","2147","1"
"3","2018","31","Hotel","12","24","294","435","526","914","820","1349","1"
"3","2018","31","","6","25","22","37","0","0","22","37","1"
"3","2018","31","Hotel","15","27","522","746","24","54","546","800","1"
"3","2018","31","Hotel","12","35","144","274","858","1401","1002","1675","1"
"3","2018","31","Hotel","16","40","30","45","415","520","445","565","1"
"3","2018","31","Hotel","16","27","57","85","382","1282","439","1367","1"
"3","2018","31","Hotel","9","30","157","592","0","0","157","592","1"
"3","2018","31","Hotel","4","13","401","813","59","97","460","910","3.2"
"3","2018","31","Hotel","2","29","103","260","341","995","444","1255","1"
"3","2018","31","Hotel","16","20","80","480","129","206","209","686","1"
"3","2018","31","Hotel","5","5","743","890","216","330","959","1220","1"
"3","2018","31","Hotel","13","33","420","662","52","90","472","752","1"
"3","2018","31","Otros","16","19","245","381","0","0","245","381","1.3333333333333"
"3","2018","31","Hotel","12","24","117","318","338","744","455","1062","1"
"3","2018","31","","8","2","490","850","45","80","535","930","1"
"3","2018","31","Hotel","12","35","8","60","215","1842","223","1902","1"
"3","2018","31","Hotel","16","27","72","86","278","314","350","400","2.5"
"3","2018","31","Otros","16","27","502","896","26","74","528","970","2"
"3","2018","31","Hotel","8","34","369","563","231","325","600","888","1"
"3","2018","27","Otros","8","3","124","317","18","54","142","371","1"
"3","2018","31","Hotel","7","27","203","436","99","264","302","700","1"
"3","2018","31","Hotel","4","39","143","261","4","10","147","271","1"
"3","2018","31","Hotel","15","16","124","247","74","113","198","360","4"
"3","2018","31","Hotel","4","39","26","32","2","4","28","36","1"
"3","2018","31","Hotel","4","39","172","326","12","17","184","343","1"
"3","2018","31","Hotel","15","16","256","482","58","85","314","567","4"
"3","2018","31","Hotel","14","31","33","66","237","653","270","719","17.4"
"3","2018","31","Hotel","8","34","310","537","191","286","501","823","1"
"3","2018","31","Hotel","6","28","221","372","56","73","277","445","1"
"3","2018","31","Hotel","7","17","719","1112","178","399","897","1511","4"
"3","2018","31","Otros","7","27","10","14","0","0","10","14","1"
"3","2018","31","Hotel","11","36","1270","1574","62","148","1332","1722","1"
"3","2018","31","Otros","4","21","514","1208","184","330","698","1538","1"
"3","2018","31","Otros","15","16","86","128","31","44","117","172","2"
"3","2018","31","Otros","7","17","281","870","19","32","300","902","3"
"3","2018","31","Hotel","7","38","50","71","0","0","50","71","1"
"3","2018","31","Hotel","16","27","425","516","42","88","467","604","2.5"
"3","2018","31","Hotel","2","6","38","80","12","34","50","114","2.2"
"3","2018","31","Hotel","11","36","308","665","132","251","440","916","1"
"3","2018","31","Hotel","6","28","25","31","4","4","29","35","1"
"3","2018","31","Hotel","6","12","57","133","0","0","57","133","5"
"3","2018","31","Otros","9","22","158","373","0","0","158","373","1"
"3","2018","31","","13","14","148","246","0","0","148","246","2"
"3","2018","31","Hotel","2","29","108","300","362","1016","470","1316","1"
"3","2018","31","Hotel","2","29","13","41","156","481","169","522","1"
"3","2018","31","Otros","4","13","356","379","12","12","368","391","1"
"3","2018","31","Hotel","15","16","68","175","31","74","99","249","4"
"3","2018","31","Hotel","2","1","146","414","16","50","162","464","6.4"
"3","2018","31","Otros","7","27","60","102","0","0","60","102","1"
"3","2018","31","Otros","13","33","54","60","2","4","56","64","5.125"
"3","2018","31","","4","21","575","678","50","74","625","752","1"
"3","2018","31","Hotel","6","10","388","388","6","6","394","394","1"
"3","2018","31","Hotel","11","36","210","569","37","104","247","673","1"
"3","2018","31","Otros","14","31","300","2100","39","39","339","2139","2.8"
"3","2018","31","Hotel","7","27","186","337","3","3","189","340","1"
"3","2018","31","Otros","6","10","65","205","0","0","65","205","3.8518518518518"
"3","2018","31","Hotel","4","39","10","18","1","1","11","19","2.6"
"3","2018","31","Otros","8","2","29","55","29","54","58","109","6.4285714285714"
"3","2018","31","Otros","11","36","68","166","7","10","75","176","5.1904761904762"
"3","2018","31","Hotel","13","33","651","651","102","102","753","753","1"
"3","2018","31","","3","4","129","188","41","58","170","246","1"
"3","2018","31","Hotel","7","17","303","760","83","215","386","975","4"
"3","2018","31","Hotel","8","2","134","196","10","14","144","210","1"
"3","2018","31","Otros","15","16","166","310","33","61","199","371","2"
"3","2018","31","Hotel","10","11","497","557","5","6","502","563","1"
"3","2018","31","Hotel","16","19","190","224","0","0","190","224","1"
"3","2018","31","Hotel","10","23","146","206","149","221","295","427","4"
"3","2018","31","","7","38","259","391","68","84","327","475","1"
"3","2018","31","Hotel","7","27","280","499","6","16","286","515","1"
"3","2018","31","Hotel","11","36","467","1091","144","264","611","1355","1"
"3","2018","31","Hotel","16","40","207","307","11","16","218","323","16.333333333333"
"3","2018","31","Hotel","16","19","85","125","7","24","92","149","1"
"3","2018","31","Hotel","16","19","24","36","0","0","24","36","1"
"3","2018","31","Hotel","16","20","0","0","0","0","0","0","1"
"3","2018","31","Hotel","10","11","297","493","45","62","342","555","1"
"3","2018","31","Otros","7","27","84","162","6","6","90","168","4.8333333333333"
"3","2018","31","Otros","7","27","38","91","0","0","38","91","1"
"3","2018","31","Hotel","7","27","63","64","0","0","63","64","4.1666666666667"
"3","2018","31","Otros","13","14","239","417","3","9","242","426","1"
"3","2018","31","Otros","11","15","48","48","0","0","48","48","2.3571428571429"
"3","2018","31","Otros","10","27","10","10","50","50","60","60","4.84"
"3","2018","31","Otros","14","31","2693","2693","113","113","2806","2806","2.8"
"3","2018","31","Otros","11","36","32","54","7","14","39","68","5.1904761904762"
"3","2018","31","Hotel","16","19","106","127","4","10","110","137","1"
"3","2018","31","","14","27","164","256","0","0","164","256","2.6666666666667"
"3","2018","31","Hotel","16","40","124","134","6","6","130","140","5.6666666666667"
"3","2018","31","Hotel","10","27","15","40","0","0","15","40","2.25"
"3","2018","31","Otros","2","29","160","382","312","790","472","1172","3.28"
"3","2018","31","Hotel","13","27","10","30","41","74","51","104","1"
"3","2018","31","Otros","9","22","78","103","0","0","78","103","1"
"3","2018","31","Hotel","2","27","143","258","35","55","178","313","1"
"3","2018","31","Hotel","8","34","371","509","210","338","581","847","1"
"3","2018","31","Hotel","7","27","478","674","22","35","500","709","1"
"3","2018","31","Hotel","15","16","167","320","62","93","229","413","4"
"3","2018","31","Hotel","16","20","84","176","27","32","111","208","1"
"3","2018","31","Otros","4","13","111","251","3","24","114","275","1"
"3","2018","31","Hotel","2","1","193","620","2","2","195","622","6.4"
"3","2018","31","Otros","11","32","23","58","0","0","23","58","2.2857142857143"
"3","2018","31","Hotel","2","29","8","52","184","1316","192","1368","1"
"3","2018","31","Hotel","16","27","170","181","72","90","242","271","2.5"
"3","2018","31","Hotel","10","18","120","120","0","0","120","120","3.2"
"3","2018","31","Otros","11","36","523","677","89","108","612","785","1"
"3","2018","31","Otros","13","14","51","100","0","0","51","100","1"
"3","2018","0","Hotel","7","27","0","0","0","0","0","0","1"
"3","2018","31","Otros","7","17","75","140","3","19","78","159","3"
"3","2018","31","Otros","14","31","778","1425","112","403","890","1828","2.8"
"3","2018","31","Hotel","2","29","514","1440","200","597","714","2037","1"
"3","2018","31","Hotel","8","3","168","891","124","299","292","1190","1"
"3","2018","31","Hotel","8","34","154","228","148","305","302","533","2.5714285714286"
"3","2018","31","Hotel","8","34","209","242","154","381","363","623","2.5714285714286"
"3","2018","31","Hotel","12","35","167","315","190","319","357","634","1"
"3","2018","31","Hotel","11","32","390","592","18","38","408","630","1"
"3","2018","31","Hotel","13","33","162","302","23","23","185","325","2"
"3","2018","31","Hotel","10","23","126","249","113","199","239","448","2.8"
"3","2018","31","Hotel","12","35","130","498","154","308","284","806","1"
"3","2018","31","","16","40","407","681","85","169","492","850","3.0555555555556"
"3","2018","31","Otros","16","19","15","30","0","0","15","30","1.3333333333333"
"3","2018","31","Otros","16","20","60","240","0","0","60","240","1"
"3","2018","31","Hotel","6","12","133","269","1","4","134","273","5"
"3","2018","31","Hotel","16","19","193","298","0","0","193","298","4"
"3","2018","31","Hotel","12","24","157","352","268","473","425","825","1"
"3","2018","31","Hotel","12","24","162","273","287","340","449","613","3"
"3","2018","31","Hotel","8","3","114","798","0","0","114","798","1"
"3","2018","31","Hotel","5","9","0","0","0","0","0","0","1"
"3","2018","31","Hotel","16","27","188","276","12","16","200","292","2.5"
"3","2018","31","Otros","10","23","41","41","0","0","41","41","7"
"3","2018","31","Otros","13","14","120","233","0","0","120","233","7.3846153846154"
"3","2018","31","Otros","2","6","52","118","5","9","57","127","1"
"3","2018","21","Hotel","15","16","4","4","14","15","18","19","7.8"
"3","2018","31","Hotel","8","3","84","364","0","0","84","364","1"
"3","2018","31","Hotel","8","34","348","403","143","253","491","656","1"
"3","2018","31","Hotel","8","3","116","272","69","118","185","390","1"
"3","2018","31","","2","29","111","314","77","250","188","564","1"
"3","2018","31","Hotel","2","1","375","539","27","43","402","582","6.4"
"3","2018","31","Hotel","7","17","162","263","10","29","172","292","4"
"3","2018","31","Otros","7","17","245","631","41","109","286","740","3"
"3","2018","31","Hotel","16","40","112","210","117","263","229","473","5.6666666666667"
"3","2018","31","Hotel","12","24","264","447","412","559","676","1006","1"
"3","2018","31","Hotel","14","31","157","385","296","1255","453","1640","17.4"
"3","2018","0","Hotel","9","26","0","0","0","0","0","0","1"
"3","2018","31","Hotel","6","12","31","31","0","0","31","31","5"
"3","2018","31","Otros","5","9","31","38","4","12","35","50","4.0454545454545"
"3","2018","31","Otros","5","9","6","6","9","10","15","16","4.0454545454545"
"3","2018","31","Otros","15","27","88","119","0","0","88","119","1.4222222222222"
"3","2018","31","Hotel","8","34","28","28","10","16","38","44","2.5714285714286"
"3","2018","31","Hotel","10","18","264","787","176","438","440","1225","7.75"
"3","2018","31","Hotel","15","16","300","776","37","98","337","874","7.8"
"3","2018","31","Hotel","2","29","77","223","475","1419","552","1642","1"
"3","2018","31","Hotel","4","39","62","111","3","3","65","114","2.6"
"3","2018","31","Otros","4","39","99","191","6","6","105","197","2.2222222222222"
"3","2018","31","Hotel","4","13","56","99","20","118","76","217","5.4"
"3","2018","31","Otros","10","23","37","37","6","6","43","43","7"
"3","2018","31","Otros","14","31","71","104","449","1094","520","1198","20.2"
"3","2018","31","Hotel","3","4","158","439","29","29","187","468","2.6"
"3","2018","31","Hotel","10","23","134","457","55","152","189","609","4"
"3","2018","31","Otros","9","22","151","472","5","5","156","477","1"
"3","2018","31","Hotel","12","24","167","351","371","518","538","869","3"
"3","2018","31","Hotel","13","14","34","74","0","0","34","74","1"
"3","2018","31","Hotel","12","35","75","184","181","356","256","540","1.7272727272727"
"3","2018","31","Hotel","6","28","340","545","0","0","340","545","1"
"3","2018","31","","6","28","29","124","0","0","29","124","1"
"3","2018","31","Hotel","12","24","356","898","188","486","544","1384","3"
"3","2018","31","Otros","5","9","12","14","0","0","12","14","4.0454545454545"
"3","2018","31","Hotel","16","20","80","123","3","5","83","128","1"
"3","2018","31","Hotel","4","21","269","543","45","60","314","603","3"
"3","2018","31","Otros","10","11","35","53","7","11","42","64","11.764705882353"
"3","2018","31","Otros","13","14","50","50","0","0","50","50","7.3846153846154"
"3","2018","31","Otros","16","27","64","113","0","0","64","113","13.818181818182"
"3","2018","31","Hotel","9","26","506","506","0","0","506","506","1"
"3","2018","31","Hotel","16","27","696","728","431","463","1127","1191","2.5"
"3","2018","31","Hotel","3","4","1478","2808","296","411","1774","3219","3"
"3","2018","31","Otros","16","27","80","80","0","0","80","80","2"
"3","2018","31","Otros","16","19","894","1694","3","7","897","1701","1.3333333333333"
"3","2018","31","Hotel","6","12","655","927","2","2","657","929","5"
"3","2018","31","Hotel","2","1","195","256","27","27","222","283","6.4"
"3","2018","31","Hotel","10","11","413","699","114","210","527","909","1"
"3","2018","31","Otros","10","23","87","87","2","2","89","89","1"
"3","2018","31","Otros","10","27","717","848","131","163","848","1011","4.84"
"3","2018","31","Hotel","16","27","283","388","33","216","316","604","2.5"
"3","2018","31","Hotel","6","28","146","196","18","25","164","221","1"
"3","2018","31","Hotel","4","13","37","82","6","19","43","101","5.4"
"3","2018","31","Hotel","14","27","652","950","28","32","680","982","8.5"
"3","2018","31","Hotel","10","27","79","135","333","436","412","571","1"
"3","2018","31","Hotel","13","27","101","125","23","27","124","152","4.2"
"3","2018","31","Hotel","3","4","706","863","16","35","722","898","3"
"3","2018","31","Otros","4","13","111","175","7","7","118","182","3.4"
"3","2018","31","Otros","11","15","29","34","0","0","29","34","2.3571428571429"
"3","2018","31","Otros","6","10","172","368","0","0","172","368","3.8518518518518"
"3","2018","31","Otros","2","1","67","76","2","2","69","78","1"
"3","2018","31","","6","12","58","165","2","13","60","178","1"
"3","2018","31","Otros","10","23","257","767","39","155","296","922","1"
"3","2018","31","Hotel","16","19","153","201","0","0","153","201","4"
"3","2018","31","Hotel","10","11","27","162","18","95","45","257","5.6666666666667"
"3","2018","31","Hotel","10","23","60","66","1","2","61","68","4"
"3","2018","31","Otros","14","31","27","70","210","520","237","590","2.8"
"3","2018","31","Otros","13","27","4","4","0","0","4","4","12.2"
"3","2018","31","Hotel","2","1","185","502","0","0","185","502","6.4"
"3","2018","31","Hotel","16","19","64","68","0","0","64","68","4"
"3","2018","31","Otros","12","35","8","14","5","7","13","21","3.5"
"3","2018","31","Otros","15","16","103","258","60","159","163","417","2"
"3","2018","31","Otros","9","22","400","800","60","120","460","920","1"
"3","2018","31","Hotel","10","27","248","434","420","513","668","947","1"
"3","2018","31","Hotel","2","27","121","159","8","8","129","167","3.6"
"3","2018","31","Hotel","16","20","29","301","6","22","35","323","1"
"3","2018","31","Hotel","10","18","0","0","30","103","30","103","7.75"
"3","2018","31","Hotel","6","12","308","308","0","0","308","308","5"
"3","2018","31","Hotel","2","27","100","422","0","0","100","422","3.6"
"3","2018","31","Hotel","15","16","150","266","28","86","178","352","7.8"
"3","2018","31","Hotel","10","23","49","49","31","31","80","80","4"
"3","2018","31","Hotel","11","32","55","77","10","10","65","87","1"
"3","2018","31","Hotel","14","27","174","445","36","220","210","665","8.5"
"3","2018","31","Otros","10","11","35","57","2","4","37","61","11.764705882353"
"3","2018","31","Hotel","2","27","99","192","12","18","111","210","3.6"
"3","2018","31","Otros","13","14","179","397","18","36","197","433","7.3846153846154"
"3","2018","31","Hotel","2","1","138","152","6","6","144","158","6.4"
"3","2018","31","Otros","7","17","200","597","44","134","244","731","17.166666666667"
"3","2018","31","Otros","10","23","29","121","10","30","39","151","7"
"3","2018","31","Hotel","13","27","169","169","8","8","177","177","2.75"
"3","2018","31","Otros","10","18","28","44","34","70","62","114","10.25"
"3","2018","31","Otros","5","9","36","201","0","0","36","201","4.0454545454545"
"3","2018","31","Hotel","4","39","54","80","6","10","60","90","2.6"
"3","2018","31","Otros","16","27","37","108","0","0","37","108","13.818181818182"
"3","2018","31","Hotel","14","27","33","65","26","37","59","102","8.5"
"3","2018","31","Hotel","10","11","170","317","71","113","241","430","5.6666666666667"
"3","2018","31","Hotel","10","18","155","368","113","322","268","690","7.75"
"3","2018","31","Otros","14","31","160","275","160","415","320","690","20.2"
"3","2018","31","Otros","11","32","31","37","2","2","33","39","2.2857142857143"
"3","2018","31","Otros","5","5","51","109","31","62","82","171","3.65625"
"3","2018","31","Otros","6","25","21","38","0","0","21","38","2.3846153846154"
"3","2018","31","Hotel","3","4","30","123","2","3","32","126","2.6"
"3","2018","31","Otros","7","27","157","271","11","25","168","296","4.8333333333333"
"3","2018","31","Otros","2","29","79","208","125","298","204","506","3.28"
"3","2018","31","Hotel","2","29","72","183","180","508","252","691","1"
"3","2018","31","Otros","4","21","147","282","27","62","174","344","1"
"3","2018","31","Hotel","7","27","271","303","0","0","271","303","4.1666666666667"
"3","2018","31","Otros","5","5","9","33","0","0","9","33","3.65625"
"3","2018","31","Otros","11","36","55","118","56","92","111","210","5.1904761904762"
"3","2018","31","Hotel","7","27","370","370","0","0","370","370","4.1666666666667"
"3","2018","14","Hotel","16","20","55","80","9","13","64","93","1"
"3","2018","31","Hotel","12","24","260","370","122","240","382","610","3"
"3","2018","31","Hotel","9","26","77","92","25","27","102","119","1.5"
"3","2018","31","Hotel","7","17","352","1428","12","56","364","1484","10"
"3","2018","31","Hotel","9","37","242","344","90","211","332","555","3.4"
"3","2018","31","Hotel","5","5","262","477","152","192","414","669","2.1428571428571"
"3","2018","31","Otros","6","27","142","280","0","0","142","280","3.960088691796"
"3","2018","31","Hotel","9","37","58","89","20","27","78","116","3.4"
"3","2018","31","Otros","10","27","59","61","150","150","209","211","4.84"
"3","2018","31","Otros","8","3","179","313","32","50","211","363","10"
"3","2018","31","Otros","16","20","38","44","0","0","38","44","3.0769230769231"
"3","2018","31","Otros","9","22","16","22","0","0","16","22","7.6428571428571"
"3","2018","31","Otros","10","27","337","532","52","56","389","588","4.84"
"3","2018","31","Otros","10","23","49","54","6","7","55","61","7"
"3","2018","31","Otros","2","6","459","459","147","147","606","606","1"
"3","2018","31","Otros","4","39","27","39","1","1","28","40","2.2222222222222"
"3","2018","31","Hotel","2","27","115","193","36","60","151","253","1"
"3","2018","31","Hotel","14","31","30","87","120","914","150","1001","24"
"3","2018","31","Otros","2","29","125","398","112","204","237","602","3.28"
"3","2018","31","Otros","8","3","164","492","30","90","194","582","10"
"3","2018","31","","13","14","19","42","21","57","40","99","1"
"3","2018","31","Hotel","6","10","198","235","34","44","232","279","6.6"
"3","2018","31","Hotel","8","34","90","100","56","74","146","174","2.5714285714286"
"3","2018","31","Hotel","9","22","85","349","0","0","85","349","2.5555555555556"
"3","2018","31","Hotel","2","6","93","123","27","32","120","155","2.2"
"3","2018","31","Hotel","10","27","79","160","218","266","297","426","2.25"
"3","2018","31","Otros","14","27","273","273","0","0","273","273","11.833333333333"
"3","2018","31","Otros","6","12","372","553","21","37","393","590","1.8256578947368"
"3","2018","31","Hotel","6","27","111","164","0","0","111","164","3"
"3","2018","31","Hotel","5","5","15","15","10","14","25","29","2.1428571428571"
"3","2018","31","Hotel","5","5","108","165","43","84","151","249","2.1428571428571"
"3","2018","31","Hotel","13","27","199","199","1","1","200","200","4.2"
"3","2018","31","Hotel","2","27","218","345","0","0","218","345","3.6"
"3","2018","31","Hotel","8","3","61","61","41","41","102","102","4.1111111111111"
"3","2018","31","Otros","11","36","96","232","0","0","96","232","5.1904761904762"
"3","2018","31","Otros","9","30","227","534","0","0","227","534","2.3333333333333"
"3","2018","31","Otros","16","19","37","65","0","0","37","65","10.263157894737"
"3","2018","31","Hotel","14","31","75","118","280","777","355","895","17.4"
"3","2018","31","Hotel","2","1","275","301","9","11","284","312","6.4"
"3","2018","31","Hotel","16","40","976","1772","386","567","1362","2339","5.6666666666667"
"3","2018","31","Otros","7","17","259","496","40","82","299","578","17.166666666667"
"3","2018","31","Hotel","13","27","352","438","221","370","573","808","2.75"
"3","2018","31","Hotel","14","31","252","305","435","800","687","1105","24"
"3","2018","31","Otros","3","4","24","71","2","8","26","79","12.2"
"3","2018","31","Otros","8","34","198","259","182","285","380","544","5.75"
"3","2018","31","Hotel","9","22","94","137","2","2","96","139","2.5555555555556"
"3","2018","31","Hotel","4","21","52","57","2","2","54","59","3"
"3","2018","31","Hotel","6","27","91","135","0","0","91","135","3"
"3","2018","31","Hotel","12","35","152","290","223","368","375","658","1.7272727272727"
"3","2018","31","Hotel","2","29","72","147","144","288","216","435","2"
"3","2018","31","Otros","10","11","52","76","3","5","55","81","11.764705882353"
"3","2018","31","Hotel","6","10","98","116","0","0","98","116","6.6"
"3","2018","31","Hotel","13","14","18","18","5","5","23","23","2"
"3","2018","18","Otros","16","27","178","262","0","0","178","262","13.818181818182"
"3","2018","31","Otros","6","27","26","28","3","3","29","31","3.960088691796"
"3","2018","31","Hotel","16","40","66","106","405","783","471","889","5.6666666666667"
"3","2018","31","Otros","6","10","46","86","0","0","46","86","3.8518518518518"
"3","2018","9","Otros","10","23","23","40","9","11","32","51","7"
"3","2018","31","Hotel","6","28","311","387","40","40","351","427","1"
"3","2018","31","Otros","7","38","407","695","65","170","472","865","2.75"
"3","2018","31","Hotel","6","12","223","337","3","35","226","372","5"
"3","2018","31","Hotel","13","27","335","541","13","19","348","560","4.2"
"3","2018","31","Otros","4","21","24","51","0","0","24","51","4.8333333333333"
"3","2018","31","Hotel","16","27","64","167","9","89","73","256","5.8571428571429"
"3","2018","31","Hotel","5","5","60","173","39","56","99","229","2.1428571428571"
"3","2018","31","Otros","12","24","84","173","140","220","224","393","9.2"
"3","2018","31","Otros","15","16","69","96","44","94","113","190","9"
"3","2018","31","Hotel","8","27","152","152","13","13","165","165","4.5"
"3","2018","31","Hotel","9","22","17","17","0","0","17","17","2.5555555555556"
"3","2018","31","Hotel","10","11","104","197","74","147","178","344","5.6666666666667"
"3","2018","31","Hotel","8","3","50","109","53","114","103","223","4.1111111111111"
"3","2018","31","Hotel","6","10","324","441","6","15","330","456","6.6"
"3","2018","31","Otros","9","26","44","539","8","89","52","628","3.8888888888889"
"3","2018","31","Hotel","4","39","28","143","7","138","35","281","2.6"
"3","2018","31","Otros","6","27","37","91","0","0","37","91","3.960088691796"
"3","2018","31","Otros","6","12","176","253","0","0","176","253","1.8256578947368"
"3","2018","31","Hotel","6","27","110","217","2","5","112","222","3"
"3","2018","31","Otros","5","9","58","90","25","43","83","133","4.0454545454545"
"3","2018","31","Hotel","2","27","111","111","31","31","142","142","3.6"
"3","2018","31","Hotel","2","29","38","152","155","453","193","605","1"
"3","2018","31","Hotel","4","13","206","389","19","27","225","416","5.4"
"3","2018","31","","11","15","12","15","0","0","12","15","1"
"3","2018","31","Hotel","6","10","321","382","11","14","332","396","6.6"
"3","2018","31","Otros","6","12","24","54","0","0","24","54","1.8256578947368"
"3","2018","31","Otros","10","18","158","187","0","0","158","187","10.25"
"3","2018","31","Otros","9","22","238","429","0","0","238","429","7.6428571428571"
"3","2018","31","","14","27","229","282","55","156","284","438","1"
"3","2018","31","Hotel","16","27","69","75","8","8","77","83","5.8571428571429"
"3","2018","31","Otros","2","29","11","27","14","29","25","56","3.28"
"3","2018","31","Otros","13","33","56","60","0","0","56","60","5.125"
"3","2018","31","Otros","13","33","0","0","8","15","8","15","5.125"
"3","2018","29","Otros","6","10","83","493","0","0","83","493","3.8518518518518"
"3","2018","31","Hotel","10","18","59","112","55","108","114","220","7.75"
"3","2018","31","Hotel","14","31","131","210","53","182","184","392","24"
"3","2018","31","Hotel","4","21","77","77","18","18","95","95","3"
"3","2018","31","Hotel","3","4","1","1","1","12","2","13","2.6"
"3","2018","31","Otros","8","27","18","22","0","0","18","22","1"
"3","2018","31","Otros","6","27","12","27","0","0","12","27","3.960088691796"
"3","2018","31","Hotel","6","25","185","389","0","0","185","389","1"
"3","2018","31","Otros","6","12","201","379","9","14","210","393","1.8256578947368"
"3","2018","31","Hotel","6","27","38","58","0","0","38","58","3"
"3","2018","31","Otros","6","27","24","36","0","0","24","36","3.960088691796"
"3","2018","31","Otros","6","10","76","138","0","0","76","138","3.8518518518518"
"3","2018","31","Otros","6","12","111","236","0","0","111","236","1.8256578947368"
"3","2018","31","Otros","5","5","15","34","12","12","27","46","3.65625"
"3","2018","31","Hotel","12","24","60","265","45","71","105","336","3"
"3","2018","31","Hotel","15","16","65","119","3","5","68","124","7.8"
"3","2018","31","Otros","4","13","49","63","2","10","51","73","3.4"
"3","2018","31","Hotel","2","29","142","417","83","246","225","663","1"
"3","2018","31","Hotel","4","21","27","53","1","4","28","57","3"
"3","2018","31","Hotel","10","27","130","192","325","402","455","594","2.25"
"3","2018","31","Hotel","8","3","197","348","133","248","330","596","4.1111111111111"
"3","2018","13","Hotel","12","27","19","23","11","13","30","36","1"
"3","2018","31","Otros","5","5","458","725","27","63","485","788","3.65625"
"3","2018","31","Otros","13","14","7","22","0","0","7","22","7.3846153846154"
"3","2018","31","Otros","10","11","293","597","0","0","293","597","11.764705882353"
"3","2018","31","Otros","16","40","253","325","18","38","271","363","28.142857142857"
"3","2018","31","Hotel","11","36","217","465","11","59","228","524","1"
"3","2018","31","Otros","8","34","32","51","49","82","81","133","5.75"
"3","2018","31","Hotel","7","17","121","167","3","4","124","171","10"
"3","2018","31","Otros","12","35","203","395","4","6","207","401","3.5"
"3","2018","31","Otros","5","9","20","33","25","51","45","84","4.0454545454545"
"3","2018","31","Hotel","9","22","91","155","0","0","91","155","2.5555555555556"
"3","2018","31","Otros","2","29","21","35","32","47","53","82","3.28"
"3","2018","31","Otros","2","29","113","113","97","97","210","210","3.28"
"3","2018","31","Hotel","10","27","24","31","19","33","43","64","2.25"
"3","2018","31","Hotel","16","19","117","128","54","60","171","188","4"
"3","2018","31","Hotel","16","40","143","419","12","34","155","453","16.333333333333"
"3","2018","31","Hotel","8","27","216","335","13","13","229","348","4.5"
"3","2018","31","Otros","13","14","18","24","0","0","18","24","7.3846153846154"
"3","2018","31","Hotel","7","27","50","58","0","0","50","58","4.1666666666667"
"3","2018","31","Otros","2","6","1","1","0","0","1","1","5"
"3","2018","31","Hotel","7","17","412","1030","21","55","433","1085","10"
"3","2018","31","Hotel","3","4","110","207","46","64","156","271","2.6"
"3","2018","31","Otros","6","12","12","154","0","0","12","154","1.8256578947368"
"3","2018","31","Otros","6","10","12","12","0","0","12","12","3.8518518518518"
"3","2018","31","Hotel","16","40","96","160","40","88","136","248","16.333333333333"
"3","2018","31","Otros","4","39","28","66","0","0","28","66","2.2222222222222"
"3","2018","31","Otros","13","14","42","93","0","0","42","93","7.3846153846154"
"3","2018","31","Otros","7","38","88","112","20","25","108","137","2.75"
"3","2018","31","Hotel","11","32","128","234","61","134","189","368","1"
"3","2018","31","Otros","11","36","184","333","9","20","193","353","5.1904761904762"
"3","2018","31","Hotel","4","21","106","169","1","1","107","170","3"
"3","2018","31","Otros","3","4","8","26","0","0","8","26","12.2"
"3","2018","31","Otros","5","9","55","83","19","24","74","107","4.0454545454545"
"3","2018","31","Hotel","8","27","80","136","0","0","80","136","4.5"
"3","2018","31","","7","17","155","370","10","54","165","424","1"
"3","2018","31","Otros","16","20","80","159","0","0","80","159","3.0769230769231"
"3","2018","31","Otros","4","21","50","68","8","10","58","78","4.8333333333333"
"3","2018","31","Otros","13","33","46","47","34","43","80","90","5.125"
"3","2018","31","","12","35","0","0","230","1130","230","1130","1"
"3","2018","31","Hotel","13","33","0","0","1","1","1","1","2"
"3","2018","31","Otros","4","39","12","12","0","0","12","12","2.2222222222222"
"3","2018","31","Otros","10","18","41","136","0","0","41","136","10.25"
"3","2018","31","Otros","6","27","74","101","0","0","74","101","3.960088691796"
"3","2018","31","Hotel","4","39","52","204","0","0","52","204","2.6"
"3","2018","31","Otros","14","31","21","49","96","258","117","307","20.2"
"3","2018","31","Hotel","2","29","34","103","144","346","178","449","2"
"3","2018","31","Hotel","9","26","155","279","3","10","158","289","1.5"
"3","2018","31","Otros","12","35","6","7","6","6","12","13","3.5"
"3","2018","31","Hotel","14","27","124","148","43","50","167","198","8.5"
"3","2018","31","Otros","11","36","102","207","29","73","131","280","5.1904761904762"
"3","2018","31","Otros","16","20","189","389","22","47","211","436","3.0769230769231"
"3","2018","31","Otros","4","39","1","4","0","0","1","4","2.2222222222222"
"3","2018","31","Otros","7","27","161","205","4","10","165","215","4.8333333333333"
"3","2018","31","Otros","6","27","136","205","3","3","139","208","3.960088691796"
"3","2018","31","Otros","5","8","3","3","0","0","3","3","5"
"3","2018","31","Otros","9","37","119","207","13","24","132","231","4.5"
"3","2018","31","Hotel","2","6","43","109","0","0","43","109","5.5"
"3","2018","31","Hotel","10","27","72","91","138","169","210","260","2.25"
"3","2018","31","Hotel","9","30","150","315","42","47","192","362","1"
"3","2018","31","Otros","4","13","30","49","2","4","32","53","3.4"
"3","2018","31","Hotel","5","5","335","335","8","8","343","343","1"
"3","2018","31","Otros","7","38","181","366","4","4","185","370","2.75"
"3","2018","31","Hotel","13","14","29","58","3","3","32","61","1"
"3","2018","31","Otros","5","9","62","88","24","49","86","137","4.0454545454545"
"3","2018","31","Otros","5","8","4","12","0","0","4","12","5"
"3","2018","31","Otros","10","27","10","310","0","0","10","310","4.84"
"3","2018","0","Hotel","13","14","0","0","0","0","0","0","1"
"3","2018","31","Otros","11","15","10","67","0","0","10","67","2.3571428571429"
"3","2018","31","Hotel","9","22","193","360","0","0","193","360","2.5555555555556"
"3","2018","31","Otros","11","36","215","357","13","23","228","380","5.1904761904762"
"3","2018","31","Hotel","10","18","1610","3142","2303","4344","3913","7486","1"
"3","2018","30","Hotel","6","12","364","436","0","0","364","436","5"
"3","2018","31","","2","29","314","668","876","2016","1190","2684","1"
"3","2018","31","Hotel","16","27","2573","5805","90","251","2663","6056","1"
"3","2018","31","","14","31","288","720","352","1545","640","2265","1"
"3","2018","31","Hotel","8","3","24","118","19","109","43","227","4.1111111111111"
"3","2018","31","Otros","13","33","73","87","36","65","109","152","5.125"
"3","2018","31","","14","27","69","108","0","0","69","108","2.6666666666667"
"3","2018","31","Otros","9","22","84","476","0","0","84","476","7.6428571428571"
"3","2018","31","Hotel","10","11","24","28","4","4","28","32","5.6666666666667"
"3","2018","31","Otros","6","12","12","12","0","0","12","12","1.8256578947368"
"3","2018","31","Hotel","8","3","171","271","58","72","229","343","4.1111111111111"
"3","2018","31","Otros","6","12","170","289","0","0","170","289","1.8256578947368"
"3","2018","31","Hotel","8","27","218","218","11","11","229","229","4.5"
"3","2018","31","Hotel","6","28","203","208","46","46","249","254","2.4"
"3","2018","31","Otros","6","25","72","326","0","0","72","326","2.3846153846154"
"3","2018","31","Otros","6","25","31","40","0","0","31","40","2.3846153846154"
"3","2018","31","Hotel","11","36","878","2371","0","0","878","2371","1"
"3","2018","31","Otros","2","6","18","46","245","739","263","785","5"
"3","2018","31","Hotel","14","31","63","112","130","265","193","377","24"
"3","2018","31","Otros","4","21","30","35","0","0","30","35","4.8333333333333"
"3","2018","31","Otros","7","38","57","113","0","0","57","113","2.75"
"3","2018","31","Otros","13","14","109","146","6","6","115","152","7.3846153846154"
"3","2018","31","Otros","2","29","26","30","22","34","48","64","3.28"
"3","2018","31","Otros","3","4","94","94","31","31","125","125","12.2"
"3","2018","31","Hotel","3","4","276","690","42","74","318","764","3"
"3","2018","31","Otros","7","27","245","338","9","9","254","347","1"
"3","2018","31","Otros","7","17","237","255","2","2","239","257","3"
"3","2018","31","Hotel","12","27","244","390","12","12","256","402","1"
"3","2018","31","Otros","5","5","31","59","18","39","49","98","3.65625"
"3","2018","31","Hotel","6","10","208","288","6","6","214","294","6.6"
"3","2018","31","Otros","10","18","0","0","12","39","12","39","10.25"
"3","2018","31","Otros","8","27","51","89","0","0","51","89","9.4"
"3","2018","31","Otros","8","3","27","73","5","8","32","81","10"
"3","2018","31","Hotel","16","27","76","88","0","0","76","88","5.8571428571429"
"3","2018","31","Otros","6","10","46","113","0","0","46","113","3.8518518518518"
"3","2018","31","Hotel","2","6","28","53","6","6","34","59","5.5"
"3","2018","31","Hotel","8","3","8","15","0","0","8","15","4.1111111111111"
"3","2018","31","Otros","10","11","29","29","7","7","36","36","11.764705882353"
"3","2018","14","Otros","6","27","12","168","0","0","12","168","3.960088691796"
"3","2018","31","Otros","15","16","1","1","0","0","1","1","9"
"3","2018","31","Otros","5","5","14","18","19","20","33","38","3.65625"
"3","2018","31","Otros","10","27","65","99","45","75","110","174","4.84"
"3","2018","31","Hotel","7","38","104","147","10","10","114","157","1"
"3","2018","31","Hotel","13","27","5","80","0","0","5","80","4.2"
"3","2018","31","Hotel","16","20","77","151","0","0","77","151","1"
"3","2018","31","Otros","10","27","42","69","134","169","176","238","4.84"
"3","2018","31","Hotel","3","7","52","68","19","26","71","94","1"
"3","2018","31","Otros","2","29","123","236","47","76","170","312","3.28"
"3","2018","31","Otros","10","18","6","18","0","0","6","18","10.25"
"3","2018","31","Otros","9","22","258","476","0","0","258","476","7.6428571428571"
"3","2018","31","Otros","15","27","55","61","0","0","55","61","1.4222222222222"
"3","2018","31","Otros","11","36","7","22","1","2","8","24","5.1904761904762"
"3","2018","31","Otros","5","5","9","13","0","0","9","13","3.65625"
"3","2018","31","Otros","2","29","7","33","24","76","31","109","3.28"
"3","2018","31","Hotel","9","22","188","188","24","24","212","212","2.5555555555556"
"3","2018","31","Otros","11","32","15","21","0","0","15","21","2.2857142857143"
"3","2018","31","Hotel","10","27","214","322","169","232","383","554","1"
"3","2018","31","Otros","16","27","235","363","0","0","235","363","2"
"3","2018","31","Hotel","16","20","60","73","0","0","60","73","1"
"3","2018","31","Otros","11","15","40","71","0","0","40","71","2.3571428571429"
"3","2018","31","Otros","7","17","11","47","3","57","14","104","3"
"3","2018","31","Otros","5","8","35","47","4","7","39","54","5"
"3","2018","31","Hotel","13","33","51","128","8","16","59","144","2"
"3","2018","31","Otros","5","9","62","97","57","94","119","191","4.0454545454545"
"3","2018","31","Otros","10","27","71","96","20","22","91","118","4.84"
"3","2018","31","Otros","9","22","56","99","0","0","56","99","7.6428571428571"
"3","2018","31","Otros","16","40","90","169","0","0","90","169","28.142857142857"
"3","2018","31","Hotel","16","40","97","125","12","12","109","137","1"
"3","2018","31","Otros","15","16","15","44","0","0","15","44","9"
"3","2018","31","Hotel","8","2","35","49","6","6","41","55","3"
"3","2018","31","Otros","8","3","34","74","0","0","34","74","10"
"3","2018","31","Otros","7","17","64","75","0","0","64","75","17.166666666667"
"3","2018","31","Otros","16","20","56","100","8","12","64","112","3.0769230769231"
"3","2018","31","Otros","6","27","49","91","0","0","49","91","3.960088691796"
"3","2018","31","Otros","12","35","65","101","184","256","249","357","3.5"
"3","2018","31","Otros","6","28","104","312","18","36","122","348","4.65"
"3","2018","31","Otros","6","28","247","396","56","118","303","514","4.65"
"3","2018","31","Hotel","8","34","99","180","93","123","192","303","2.5714285714286"
"3","2018","31","Hotel","16","20","2403","2652","15","41","2418","2693","1"
"3","2018","31","Hotel","2","6","42","106","13","13","55","119","2.2"
"3","2018","31","Hotel","7","27","92","713","0","0","92","713","4.1666666666667"
"3","2018","31","Hotel","10","23","0","0","2","28","2","28","4"
"3","2018","31","Hotel","9","26","119","148","10","12","129","160","1.5"
"3","2018","31","Otros","8","27","117","381","2","2","119","383","9.4"
"3","2018","31","Otros","10","27","12","12","5","5","17","17","4.84"
"3","2018","31","Otros","11","15","21","37","1","1","22","38","2.3571428571429"
"3","2018","31","Otros","16","20","170","220","0","0","170","220","3.0769230769231"
"3","2018","31","Otros","11","32","78","160","0","0","78","160","1"
"3","2018","31","Otros","16","27","89","89","6","6","95","95","13.818181818182"
"3","2018","31","Otros","9","37","113","113","0","0","113","113","4.5"
"3","2018","31","Hotel","2","29","10","30","28","92","38","122","2"
"3","2018","31","Hotel","2","1","104","192","4","10","108","202","6.4"
"3","2018","31","Otros","5","8","6","6","2","2","8","8","5"
"3","2018","31","Otros","9","37","88","151","39","65","127","216","4.5"
"3","2018","31","Otros","7","38","264","630","0","0","264","630","2.75"
"3","2018","31","Otros","11","32","63","157","4","4","67","161","1"
"3","2018","31","Otros","4","39","36","40","0","0","36","40","2.2222222222222"
"3","2018","31","Hotel","11","36","71","143","28","62","99","205","2.375"
"3","2018","31","Otros","10","23","13","23","5","10","18","33","7"
"3","2018","31","Hotel","15","16","547","1282","190","723","737","2005","2"
"3","2018","31","Otros","2","29","56","115","141","314","197","429","3.28"
"3","2018","31","Hotel","6","12","1020","1332","31","37","1051","1369","1"
"3","2018","31","Hotel","11","15","172","321","0","0","172","321","1"
"3","2018","31","Otros","4","21","345","847","47","104","392","951","1"
"3","2018","31","Otros","16","19","92","238","0","0","92","238","10.263157894737"
"3","2018","31","","9","37","337","434","3","4","340","438","1"
"3","2018","31","Otros","10","27","71","125","64","124","135","249","4.84"
"3","2018","31","Otros","11","15","47","47","2","2","49","49","2.3571428571429"
"3","2018","31","Hotel","2","29","72","216","88","272","160","488","2"
"3","2018","31","Hotel","10","27","54","101","32","78","86","179","1"
"3","2018","31","Hotel","11","36","109","557","38","73","147","630","2.375"
"3","2018","31","Hotel","9","37","143","202","65","133","208","335","3.4"
"3","2018","31","Otros","14","27","10","20","2","10","12","30","11.833333333333"
"3","2018","31","Otros","7","38","205","501","0","0","205","501","1"
"3","2018","31","Hotel","2","1","10","100","0","0","10","100","6.4"
"3","2018","31","Otros","2","29","14","31","50","199","64","230","3.28"
"3","2018","31","Hotel","6","27","12","13","15","35","27","48","3"
"3","2018","31","Otros","5","9","5","155","0","0","5","155","4.0454545454545"
"3","2018","31","Hotel","2","1","121","192","0","0","121","192","6.4"
"3","2018","31","Hotel","3","7","9","17","27","67","36","84","1"
"3","2018","31","Otros","7","38","52","56","58","68","110","124","2.75"
"3","2018","31","Otros","7","17","23","50","3","9","26","59","17.166666666667"
"3","2018","31","Otros","7","38","28","51","6","6","34","57","2.75"
"3","2018","31","Otros","4","21","44","44","0","0","44","44","4.8333333333333"
"3","2018","31","Otros","2","1","46","46","9","9","55","55","5.5"
"3","2018","31","Otros","12","35","83","123","32","85","115","208","3.5"
"3","2018","31","Otros","12","35","10","14","33","46","43","60","3.5"
"3","2018","31","Otros","4","21","39","65","12","30","51","95","4.8333333333333"
"3","2018","31","Otros","12","24","40","120","27","151","67","271","9.2"
"3","2018","31","Otros","16","19","8","16","0","0","8","16","10.263157894737"
"3","2018","31","Otros","10","11","221","531","8","11","229","542","11.764705882353"
"3","2018","31","Otros","16","19","60","112","0","0","60","112","10.263157894737"
"3","2018","31","Hotel","2","27","63","129","13","31","76","160","1"
"3","2018","31","Otros","6","28","46","78","0","0","46","78","4.65"
"3","2018","31","Otros","10","18","156","467","49","122","205","589","10.25"
"3","2018","31","Otros","14","27","52","246","0","0","52","246","11.833333333333"
"3","2018","31","Hotel","11","32","35","39","8","12","43","51","1"
"3","2018","31","Otros","8","27","2","4","0","0","2","4","9.4"
"3","2018","31","Hotel","12","35","98","208","112","205","210","413","1.7272727272727"
"3","2018","31","Otros","13","14","27","43","0","0","27","43","7.3846153846154"
"3","2018","31","Otros","11","36","41","59","2","2","43","61","5.1904761904762"
"3","2018","31","Otros","16","20","105","157","0","0","105","157","3.0769230769231"
"3","2018","31","Hotel","14","31","107","146","763","948","870","1094","7.8"
"3","2018","31","Otros","2","27","154","327","14","24","168","351","3.2"
"3","2018","31","","16","40","374","1223","0","0","374","1223","3.0555555555556"
"3","2018","31","Hotel","11","36","61","145","29","63","90","208","2.375"
"3","2018","31","Hotel","9","22","32","42","0","0","32","42","2.5555555555556"
"3","2018","31","Otros","2","29","12","21","28","52","40","73","3.28"
"3","2018","31","Hotel","10","27","8","10","40","44","48","54","2.25"
"3","2018","31","Otros","10","27","12","47","0","0","12","47","4.84"
"3","2018","31","Hotel","16","19","31","46","2","4","33","50","4"
"3","2018","31","Otros","2","6","20","20","0","0","20","20","5"
"3","2018","31","Otros","7","27","207","285","0","0","207","285","4.8333333333333"
"3","2018","31","Hotel","2","6","103","832","0","0","103","832","5.5"
"3","2018","31","Hotel","6","28","4","4","2","2","6","6","2.4"
"3","2018","31","Otros","6","10","226","1307","0","0","226","1307","3.8518518518518"
"3","2018","31","Hotel","6","27","33","43","2","2","35","45","3"
"3","2018","31","Otros","5","5","39","55","9","10","48","65","3.65625"
"3","2018","31","Otros","12","24","51","87","104","234","155","321","9.2"
"3","2018","31","Hotel","8","2","52","101","17","38","69","139","3"
"3","2018","31","Hotel","11","32","20","76","8","15","28","91","1"
"3","2018","31","Otros","10","18","20","47","73","184","93","231","10.25"
"3","2018","31","Hotel","9","37","33","58","12","32","45","90","3.4"
"3","2018","31","Otros","5","9","109","203","44","97","153","300","4.0454545454545"
"3","2018","31","Otros","12","24","10","24","20","42","30","66","9.2"
"3","2018","31","Otros","9","22","4","12","0","0","4","12","7.6428571428571"
"3","2018","31","Otros","2","29","13","41","22","65","35","106","3.28"
"3","2018","31","Otros","10","23","16","320","0","0","16","320","7"
"3","2018","31","Otros","10","27","7","20","12","41","19","61","4.84"
"3","2018","31","Otros","10","11","38","38","0","0","38","38","11.764705882353"
"3","2018","10","Otros","8","3","30","70","2","8","32","78","10"
"3","2018","31","Otros","14","31","127","199","490","826","617","1025","20.2"
"3","2018","31","Otros","2","29","220","698","166","484","386","1182","3.28"
"3","2018","0","Otros","6","25","0","0","0","0","0","0","1"
"3","2018","31","Hotel","15","16","10","21","0","0","10","21","7.8"
"3","2018","31","Hotel","15","27","100","115","0","0","100","115","1"
"3","2018","31","Otros","10","27","6","15","0","0","6","15","4.84"
"3","2018","31","Otros","10","23","45","45","6","6","51","51","7"
"3","2018","31","Otros","6","27","34","64","0","0","34","64","3.960088691796"
"3","2018","31","Otros","16","40","211","292","0","0","211","292","28.142857142857"
"3","2018","31","Otros","11","36","259","366","45","108","304","474","5.1904761904762"
"3","2018","31","Otros","8","34","17","29","13","15","30","44","5.75"
"3","2018","17","Otros","6","12","8","84","0","0","8","84","1.8256578947368"
"3","2018","31","Otros","6","10","58","82","0","0","58","82","3.8518518518518"
"3","2018","31","Hotel","4","21","177","355","31","36","208","391","3"
"3","2018","31","Hotel","11","36","97","183","59","106","156","289","2.375"
"3","2018","31","Otros","5","8","161","213","93","127","254","340","5"
"3","2018","31","Hotel","7","17","92","112","0","0","92","112","10"
"3","2018","27","Hotel","11","36","471","623","48","65","519","688","1"
"3","2018","31","Otros","9","30","32","39","0","0","32","39","2.3333333333333"
"3","2018","31","Hotel","12","35","23","46","90","167","113","213","1.7272727272727"
"3","2018","31","Otros","2","1","113","212","16","21","129","233","5.5"
"3","2018","31","Hotel","6","25","72","83","0","0","72","83","1"
"3","2018","31","Otros","5","5","12","372","0","0","12","372","3.65625"
"3","2018","31","Otros","2","29","34","103","124","395","158","498","3.28"
"3","2018","31","Hotel","2","6","15","20","9","14","24","34","5.5"
"3","2018","31","Otros","7","17","23","31","3","6","26","37","17.166666666667"
"3","2018","31","Hotel","8","2","28","28","20","20","48","48","3"
"3","2018","31","Hotel","13","14","29","44","7","7","36","51","1"
"3","2018","31","Otros","7","38","47","94","0","0","47","94","2.75"
"3","2018","31","Hotel","14","31","24","48","154","313","178","361","24"
"3","2018","31","Hotel","5","5","44","66","86","112","130","178","2.1428571428571"
"3","2018","31","Otros","2","27","3","3","4","6","7","9","3.2"
"3","2018","31","Otros","5","8","16","23","11","17","27","40","5"
"3","2018","31","Otros","3","4","38","131","4","44","42","175","12.2"
"3","2018","31","Otros","13","14","4","4","0","0","4","4","7.3846153846154"
"3","2018","31","Otros","9","37","59","240","0","0","59","240","4.5"
"3","2018","31","Hotel","10","23","851","951","88","123","939","1074","1"
"3","2018","31","Otros","11","32","12","12","2","2","14","14","2.2857142857143"
"3","2018","31","Otros","11","15","4","10","0","0","4","10","2.3571428571429"
"3","2018","31","Otros","8","3","28","105","15","45","43","150","10"
"3","2018","31","Otros","16","20","89","204","2","6","91","210","3.0769230769231"
"3","2018","31","Otros","8","3","17","56","0","0","17","56","10"
"3","2018","31","Otros","16","27","74","183","0","0","74","183","2"
"3","2018","31","Hotel","16","19","14","20","0","0","14","20","4"
"3","2018","31","Hotel","16","27","57","229","0","0","57","229","5.8571428571429"
"3","2018","31","Otros","9","26","27","61","0","0","27","61","3.8888888888889"
"3","2018","31","Otros","5","5","9","11","5","5","14","16","3.65625"
"3","2018","31","Otros","14","27","14","18","5","7","19","25","11.833333333333"
"3","2018","31","Hotel","5","5","21","76","37","105","58","181","2.1428571428571"
"3","2018","31","Hotel","12","24","107","235","142","287","249","522","3"
"3","2018","31","Otros","16","27","31","95","0","0","31","95","13.818181818182"
"3","2018","31","Otros","8","3","50","144","30","72","80","216","1"
"3","2018","31","Otros","13","27","213","301","3","3","216","304","12.2"
"3","2018","31","Hotel","16","40","48","66","15","52","63","118","16.333333333333"
"3","2018","31","Otros","11","36","35","157","0","0","35","157","1"
"3","2018","31","Otros","10","27","17","22","23","30","40","52","4.84"
"3","2018","31","Otros","9","22","76","172","0","0","76","172","7.6428571428571"
"3","2018","31","Hotel","5","5","20","31","58","101","78","132","2.1428571428571"
"3","2018","31","Otros","2","29","82","197","68","157","150","354","3.28"
"3","2018","31","Otros","2","29","6","18","2","2","8","20","3.28"
"3","2018","31","Hotel","13","14","47","47","2","2","49","49","1"
"3","2018","31","Otros","6","25","2","2","0","0","2","2","2.3846153846154"
"3","2018","31","Otros","2","1","8","11","2","2","10","13","5.5"
"3","2018","31","Hotel","12","27","28","33","105","125","133","158","1"
"3","2018","31","Hotel","13","27","11","16","0","0","11","16","4.2"
"3","2018","31","Otros","6","12","56","173","1","30","57","203","1.8256578947368"
"3","2018","31","Otros","6","27","12","13","0","0","12","13","3.960088691796"
"3","2018","31","Otros","6","25","30","32","0","0","30","32","2.3846153846154"
"3","2018","31","Hotel","6","28","19","63","0","0","19","63","2.5833333333333"
"3","2018","31","Otros","5","5","5","6","1","1","6","7","3.65625"
"3","2018","31","Otros","5","9","14","15","0","0","14","15","4.0454545454545"
"3","2018","31","Otros","5","8","8","10","4","12","12","22","5"
"3","2018","31","Hotel","2","29","130","335","146","450","276","785","1"
"3","2018","31","Otros","5","5","156","219","37","72","193","291","3.65625"
"3","2018","31","Hotel","9","26","24","98","7","9","31","107","1.5"
"3","2018","31","Otros","9","30","7","12","0","0","7","12","2.3333333333333"
"3","2018","31","Otros","11","15","40","84","3","5","43","89","2.3571428571429"
"3","2018","31","Hotel","16","27","4","6","6","6","10","12","5.8571428571429"
"3","2018","31","Otros","9","30","50","70","8","16","58","86","2.3333333333333"
"3","2018","7","Otros","2","29","7","14","0","0","7","14","3.28"
"3","2018","31","Otros","7","38","30","64","34","90","64","154","2.75"
"3","2018","31","Otros","4","21","68","282","10","48","78","330","4.8333333333333"
"3","2018","31","Otros","9","22","50","83","0","0","50","83","7.6428571428571"
"3","2018","31","Otros","9","22","91","178","0","0","91","178","7.6428571428571"
"3","2018","31","Otros","13","27","35","54","0","0","35","54","12.2"
"3","2018","31","Hotel","11","36","2446","2572","58","100","2504","2672","1"
"3","2018","31","Otros","13","33","10","30","0","0","10","30","5.125"
"3","2018","31","Otros","11","36","101","234","63","156","164","390","5.1904761904762"
"3","2018","31","Otros","12","35","111","186","199","312","310","498","3.5"
"3","2018","31","Otros","12","35","14","30","20","40","34","70","3.5"
"3","2018","31","Otros","10","11","72","121","0","0","72","121","11.764705882353"
"3","2018","31","Otros","12","24","17","45","21","42","38","87","9.2"
"3","2018","31","Otros","16","20","24","40","0","0","24","40","3.0769230769231"
"3","2018","31","Hotel","7","27","14","14","0","0","14","14","1"
"3","2018","31","Otros","6","12","15","29","3","22","18","51","1.8256578947368"
"3","2018","31","Otros","11","32","53","129","24","70","77","199","2.2857142857143"
"3","2018","31","Otros","6","28","100","111","2","2","102","113","4.65"
"3","2018","31","Otros","8","34","1","1","0","0","1","1","5.75"
"3","2018","31","Otros","16","27","127","142","0","0","127","142","13.818181818182"
"3","2018","31","Otros","10","11","5","6","0","0","5","6","11.764705882353"
"3","2018","31","Otros","6","10","44","104","0","0","44","104","3.8518518518518"
"3","2018","31","Otros","8","3","2","2","0","0","2","2","10"
"3","2018","31","Hotel","16","20","82","164","32","64","114","228","1"
"3","2018","31","Hotel","11","32","90","116","22","28","112","144","1"
"3","2018","31","Otros","8","27","89","326","6","14","95","340","9.4"
"3","2018","31","Otros","12","27","55","147","31","37","86","184","3.4285714285714"
"3","2018","31","Otros","6","10","25","39","0","0","25","39","3.8518518518518"
"3","2018","31","Otros","6","10","13","71","0","0","13","71","3.8518518518518"
"3","2018","31","Otros","5","8","45","58","0","0","45","58","5"
"3","2018","31","Otros","5","8","18","23","6","8","24","31","5"
"3","2018","31","Hotel","9","26","60","87","6","13","66","100","1.5"
"3","2018","31","Hotel","13","14","22","44","11","21","33","65","1"
"3","2018","31","Otros","10","18","89","282","54","212","143","494","10.25"
"3","2018","31","Otros","8","2","54","58","17","19","71","77","6.4285714285714"
"3","2018","31","Otros","7","27","20","66","0","0","20","66","4.8333333333333"
"3","2018","31","Otros","2","29","8","12","23","40","31","52","3.28"
"3","2018","10","Otros","11","32","6","10","1","1","7","11","2.2857142857143"
"3","2018","31","Otros","9","30","28","66","0","0","28","66","2.3333333333333"
"3","2018","31","Otros","2","29","4","14","4","8","8","22","3.28"
"3","2018","31","Otros","5","5","18","27","9","13","27","40","3.65625"
"3","2018","31","Otros","11","15","21","25","0","0","21","25","2.3571428571429"
"3","2018","31","Otros","10","23","26","26","0","0","26","26","7"
"3","2018","31","Otros","11","36","65","374","14","39","79","413","5.1904761904762"
"3","2018","31","Hotel","3","7","19","19","47","94","66","113","1"
"3","2018","31","Otros","10","27","19","21","12","12","31","33","4.84"
"3","2018","31","Otros","2","27","12","12","0","0","12","12","3.2"
"3","2018","31","Otros","12","35","32","52","34","62","66","114","3.5"
"3","2018","31","Otros","10","27","16","24","12","30","28","54","4.84"
"3","2018","31","Otros","16","40","14","34","109","252","123","286","28.142857142857"
"3","2018","31","Hotel","8","3","402","1106","222","540","624","1646","4.1111111111111"
"3","2018","31","Otros","9","22","82","112","0","0","82","112","7.6428571428571"
"3","2018","31","Otros","13","14","16","28","0","0","16","28","7.3846153846154"
"3","2018","31","Otros","5","9","14","23","4","8","18","31","4.0454545454545"
"3","2018","31","Otros","10","18","56","75","35","89","91","164","10.25"
"3","2018","31","Otros","6","25","118","241","0","0","118","241","2.3846153846154"
"3","2018","31","Otros","9","22","26","44","0","0","26","44","7.6428571428571"
"3","2018","31","Otros","10","27","54","142","6","6","60","148","4.84"
"3","2018","31","Otros","16","20","45","78","0","0","45","78","3.0769230769231"
"3","2018","31","Hotel","7","17","136","219","4","4","140","223","10"
"3","2018","31","Otros","15","27","53","92","0","0","53","92","1.4222222222222"
"3","2018","31","Otros","12","35","9","9","24","26","33","35","3.5"
"3","2018","31","Otros","12","35","10","12","190","256","200","268","3.5"
"3","2018","31","Otros","3","7","7","12","5","5","12","17","2"
"3","2018","31","Otros","10","11","7","7","5","10","12","17","11.764705882353"
"3","2018","31","Otros","12","24","4","8","2","6","6","14","9.2"
"3","2018","31","Otros","10","23","20","28","0","0","20","28","7"
"3","2018","31","Otros","7","27","2","3","0","0","2","3","4.8333333333333"
"3","2018","31","","10","18","10","49","0","0","10","49","1"
"3","2018","31","Otros","16","27","3","3","2","2","5","5","13.818181818182"
"3","2018","24","Hotel","2","29","21","53","28","88","49","141","1"
"3","2018","31","Otros","14","27","31","62","0","0","31","62","11.833333333333"
"3","2018","31","Otros","11","32","137","177","0","0","137","177","2.2857142857143"
"3","2018","31","Otros","16","19","44","108","0","0","44","108","1"
"3","2018","31","Otros","16","27","33","42","0","0","33","42","13.818181818182"
"3","2018","31","Otros","8","3","71","256","19","122","90","378","10"
"3","2018","31","Otros","16","27","84","160","0","0","84","160","13.818181818182"
"3","2018","31","Otros","16","20","66","135","8","18","74","153","3.0769230769231"
"3","2018","31","Otros","16","40","109","212","21","32","130","244","28.142857142857"
"3","2018","31","Hotel","11","36","82","143","25","64","107","207","2.375"
"3","2018","31","Otros","6","10","39","71","0","0","39","71","3.8518518518518"
"3","2018","31","Otros","7","38","157","492","43","98","200","590","2.75"
"3","2018","31","Otros","13","14","23","27","0","0","23","27","7.3846153846154"
"3","2018","31","Otros","9","30","31","34","0","0","31","34","2.3333333333333"
"3","2018","31","Otros","13","27","15","33","0","0","15","33","12.2"
"3","2018","31","Otros","10","27","29","29","23","23","52","52","4.84"
"3","2018","31","Otros","6","25","48","67","35","49","83","116","2.3846153846154"
"3","2018","31","Otros","9","26","29","221","0","0","29","221","3.8888888888889"
"3","2018","31","Otros","10","18","16","28","41","50","57","78","10.25"
"3","2018","31","Otros","2","29","56","145","12","26","68","171","3.28"
"3","2018","31","Otros","6","25","51","59","0","0","51","59","2.3846153846154"
"3","2018","31","Otros","5","9","16","26","4","6","20","32","4.0454545454545"
"3","2018","31","Otros","5","9","10","12","0","0","10","12","4.0454545454545"
"3","2018","31","Hotel","9","37","68","90","0","0","68","90","3.4"
"3","2018","29","Hotel","7","38","149","165","49","57","198","222","1"
"3","2018","31","Otros","7","27","41","52","0","0","41","52","4.8333333333333"
"3","2018","31","Otros","5","9","2","2","0","0","2","2","4.0454545454545"
"3","2018","31","Otros","10","27","2","2","4","4","6","6","4.84"
"3","2018","31","Otros","7","27","26","69","0","0","26","69","4.8333333333333"
"3","2018","31","Otros","16","40","41","74","27","47","68","121","28.142857142857"
"3","2018","31","Otros","10","23","22","22","1","1","23","23","7"
"3","2018","31","Otros","15","16","71","349","7","13","78","362","9"
"3","2018","30","Otros","3","7","22","40","80","163","102","203","2"
"3","2018","31","Otros","7","17","42","99","5","11","47","110","17.166666666667"
"3","2018","31","Otros","8","27","43","87","3","3","46","90","9.4"
"3","2018","31","Otros","9","22","39","144","0","0","39","144","7.6428571428571"
"3","2018","31","Otros","16","19","31","46","0","0","31","46","10.263157894737"
"3","2018","31","","15","27","9","9","0","0","9","9","1"
"3","2018","31","Hotel","10","11","23","23","10","10","33","33","5.6666666666667"
"3","2018","31","Otros","2","27","5","20","11","14","16","34","3.2"
"3","2018","31","Otros","8","2","57","79","48","67","105","146","6.4285714285714"
"3","2018","31","Otros","5","5","4","6","0","0","4","6","3.65625"
"3","2018","31","Otros","12","35","1","1","5","6","6","7","3.5"
"3","2018","31","Otros","8","3","4","8","30","70","34","78","10"
"3","2018","31","Otros","12","24","0","0","62","99","62","99","9.2"
"3","2018","31","Otros","11","32","48","229","0","0","48","229","2.2857142857143"
"3","2018","31","Otros","10","27","44","70","104","155","148","225","4.84"
"3","2018","31","Otros","11","15","23","48","3","9","26","57","2.3571428571429"
"3","2018","31","Otros","5","8","9","15","19","25","28","40","5"
"3","2018","31","Otros","14","27","25","25","2","2","27","27","11.833333333333"
"3","2018","31","Otros","13","27","80","144","4","8","84","152","12.2"
"3","2018","31","Hotel","10","18","77","247","81","125","158","372","3.2"
"3","2018","31","Otros","10","27","19","19","30","30","49","49","4.84"
"3","2018","31","Otros","11","32","33","137","0","0","33","137","1"
"3","2018","31","Otros","9","37","25","49","0","0","25","49","4.5"
"3","2018","31","Otros","12","35","79","79","328","328","407","407","3.5"
"3","2018","31","Otros","8","34","76","154","58","99","134","253","5.75"
"3","2018","31","Hotel","16","40","11","18","57","148","68","166","16.333333333333"
"3","2018","31","Hotel","10","11","55","147","30","119","85","266","5.6666666666667"
"3","2018","31","Otros","7","27","14","42","0","0","14","42","4.8333333333333"
"3","2018","31","Hotel","7","38","0","0","0","0","0","0","1"
"3","2018","31","Otros","6","27","5","11","0","0","5","11","3.960088691796"
"3","2018","31","Otros","6","10","47","120","0","0","47","120","3.8518518518518"
"3","2018","31","Otros","6","25","109","184","0","0","109","184","1"
"3","2018","31","Otros","6","25","10","14","0","0","10","14","2.3846153846154"
"3","2018","31","Otros","6","27","8","248","0","0","8","248","3.960088691796"
"3","2018","31","Otros","6","27","53","159","0","0","53","159","3.960088691796"
"3","2018","31","Otros","5","5","6","6","4","4","10","10","3.65625"
"3","2018","31","Otros","5","5","9","13","0","0","9","13","3.65625"
"3","2018","31","Otros","3","4","21","29","6","10","27","39","12.2"
"3","2018","31","Otros","10","23","28","66","0","0","28","66","7"
"3","2018","31","Otros","8","3","5","20","0","0","5","20","10"
"3","2018","31","Otros","5","5","24","84","3","3","27","87","3.65625"
"3","2018","31","Otros","5","8","20","37","12","18","32","55","5"
"3","2018","29","Otros","6","10","12","28","2","6","14","34","3.8518518518518"
"3","2018","31","Otros","16","19","16","52","0","0","16","52","10.263157894737"
"3","2018","31","Otros","11","15","25","53","19","38","44","91","2.3571428571429"
"3","2018","31","Otros","7","38","51","71","0","0","51","71","2.75"
"3","2018","31","Otros","11","32","110","228","62","344","172","572","2.2857142857143"
"3","2018","31","Otros","8","2","12","14","4","4","16","18","6.4285714285714"
"3","2018","31","Otros","10","27","38","64","15","24","53","88","4.84"
"3","2018","31","Otros","6","27","10","15","0","0","10","15","3.960088691796"
"3","2018","31","Otros","11","32","49","82","2","5","51","87","2.2857142857143"
"3","2018","31","Otros","8","34","36","41","32","74","68","115","5.75"
"3","2018","31","Otros","11","32","5","11","0","0","5","11","2.2857142857143"
"3","2018","31","Otros","10","11","18","22","6","8","24","30","11.764705882353"
"3","2018","31","Otros","11","32","9","23","1","4","10","27","2.2857142857143"
"3","2018","31","Otros","14","31","5","12","14","17","19","29","20.2"
"3","2018","31","Hotel","14","31","208","347","602","1998","810","2345","17.4"
"3","2018","31","Otros","11","36","279","449","19","33","298","482","5.1904761904762"
"3","2018","31","Hotel","15","16","1087","2347","224","460","1311","2807","2"
"3","2018","31","Otros","15","27","12","16","9","16","21","32","1.4222222222222"
"3","2018","31","Otros","5","5","5","7","10","10","15","17","3.65625"
"3","2018","31","Otros","8","34","11","11","14","14","25","25","5.75"
"3","2018","31","Otros","7","27","43","77","0","0","43","77","4.8333333333333"
"3","2018","31","Otros","12","35","3","3","0","0","3","3","3.5"
"3","2018","31","Otros","5","5","75","90","0","0","75","90","3.65625"
"3","2018","31","Otros","10","11","6","12","0","0","6","12","11.764705882353"
"3","2018","31","Otros","10","11","1","1","0","0","1","1","11.764705882353"
"3","2018","31","Otros","9","30","3","50","0","0","3","50","2.3333333333333"
"3","2018","31","Otros","8","2","22","34","1","2","23","36","6.4285714285714"
"3","2018","31","Otros","10","27","76","160","19","32","95","192","4.84"
"3","2018","31","Otros","5","9","10","20","10","20","20","40","4.0454545454545"
"3","2018","31","Otros","6","27","18","36","0","0","18","36","3.960088691796"
"3","2018","31","Otros","6","10","78","166","12","23","90","189","3.8518518518518"
"3","2018","31","Otros","6","10","39","68","0","0","39","68","3.8518518518518"
"3","2018","31","Otros","6","27","32","61","0","0","32","61","3.960088691796"
"3","2018","31","Otros","6","12","4","36","0","0","4","36","1.8256578947368"
"3","2018","31","Otros","6","10","30","68","0","0","30","68","3.8518518518518"
"3","2018","10","Otros","6","10","6","14","0","0","6","14","3.8518518518518"
"3","2018","31","Otros","6","27","2","3","0","0","2","3","3.960088691796"
"3","2018","31","Otros","6","12","57","80","0","0","57","80","1.8256578947368"
"3","2018","31","Otros","6","10","11","22","0","0","11","22","3.8518518518518"
"3","2018","31","Hotel","6","25","81","144","0","0","81","144","1"
"3","2018","4","Otros","6","27","6","6","0","0","6","6","3.960088691796"
"3","2018","31","Otros","5","9","12","23","28","47","40","70","4.0454545454545"
"3","2018","31","Otros","5","5","26","81","6","12","32","93","3.65625"
"3","2018","31","Otros","5","5","61","84","13","20","74","104","3.65625"
"3","2018","31","Otros","5","5","64","104","12","21","76","125","3.65625"
"3","2018","31","Otros","11","36","95","190","20","48","115","238","5.1904761904762"
"3","2018","31","Hotel","6","10","480","1020","32","54","512","1074","1"
"3","2018","31","Otros","5","9","11","12","1","1","12","13","4.0454545454545"
"3","2018","31","Otros","5","8","17","22","21","30","38","52","5"
"3","2018","0","Hotel","15","27","0","0","0","0","0","0","1"
"3","2018","31","Hotel","3","4","281","1617","18","42","299","1659","3"
"3","2018","31","Otros","3","7","19","19","17","17","36","36","1"
"3","2018","31","Otros","7","38","121","184","4","6","125","190","2.75"
"3","2018","31","Hotel","10","27","61","82","133","181","194","263","1"
"3","2018","31","Hotel","12","35","0","0","68","139","68","139","1.7272727272727"
"3","2018","31","Hotel","10","27","6","6","0","0","6","6","2.25"
"3","2018","31","Hotel","7","17","464","790","96","197","560","987","4"
"3","2018","11","Hotel","16","19","18","22","6","10","24","32","4"
"3","2018","13","Hotel","2","6","349","717","0","0","349","717","2.2"
"3","2018","31","Otros","5","5","67","348","26","167","93","515","3.65625"
"3","2018","31","Otros","12","24","82","95","157","179","239","274","9.2"
"3","2018","31","Otros","5","8","14","19","0","0","14","19","5"
"3","2018","31","Otros","4","13","187","217","15","15","202","232","1"
"3","2018","31","Otros","10","11","79","79","0","0","79","79","11.764705882353"
"3","2018","31","Otros","12","35","54","99","333","433","387","532","3.5"
"3","2018","31","Otros","10","23","127","132","11","13","138","145","7"
"3","2018","31","Otros","11","36","671","1375","188","379","859","1754","5.1904761904762"
"3","2018","31","Otros","12","35","40","44","90","102","130","146","3.5"
"3","2018","31","Otros","11","36","75","191","12","20","87","211","5.1904761904762"
"3","2018","31","Otros","8","2","20","34","6","15","26","49","6.4285714285714"
"3","2018","31","Otros","9","30","52","96","0","0","52","96","2.3333333333333"
"3","2018","31","Otros","11","36","97","269","10","10","107","279","5.1904761904762"
"3","2018","31","Otros","6","10","14","36","0","0","14","36","3.8518518518518"
"3","2018","31","Otros","10","18","11","22","0","0","11","22","10.25"
"3","2018","31","Otros","7","27","13","55","6","8","19","63","4.8333333333333"
"3","2018","31","Otros","16","20","32","128","0","0","32","128","1"
"3","2018","31","Otros","9","22","34","61","0","0","34","61","7.6428571428571"
"3","2018","31","Otros","5","5","128","210","20","39","148","249","3.65625"
"3","2018","31","Otros","12","35","36","45","76","83","112","128","3.5"
"3","2018","31","Otros","10","11","54","87","3","3","57","90","11.764705882353"
"3","2018","31","Otros","10","11","2","4","0","0","2","4","11.764705882353"
"3","2018","25","Otros","5","9","33","66","10","16","43","82","4.0454545454545"
"3","2018","31","Otros","5","5","10","310","0","0","10","310","3.65625"
"3","2018","31","Otros","12","35","0","0","22","37","22","37","3.5"
"3","2018","31","Otros","7","38","114","296","14","36","128","332","2.75"
"3","2018","31","Hotel","12","35","10","20","205","380","215","400","1.7272727272727"
"3","2018","31","Otros","13","14","53","72","0","0","53","72","1"
"3","2018","31","Otros","5","5","4","10","8","22","12","32","3.65625"
"3","2018","31","Hotel","9","26","10","20","0","0","10","20","1.5"
"3","2018","7","Hotel","16","19","58","58","0","0","58","58","1"
"3","2018","31","Otros","16","19","34","43","0","0","34","43","10.263157894737"
"3","2018","31","Otros","9","30","51","62","0","0","51","62","2.3333333333333"
"3","2018","31","Otros","16","19","8","8","0","0","8","8","10.263157894737"
"3","2018","31","Otros","16","19","124","299","0","0","124","299","10.263157894737"
"3","2018","31","Otros","9","26","10","17","0","0","10","17","3.8888888888889"
"3","2018","31","Otros","16","40","3","5","0","0","3","5","28.142857142857"
"3","2018","31","Hotel","16","27","14","40","0","0","14","40","5.8571428571429"
"3","2018","31","Otros","16","19","11","60","0","0","11","60","10.263157894737"
"3","2018","31","Otros","16","19","71","96","0","0","71","96","10.263157894737"
"3","2018","31","","9","30","48","233","14","87","62","320","1"
"3","2018","31","Otros","16","19","57","74","0","0","57","74","10.263157894737"
"3","2018","31","Otros","10","11","3","3","0","0","3","3","11.764705882353"
"3","2018","31","Otros","11","36","14","14","0","0","14","14","5.1904761904762"
"3","2018","31","Otros","16","19","8","14","0","0","8","14","10.263157894737"
"3","2018","31","Otros","16","19","242","362","0","0","242","362","1.3333333333333"
"3","2018","31","Otros","16","19","54","56","0","0","54","56","10.263157894737"
"3","2018","31","Otros","10","18","30","70","54","121","84","191","10.25"
"3","2018","31","Otros","16","19","19","39","0","0","19","39","10.263157894737"
"3","2018","31","Otros","16","19","10","16","0","0","10","16","1.3333333333333"
"3","2018","31","","9","26","219","906","0","0","219","906","1"
"3","2018","31","Otros","16","19","15","19","0","0","15","19","10.263157894737"
"3","2018","23","Otros","16","19","52","71","6","6","58","77","10.263157894737"
"3","2018","31","Hotel","8","2","397","786","75","147","472","933","1"
"3","2018","31","Otros","6","10","22","28","0","0","22","28","3.8518518518518"
"3","2018","31","Otros","6","12","43","43","0","0","43","43","1.8256578947368"
"3","2018","31","Hotel","16","19","56","84","5","5","61","89","1"
"3","2018","18","Otros","3","7","4","4","6","6","10","10","2"
"3","2018","31","Hotel","2","6","839","2488","146","287","985","2775","1"
"3","2018","31","Hotel","3","4","457","744","117","165","574","909","2.6"
"3","2018","31","Hotel","16","40","1988","3040","1265","2023","3253","5063","1"
"3","2018","31","Otros","16","27","87","103","0","0","87","103","13.818181818182"
"3","2018","31","Hotel","6","28","195","345","27","33","222","378","2.4"
"3","2018","31","Hotel","8","34","1572","2442","288","434","1860","2876","1"
"3","2018","31","Otros","9","30","15","17","0","0","15","17","2.3333333333333"
"3","2018","31","Hotel","10","18","48","118","172","291","220","409","1"
"3","2018","31","Hotel","9","30","87","126","4","8","91","134","1"
"3","2018","31","Hotel","15","27","37","44","0","0","37","44","1"
"3","2018","31","Hotel","9","22","46","288","0","0","46","288","2.5555555555556"
"3","2018","31","","11","15","33","33","0","0","33","33","1"
"3","2018","31","Otros","6","12","11","19","4","6","15","25","1.8256578947368"
"3","2018","31","Hotel","15","27","30","930","0","0","30","930","1"
"3","2018","31","Otros","15","27","18","18","0","0","18","18","1.4222222222222"
"3","2018","31","Otros","15","27","7","217","0","0","7","217","1.4222222222222"
"3","2018","31","Otros","2","1","17","17","12","12","29","29","1"
"3","2018","31","Otros","12","24","3","5","6","6","9","11","9.2"
"3","2018","31","Otros","5","5","24","33","23","32","47","65","3.65625"
"3","2018","31","Hotel","7","27","156","178","16","18","172","196","1"
"3","2018","31","Otros","16","20","88","116","0","0","88","116","3.0769230769231"
"3","2018","31","","10","11","192","355","25","58","217","413","1"
"3","2018","31","Hotel","16","40","26","44","28","39","54","83","16.333333333333"
"3","2018","31","Otros","12","35","12","16","4","4","16","20","3.5"
"3","2018","31","Hotel","6","27","17","23","4","6","21","29","3"
"3","2018","31","Otros","5","5","43","56","0","0","43","56","3.65625"
"3","2018","31","Hotel","6","27","58","82","4","4","62","86","3"
"3","2018","31","Otros","6","25","53","69","0","0","53","69","2.3846153846154"
"3","2018","0","Hotel","15","27","0","0","0","0","0","0","1"
"3","2018","31","Otros","5","9","15","24","58","77","73","101","4.0454545454545"
"3","2018","31","Hotel","15","27","60","60","0","0","60","60","1"
"3","2018","31","Hotel","5","9","40","53","5","10","45","63","1"
"3","2018","31","Hotel","8","34","74","134","39","63","113","197","2.5714285714286"
"3","2018","0","Hotel","15","27","0","0","0","0","0","0","1"
"3","2018","31","Hotel","6","27","311","539","0","0","311","539","3"
"3","2018","31","Otros","6","27","20","34","0","0","20","34","1"
"3","2018","31","Otros","12","27","2","2","15","15","17","17","3.4285714285714"
"3","2018","31","Hotel","2","27","704","799","346","357","1050","1156","1"
"3","2018","31","Hotel","2","6","417","417","0","0","417","417","1"
"3","2018","31","Otros","2","6","55","55","0","0","55","55","1"
"3","2018","31","Hotel","4","39","96","96","0","0","96","96","1"
"3","2018","31","Hotel","6","10","432","592","28","43","460","635","1"
"3","2018","31","Otros","5","8","35","55","18","44","53","99","5"
"3","2018","0","Hotel","13","33","0","0","0","0","0","0","1"
"3","2018","31","Hotel","13","33","103","206","24","48","127","254","1"
"3","2018","31","Otros","11","32","204","468","23","69","227","537","2.2857142857143"
"3","2018","31","Hotel","9","26","439","992","202","342","641","1334","1"
"3","2018","31","Hotel","16","20","102","134","4","8","106","142","1"
"3","2018","31","Otros","16","20","27","34","4","4","31","38","3.0769230769231"
"3","2018","31","","16","40","669","1326","63","172","732","1498","1"
"3","2018","31","Hotel","15","16","1308","2599","239","642","1547","3241","1"
"3","2018","31","Hotel","5","9","31","36","34","48","65","84","1"
"3","2018","31","Otros","7","38","78","267","4","5","82","272","2.75"
"3","2018","31","Otros","2","6","2849","2849","0","0","2849","2849","1"
"3","2018","31","Otros","2","6","98","435","0","0","98","435","1"
"3","2018","31","Hotel","15","27","281","830","22","22","303","852","1"
"3","2018","31","Otros","7","38","60","85","2","4","62","89","2.75"
"3","2018","31","Otros","2","1","19","48","16","37","35","85","1"
"3","2018","31","Otros","8","3","32","39","4","5","36","44","10"
"3","2018","31","Otros","11","36","31","84","0","0","31","84","5.1904761904762"
"3","2018","31","Otros","16","20","55","108","0","0","55","108","3.0769230769231"
"3","2018","31","Otros","8","3","254","386","2","8","256","394","1"
"3","2018","31","Otros","4","39","72","103","1","17","73","120","2.2222222222222"
"3","2018","31","Otros","5","5","225","439","160","317","385","756","3.65625"
"3","2018","31","Otros","12","27","0","0","16","17","16","17","3.4285714285714"
"3","2018","31","Otros","7","27","74","361","0","0","74","361","1"
"3","2018","31","Hotel","2","6","335","451","30","34","365","485","1"
"3","2018","31","Hotel","14","27","308","706","133","224","441","930","1"
"3","2018","31","Hotel","16","19","291","460","0","0","291","460","1"
"3","2018","31","","2","1","12","168","0","0","12","168","1"
"3","2018","31","Hotel","2","27","45","122","5","6","50","128","1"
"3","2018","31","Otros","16","20","0","0","75","774","75","774","1"
"3","2018","31","Otros","13","14","38","87","6","12","44","99","1"
"3","2018","31","Hotel","11","36","129","458","0","0","129","458","2.375"
"3","2018","31","Otros","13","14","30","300","0","0","30","300","7.3846153846154"
"3","2018","31","Otros","12","27","11","18","0","0","11","18","3.4285714285714"
"3","2018","31","Hotel","2","6","208","406","29","29","237","435","2.2"
"3","2018","31","Otros","2","6","1840","2666","0","0","1840","2666","1"
"3","2018","31","Otros","10","27","4","86","0","0","4","86","4.84"
"3","2018","31","Otros","12","27","11","15","10","10","21","25","3.4285714285714"
"3","2018","31","Otros","13","14","24","93","0","0","24","93","7.3846153846154"
"3","2018","31","Otros","6","12","133","202","17","26","150","228","1.8256578947368"
"3","2018","31","Otros","2","6","744","1104","80","171","824","1275","1"
"3","2018","31","Hotel","12","35","46","75","2","4","48","79","1.7272727272727"
"3","2018","31","Otros","5","5","21","29","5","14","26","43","3.65625"
"3","2018","31","Otros","9","30","0","0","9","279","9","279","2.3333333333333"
"3","2018","0","Hotel","8","2","0","0","0","0","0","0","1"
"3","2018","31","Otros","9","30","12","54","0","0","12","54","2.3333333333333"
"3","2018","31","Hotel","15","27","24","28","0","0","24","28","1"
"3","2018","31","Hotel","3","7","23","23","2","2","25","25","1"
"3","2018","31","Otros","6","12","369","572","0","0","369","572","1.8256578947368"
"3","2018","31","Otros","12","27","25","48","11","15","36","63","3.4285714285714"
"3","2018","12","Otros","2","6","8","16","0","0","8","16","5"
"3","2018","31","Otros","6","27","25","56","0","0","25","56","3.960088691796"
"3","2018","0","Hotel","10","11","0","0","0","0","0","0","1"
"3","2018","31","Otros","2","1","8","56","0","0","8","56","1"
"3","2018","31","Otros","11","36","13","13","0","0","13","13","5.1904761904762"
"3","2018","31","Hotel","11","32","0","0","0","0","0","0","1"
"3","2018","31","Otros","2","27","7","140","0","0","7","140","1"
"3","2018","31","Otros","12","27","1","1","6","6","7","7","3.4285714285714"
"3","2018","31","Hotel","8","2","18","18","0","0","18","18","3"
"3","2018","31","Hotel","16","20","92","92","0","0","92","92","1"
"3","2018","31","Otros","12","35","49","91","94","182","143","273","3.5"
"3","2018","31","Otros","13","14","60","157","0","0","60","157","1"
"3","2018","31","Otros","2","27","12","60","0","0","12","60","3.2"
"3","2018","31","Hotel","6","27","21","21","0","0","21","21","3"
"3","2018","31","Hotel","8","3","32","59","18","50","50","109","4.1111111111111"
"3","2018","31","Hotel","15","27","26","54","0","0","26","54","1"
"3","2018","31","Otros","8","3","15","81","0","0","15","81","10"
"3","2018","31","Hotel","16","20","37","59","0","0","37","59","1"
"3","2018","31","Hotel","6","28","109","263","0","0","109","263","2.4"
"3","2018","31","Otros","2","1","29","62","4","6","33","68","5.5"
"3","2018","31","Hotel","11","36","99","157","206","453","305","610","2.375"
"3","2018","31","Otros","4","13","95","897","1","2","96","899","1"
"3","2018","31","Otros","2","6","184","1288","0","0","184","1288","1"
"3","2018","31","Otros","8","34","141","179","47","69","188","248","5.75"
"3","2018","0","Hotel","11","15","0","0","0","0","0","0","1"
"3","2018","31","Otros","15","27","30","450","0","0","30","450","1.4222222222222"
"3","2018","31","Hotel","13","14","134","192","10","21","144","213","1"
"3","2018","31","Hotel","13","14","244","416","35","69","279","485","1"
"3","2018","31","Hotel","9","30","87","158","14","61","101","219","1"
"3","2018","31","Hotel","4","13","126","259","125","209","251","468","5.4"
"3","2018","31","Otros","6","27","5","22","0","0","5","22","3.960088691796"
"3","2018","0","Hotel","15","27","0","0","0","0","0","0","1"
"3","2018","31","Hotel","2","29","9","23","95","320","104","343","2"
"3","2018","31","Hotel","13","33","14","23","0","0","14","23","2"
"3","2018","31","Hotel","12","35","54","99","154","308","208","407","1.7272727272727"
"3","2018","31","Hotel","13","14","212","344","34","56","246","400","1"
"3","2018","31","Otros","6","25","19","38","0","0","19","38","2.3846153846154"
"3","2018","31","Hotel","8","2","57","94","16","22","73","116","3"
"3","2018","31","Otros","4","39","56","136","0","0","56","136","2.2222222222222"
"3","2018","31","Otros","6","12","160","169","30","33","190","202","1.8256578947368"
"3","2018","31","Otros","13","33","63","102","26","43","89","145","5.125"
"3","2018","31","Hotel","4","13","167","247","88","159","255","406","5.4"
"3","2018","31","Hotel","7","27","180","242","7","15","187","257","4.1666666666667"
"3","2018","31","Hotel","4","13","458","1547","101","278","559","1825","1"
"3","2018","31","","5","8","18","31","10","22","28","53","1"
"3","2018","31","Otros","8","2","21","53","0","0","21","53","6.4285714285714"
"3","2018","31","Otros","2","6","24","24","17","17","41","41","1"
"3","2018","31","","6","10","38","76","0","0","38","76","1"
"3","2018","31","Hotel","2","29","56","89","73","123","129","212","2"
"3","2018","31","","14","31","211","375","436","1306","647","1681","1"
"3","2018","31","Hotel","16","27","5216","15650","0","0","5216","15650","1"
"3","2018","31","Hotel","12","35","89","154","72","126","161","280","1.7272727272727"
"3","2018","31","","12","35","1374","1716","6112","7017","7486","8733","1"
"3","2018","31","","9","26","107","137","10","19","117","156","1"
"3","2018","31","Otros","11","32","94","133","0","0","94","133","2.2857142857143"
"3","2018","31","Otros","12","24","36","106","79","108","115","214","9.2"
"3","2018","31","Hotel","6","25","39","43","1","2","40","45","1"
"3","2018","31","Otros","11","32","13","20","7","7","20","27","2.2857142857143"
"3","2018","31","Hotel","16","19","21","24","1","2","22","26","4"
"3","2018","31","Otros","13","33","35","39","0","0","35","39","5.125"
"3","2018","31","Otros","16","27","40","100","2","24","42","124","13.818181818182"
"3","2018","31","Otros","6","12","122","219","11","30","133","249","1.8256578947368"
"3","2018","31","Otros","2","29","11","13","0","0","11","13","3.28"
"3","2018","31","Hotel","14","27","618","700","231","296","849","996","1"
"3","2018","31","Otros","2","1","1","1","0","0","1","1","1"
"3","2018","31","Otros","11","32","31","31","0","0","31","31","2.2857142857143"
"3","2018","31","Otros","2","27","53","57","1","2","54","59","1"
"3","2018","31","Hotel","2","29","162","695","24","75","186","770","1"
"3","2018","31","Hotel","4","13","44","412","0","0","44","412","3.2"
"3","2018","31","Hotel","4","21","23","43","8","13","31","56","3"
"3","2018","29","Otros","7","27","112","120","6","8","118","128","4.8333333333333"
"3","2018","31","","3","4","58","125","4","6","62","131","1"
"3","2018","31","Hotel","6","27","10","10","4","8","14","18","3"
"3","2018","31","Otros","16","19","18","23","0","0","18","23","10.263157894737"
"3","2018","31","Otros","11","32","56","123","13","27","69","150","2.2857142857143"
"3","2018","31","Otros","3","7","23","31","35","70","58","101","2"
"3","2018","31","Otros","5","5","45","75","5","10","50","85","3.65625"
"3","2018","24","Otros","15","27","948","1368","0","0","948","1368","1.4222222222222"
"3","2018","31","Otros","6","25","47","65","0","0","47","65","2.3846153846154"
"3","2018","20","","10","27","12","20","8","14","20","34","1"
"3","2018","31","Otros","2","29","30","61","143","226","173","287","3.28"
"3","2018","31","Otros","12","35","3","3","33","49","36","52","3.5"
"3","2018","31","Otros","16","19","18","25","5","15","23","40","10.263157894737"
"3","2018","31","Otros","9","26","72","96","0","0","72","96","3.8888888888889"
"3","2018","31","Hotel","13","33","43","43","6","6","49","49","2"
"3","2018","19","Otros","11","32","13","25","14","34","27","59","2.2857142857143"
"3","2018","31","Otros","9","22","12","25","0","0","12","25","7.6428571428571"
"3","2018","31","Otros","6","27","15","315","0","0","15","315","3.960088691796"
"3","2018","31","Otros","15","27","19","35","0","0","19","35","1.4222222222222"
"3","2018","31","Otros","11","32","89","89","5","5","94","94","2.2857142857143"
"3","2018","31","Otros","11","15","32","57","2","2","34","59","2.3571428571429"
"3","2018","31","Otros","9","37","17","112","0","0","17","112","4.5"
"3","2018","31","Otros","5","9","25","48","9","19","34","67","4.0454545454545"
"3","2018","31","Hotel","10","27","28","76","0","0","28","76","2.25"
"3","2018","31","Otros","6","28","15","115","3","15","18","130","4.65"
"3","2018","31","Otros","4","13","32","48","1","1","33","49","3.4"
"3","2018","31","Otros","2","1","1","1","0","0","1","1","1"
"3","2018","31","Otros","2","29","39","88","52","104","91","192","3.28"
"3","2018","31","Hotel","8","3","59","104","8","14","67","118","4.1111111111111"
"3","2018","31","Otros","16","19","209","792","0","0","209","792","1.3333333333333"
"3","2018","31","Otros","12","35","8","17","40","51","48","68","3.5"
"3","2018","31","Hotel","12","35","27","42","173","226","200","268","1.7272727272727"
"3","2018","31","Otros","12","35","25","40","54","96","79","136","3.5"
"3","2018","31","Otros","2","29","81","114","139","179","220","293","3.28"
"3","2018","31","Hotel","7","27","133","196","18","20","151","216","1"
"3","2018","31","Hotel","9","22","38","49","1","3","39","52","2.5555555555556"
"3","2018","31","Hotel","12","35","48","86","134","191","182","277","1.7272727272727"
"3","2018","31","Otros","15","16","111","211","14","58","125","269","2"
"3","2018","31","Hotel","15","27","23","46","2","4","25","50","1"
"3","2018","31","Otros","4","13","61","93","12","22","73","115","3.4"
"3","2018","31","Hotel","8","34","104","165","42","80","146","245","2.5714285714286"
"3","2018","31","Hotel","16","20","64","128","0","0","64","128","1"
"3","2018","31","Hotel","6","28","192","227","42","65","234","292","2.4"
"3","2018","31","Hotel","15","27","77","291","11","15","88","306","1"
"3","2018","31","Otros","12","35","185","338","72","197","257","535","3.5"
"3","2018","31","Otros","11","15","29","61","4","8","33","69","2.3571428571429"
"3","2018","31","Otros","11","15","64","127","0","0","64","127","2.3571428571429"
"3","2018","31","Otros","11","36","81","159","50","92","131","251","5.1904761904762"
"3","2018","31","Hotel","11","36","50","78","14","20","64","98","2.375"
"3","2018","31","Hotel","6","12","95","235","0","0","95","235","5"
"3","2018","31","Otros","8","3","66","96","34","48","100","144","10"
"3","2018","31","Otros","10","27","12","20","13","21","25","41","4.84"
"3","2018","31","Otros","8","3","8","13","28","68","36","81","10"
"3","2018","31","Otros","6","25","10","10","0","0","10","10","2.3846153846154"
"3","2018","31","Hotel","2","27","73","110","0","0","73","110","1"
"3","2018","31","Hotel","10","18","20","47","42","126","62","173","3.2"
"3","2018","31","Otros","11","32","192","634","57","164","249","798","1"
"3","2018","31","Hotel","6","10","2131","2610","240","386","2371","2996","1"
"3","2018","31","Otros","11","32","73","145","5","5","78","150","2.2857142857143"
"3","2018","0","Otros","2","27","0","0","0","0","0","0","1"
"3","2018","31","","12","24","67","171","472","1213","539","1384","1"
"3","2018","31","Hotel","16","27","616","769","2","6","618","775","5.8571428571429"
"3","2018","31","Hotel","7","38","57","66","0","0","57","66","1"
"3","2018","31","Hotel","6","12","2301","2302","37","40","2338","2342","1"
"4","2018","30","Hotel","14","31","1583","2408","8815","10195","10398","12603","1"
"4","2018","30","Hotel","14","31","793","1208","2506","8886","3299","10094","1"
"4","2018","30","Hotel","14","31","743","957","798","3361","1541","4318","1"
"4","2018","30","Hotel","11","32","35","76","15","29","50","105","1"
"4","2018","30","Hotel","14","27","4069","5523","833","1130","4902","6653","1"
"4","2018","30","Otros","11","32","82","162","0","0","82","162","2.2857142857143"
"4","2018","30","Hotel","14","31","536","624","4053","5017","4589","5641","5.4"
"4","2018","30","Hotel","15","16","975","1770","109","162","1084","1932","1"
"4","2018","30","Hotel","14","31","780","1292","1124","3677","1904","4969","5.4"
"4","2018","30","Hotel","12","24","2750","3813","1589","2262","4339","6075","1"
"4","2018","30","Hotel","16","40","637","1675","216","709","853","2384","1"
"4","2018","30","Hotel","6","12","1855","2277","113","251","1968","2528","1"
"4","2018","30","Hotel","10","23","1288","2000","176","311","1464","2311","1"
"4","2018","30","Hotel","14","31","1873","4734","379","961","2252","5695","5.4"
"4","2018","30","Hotel","3","4","1281","3185","135","204","1416","3389","1"
"4","2018","30","","11","32","427","655","39","82","466","737","1"
"4","2018","30","Hotel","6","12","468","926","28","51","496","977","1"
"4","2018","30","Hotel","6","12","2615","3333","328","411","2943","3744","1"
"4","2018","30","Hotel","9","26","3437","6513","95","168","3532","6681","1"
"4","2018","30","Hotel","2","1","715","1526","50","294","765","1820","1"
"4","2018","30","Hotel","9","26","1329","2382","207","573","1536","2955","1"
"4","2018","30","Hotel","6","12","842","1424","79","165","921","1589","1"
"4","2018","30","Hotel","14","31","119","163","4557","8427","4676","8590","5.4"
"4","2018","30","Hotel","11","32","276","369","16","38","292","407","1"
"4","2018","30","Hotel","2","6","1086","1392","108","162","1194","1554","1"
"4","2018","30","Hotel","16","40","1721","3129","1101","1711","2822","4840","1"
"4","2018","30","Hotel","14","27","751","1845","1194","2211","1945","4056","1"
"4","2018","30","Otros","11","36","46","79","4","12","50","91","1"
"4","2018","30","Hotel","10","23","1352","1823","401","666","1753","2489","1"
"4","2018","30","Hotel","14","31","514","1467","684","2816","1198","4283","7.8"
"4","2018","30","Hotel","7","17","319","671","137","588","456","1259","1"
"4","2018","30","Hotel","2","1","1664","2914","0","0","1664","2914","2"
"4","2018","30","Hotel","2","1","1321","2050","231","442","1552","2492","2"
"4","2018","30","Hotel","4","13","993","1587","94","133","1087","1720","1"
"4","2018","30","Hotel","2","1","709","1577","102","257","811","1834","2"
"4","2018","30","Hotel","10","27","1200","3078","921","1673","2121","4751","1"
"4","2018","30","Hotel","14","27","773","773","2119","2119","2892","2892","1"
"4","2018","30","Hotel","14","27","1849","2796","1143","2244","2992","5040","1"
"4","2018","30","Hotel","6","12","2064","2246","59","107","2123","2353","1"
"4","2018","30","Hotel","6","12","1728","2382","663","747","2391","3129","1"
"4","2018","30","Hotel","13","27","1892","3942","2","4","1894","3946","1"
"4","2018","30","Hotel","14","31","76","161","1063","3108","1139","3269","7.8"
"4","2018","30","Hotel","6","12","1530","4672","317","963","1847","5635","1"
"4","2018","30","Hotel","16","27","2348","4131","97","183","2445","4314","1"
"4","2018","30","","10","27","12","24","10","11","22","35","1"
"4","2018","30","Hotel","10","18","606","1119","482","1165","1088","2284","1"
"4","2018","30","Hotel","9","37","1974","3366","284","450","2258","3816","1"
"4","2018","30","Hotel","16","27","1058","4237","0","0","1058","4237","1"
"4","2018","30","Hotel","15","16","820","1502","111","178","931","1680","2"
"4","2018","30","Hotel","2","1","1174","1968","240","402","1414","2370","2"
"4","2018","30","Hotel","3","4","613","1420","110","181","723","1601","1"
"4","2018","30","Hotel","16","40","1238","1839","1109","1709","2347","3548","1"
"4","2018","30","Hotel","7","17","1688","1943","1299","1454","2987","3397","1"
"4","2018","30","Hotel","12","24","1083","1494","785","1242","1868","2736","1"
"4","2018","30","Hotel","12","35","898","2022","764","1581","1662","3603","1"
"4","2018","30","Hotel","2","6","484","1641","11","34","495","1675","1"
"4","2018","30","Hotel","13","33","1254","1789","154","215","1408","2004","1"
"4","2018","30","Hotel","10","27","1231","1497","722","1052","1953","2549","1"
"4","2018","30","Hotel","10","23","1253","2235","254","455","1507","2690","1"
"4","2018","30","Hotel","11","36","1306","1944","141","240","1447","2184","1"
"4","2018","30","Hotel","8","34","1202","1940","133","145","1335","2085","1"
"4","2018","30","Hotel","2","6","532","1653","92","140","624","1793","1"
"4","2018","30","Hotel","14","31","727","1053","1401","1941","2128","2994","7.8"
"4","2018","30","Hotel","11","36","1886","2937","247","413","2133","3350","1"
"4","2018","30","","10","27","198","394","180","333","378","727","1"
"4","2018","30","Hotel","14","31","1500","2145","2264","7080","3764","9225","5.4"
"4","2018","30","Hotel","4","13","2100","2114","3","7","2103","2121","1"
"4","2018","30","Hotel","6","28","1416","1768","60","77","1476","1845","1"
"4","2018","30","Otros","14","31","176","224","206","453","382","677","2.8"
"4","2018","30","Otros","16","27","30","30","14","14","44","44","2"
"4","2018","30","Hotel","2","1","846","1659","54","85","900","1744","2"
"4","2018","30","Hotel","10","18","1241","2040","595","735","1836","2775","1"
"4","2018","30","Hotel","7","17","946","1376","240","776","1186","2152","1"
"4","2018","30","Hotel","12","24","496","1327","464","1473","960","2800","1"
"4","2018","30","Hotel","10","18","1007","1800","241","942","1248","2742","1"
"4","2018","30","Hotel","2","1","2316","2878","15","26","2331","2904","1"
"4","2018","30","Hotel","10","18","828","1356","785","1458","1613","2814","1"
"4","2018","30","Hotel","6","28","1309","1631","387","454","1696","2085","1"
"4","2018","30","Hotel","5","5","807","1423","232","344","1039","1767","1"
"4","2018","30","Hotel","4","13","345","643","18","47","363","690","1"
"4","2018","30","Hotel","10","18","744","2008","418","880","1162","2888","1"
"4","2018","30","Hotel","16","40","814","1314","77","97","891","1411","1"
"4","2018","30","Hotel","8","3","2303","4696","565","1169","2868","5865","1"
"4","2018","30","Hotel","15","16","677","967","253","322","930","1289","2"
"4","2018","30","Hotel","14","31","38","87","376","1405","414","1492","7.8"
"4","2018","30","Hotel","13","33","562","774","345","607","907","1381","1"
"4","2018","30","Hotel","15","16","391","1040","98","240","489","1280","2"
"4","2018","30","Otros","4","21","513","1091","4","14","517","1105","1"
"4","2018","30","Hotel","6","10","609","981","6","18","615","999","1"
"4","2018","30","Hotel","16","19","268","404","25","44","293","448","1"
"4","2018","30","Hotel","16","27","801","1729","9","18","810","1747","1"
"4","2018","30","Hotel","10","11","1234","2185","116","207","1350","2392","1"
"4","2018","30","Otros","10","23","382","868","13","30","395","898","1"
"4","2018","30","Hotel","12","35","201","650","152","287","353","937","1"
"4","2018","30","Hotel","11","36","575","1089","101","216","676","1305","1"
"4","2018","30","Hotel","14","31","29","57","381","1817","410","1874","17.4"
"4","2018","30","Hotel","10","18","458","1037","555","1382","1013","2419","3.2"
"4","2018","30","Hotel","4","13","207","327","53","114","260","441","1"
"4","2018","30","Hotel","6","12","589","892","48","98","637","990","5"
"4","2018","30","Hotel","6","10","551","836","106","179","657","1015","1"
"4","2018","30","Otros","5","5","167","405","65","121","232","526","3.65625"
"4","2018","30","Hotel","12","24","803","1081","998","1272","1801","2353","1"
"4","2018","30","Hotel","8","3","1116","1878","213","419","1329","2297","1"
"4","2018","30","Hotel","13","27","561","891","0","0","561","891","2.75"
"4","2018","30","Hotel","15","16","60","550","26","400","86","950","4"
"4","2018","30","Otros","15","16","245","1050","98","330","343","1380","2"
"4","2018","30","Otros","16","20","126","213","0","0","126","213","1"
"4","2018","30","Hotel","3","4","735","1385","250","250","985","1635","1"
"4","2018","30","Hotel","11","36","84","94","0","0","84","94","1"
"4","2018","30","Hotel","2","6","899","1144","16","112","915","1256","1"
"4","2018","30","Hotel","8","34","702","1346","141","269","843","1615","1"
"4","2018","30","Hotel","4","13","23","40","0","0","23","40","3.2"
"4","2018","30","Hotel","13","27","1024","2190","10","13","1034","2203","2.75"
"4","2018","30","Hotel","2","29","221","494","669","1838","890","2332","1"
"4","2018","30","Otros","11","36","123","266","1","9","124","275","1"
"4","2018","30","","10","11","5","5","2","2","7","7","1"
"4","2018","30","Hotel","4","13","846","1144","65","156","911","1300","1"
"4","2018","30","Hotel","16","40","2252","3382","587","881","2839","4263","5.6666666666667"
"4","2018","30","Hotel","10","23","918","1424","556","1138","1474","2562","2.8"
"4","2018","30","Hotel","8","34","193","262","46","93","239","355","1"
"4","2018","30","Hotel","5","5","400","1039","54","139","454","1178","1"
"4","2018","30","Hotel","3","4","78","169","73","133","151","302","3"
"4","2018","30","Hotel","9","26","121","368","5","23","126","391","1"
"4","2018","30","Hotel","8","34","691","997","190","367","881","1364","1"
"4","2018","30","Hotel","7","17","270","479","128","551","398","1030","4"
"4","2018","30","Hotel","4","13","305","629","20","35","325","664","3.2"
"4","2018","30","Hotel","12","35","36","172","331","1283","367","1455","1"
"4","2018","30","Hotel","16","40","1052","1954","1123","2330","2175","4284","1"
"4","2018","30","Hotel","9","26","415","754","59","264","474","1018","1"
"4","2018","30","","6","27","179","279","12","19","191","298","1"
"4","2018","30","Hotel","9","26","132","185","6","8","138","193","1"
"4","2018","30","Hotel","4","13","116","149","33","47","149","196","3.2"
"4","2018","30","Hotel","6","28","448","553","26","33","474","586","1"
"4","2018","30","","2","29","79","231","545","1547","624","1778","1"
"4","2018","30","Hotel","13","33","1251","1582","150","209","1401","1791","1"
"4","2018","30","Hotel","8","3","208","425","46","101","254","526","1"
"4","2018","30","Hotel","14","27","1648","2210","795","1279","2443","3489","1"
"4","2018","30","Hotel","16","40","359","750","4","13","363","763","5.6666666666667"
"4","2018","30","Hotel","12","24","258","601","247","431","505","1032","1"
"4","2018","30","Hotel","10","18","775","1167","182","315","957","1482","3.2"
"4","2018","30","Otros","15","16","134","134","15","15","149","149","9"
"4","2018","30","Hotel","6","10","604","714","0","0","604","714","1"
"4","2018","30","Hotel","10","11","617","1021","76","227","693","1248","1"
"4","2018","30","Otros","6","10","67","79","1","1","68","80","3.8518518518518"
"4","2018","30","Otros","10","23","138","414","0","0","138","414","1"
"4","2018","30","Hotel","10","23","336","513","411","990","747","1503","2.8"
"4","2018","30","Hotel","6","12","279","383","2","2","281","385","5"
"4","2018","30","Hotel","6","27","59","109","0","0","59","109","3"
"4","2018","30","Hotel","10","23","453","740","327","593","780","1333","2.8"
"4","2018","30","","4","39","127","213","0","0","127","213","1"
"4","2018","30","Hotel","8","34","399","652","350","547","749","1199","1"
"4","2018","30","Hotel","8","34","576","857","194","358","770","1215","1"
"4","2018","30","Otros","4","39","32","52","0","0","32","52","2.2222222222222"
"4","2018","30","Otros","13","14","270","540","0","0","270","540","1"
"4","2018","30","Hotel","10","23","106","178","37","55","143","233","2.8"
"4","2018","30","Otros","13","14","375","1225","0","0","375","1225","1"
"4","2018","30","Hotel","12","24","124","296","396","684","520","980","1"
"4","2018","30","","6","25","217","317","0","0","217","317","1"
"4","2018","30","Hotel","15","27","375","682","9","23","384","705","1"
"4","2018","30","Hotel","12","35","55","103","224","516","279","619","1"
"4","2018","30","Hotel","16","40","180","305","206","315","386","620","1"
"4","2018","30","Hotel","16","27","145","282","23","23","168","305","1"
"4","2018","30","Hotel","9","30","90","286","0","0","90","286","1"
"4","2018","30","Hotel","4","13","397","753","53","124","450","877","3.2"
"4","2018","30","Hotel","2","29","60","247","300","837","360","1084","1"
"4","2018","30","Hotel","16","20","152","416","66","139","218","555","1"
"4","2018","30","Hotel","5","5","701","1001","123","322","824","1323","1"
"4","2018","30","Hotel","13","33","606","960","70","131","676","1091","1"
"4","2018","30","Otros","16","19","97","129","2","12","99","141","1.3333333333333"
"4","2018","30","Hotel","12","24","149","353","236","532","385","885","1"
"4","2018","30","","8","2","611","1136","40","72","651","1208","1"
"4","2018","30","Hotel","12","35","19","147","110","985","129","1132","1"
"4","2018","30","Hotel","16","27","51","57","307","390","358","447","2.5"
"4","2018","30","Otros","16","27","373","574","26","54","399","628","2"
"4","2018","30","Hotel","8","34","353","531","131","256","484","787","1"
"4","2018","30","Otros","8","3","108","322","0","0","108","322","1"
"4","2018","30","Hotel","7","27","228","300","46","64","274","364","1"
"4","2018","30","Hotel","4","39","152","205","10","13","162","218","1"
"4","2018","30","Hotel","15","16","212","424","14","40","226","464","4"
"4","2018","30","Hotel","4","39","28","62","6","16","34","78","1"
"4","2018","30","Hotel","4","39","183","374","3","4","186","378","1"
"4","2018","30","Hotel","15","16","279","689","56","111","335","800","4"
"4","2018","30","Hotel","14","31","59","103","285","764","344","867","17.4"
"4","2018","30","Hotel","8","34","485","705","92","121","577","826","1"
"4","2018","30","Hotel","6","28","178","247","22","30","200","277","1"
"4","2018","30","Hotel","7","17","447","767","93","649","540","1416","4"
"4","2018","30","Otros","7","27","1","1","0","0","1","1","1"
"4","2018","30","Hotel","11","36","1339","1532","90","158","1429","1690","1"
"4","2018","30","Otros","4","21","371","757","70","115","441","872","1"
"4","2018","30","Otros","15","16","99","148","28","39","127","187","2"
"4","2018","30","Otros","7","17","236","459","0","0","236","459","3"
"4","2018","30","Hotel","7","38","33","44","2","4","35","48","1"
"4","2018","30","Hotel","16","27","591","658","30","45","621","703","2.5"
"4","2018","30","Hotel","2","6","30","66","1","1","31","67","2.2"
"4","2018","30","Hotel","11","36","289","531","102","223","391","754","1"
"4","2018","30","Hotel","6","28","15","28","0","0","15","28","1"
"4","2018","30","Hotel","6","12","136","253","0","0","136","253","5"
"4","2018","30","Otros","9","22","58","75","0","0","58","75","1"
"4","2018","30","","13","14","196","336","0","0","196","336","2"
"4","2018","30","Hotel","2","29","26","77","418","842","444","919","1"
"4","2018","30","Hotel","2","29","36","92","76","273","112","365","1"
"4","2018","30","Otros","4","13","320","337","8","8","328","345","1"
"4","2018","30","Hotel","15","16","68","173","29","73","97","246","4"
"4","2018","30","Hotel","2","1","106","189","5","7","111","196","6.4"
"4","2018","30","Otros","7","27","72","120","0","0","72","120","1"
"4","2018","30","Otros","13","33","25","38","0","0","25","38","5.125"
"4","2018","30","","4","21","68","133","7","13","75","146","1"
"4","2018","30","Hotel","6","10","375","375","1","1","376","376","1"
"4","2018","30","Hotel","11","36","245","494","4","12","249","506","1"
"4","2018","30","Otros","14","31","100","400","200","400","300","800","2.8"
"4","2018","30","Hotel","7","27","191","269","7","13","198","282","1"
"4","2018","30","Otros","6","10","61","200","0","0","61","200","3.8518518518518"
"4","2018","30","Hotel","4","39","14","23","2","2","16","25","2.6"
"4","2018","30","Otros","8","2","48","81","29","123","77","204","6.4285714285714"
"4","2018","30","Otros","11","36","22","38","6","18","28","56","5.1904761904762"
"4","2018","30","Hotel","13","33","506","506","29","29","535","535","1"
"4","2018","30","","3","4","83","131","60","75","143","206","1"
"4","2018","30","Hotel","7","17","242","688","51","450","293","1138","4"
"4","2018","30","Hotel","8","2","134","196","10","14","144","210","1"
"4","2018","30","Otros","15","16","199","267","44","80","243","347","2"
"4","2018","29","Hotel","10","11","324","376","3","3","327","379","1"
"4","2018","30","Hotel","16","19","234","302","0","0","234","302","1"
"4","2018","30","Hotel","10","23","124","176","57","71","181","247","4"
"4","2018","30","","7","38","231","342","67","81","298","423","1"
"4","2018","30","Hotel","7","27","279","492","23","87","302","579","1"
"4","2018","30","Hotel","11","36","441","1002","47","110","488","1112","1"
"4","2018","30","Hotel","16","40","192","293","10","18","202","311","16.333333333333"
"4","2018","30","Hotel","16","19","53","65","5","9","58","74","1"
"4","2018","30","Hotel","16","19","0","0","0","0","0","0","1"
"4","2018","0","Hotel","16","20","0","0","0","0","0","0","1"
"4","2018","30","Hotel","10","11","220","325","11","22","231","347","1"
"4","2018","30","Otros","7","27","61","138","2","2","63","140","4.8333333333333"
"4","2018","30","Otros","7","27","24","105","0","0","24","105","1"
"4","2018","30","Hotel","7","27","38","48","1","1","39","49","4.1666666666667"
"4","2018","30","Otros","13","14","38","78","0","0","38","78","1"
"4","2018","30","Otros","11","15","45","45","0","0","45","45","2.3571428571429"
"4","2018","30","Otros","10","27","22","105","16","85","38","190","4.84"
"4","2018","30","Otros","14","31","2542","2542","56","56","2598","2598","2.8"
"4","2018","30","Otros","11","36","10","16","3","6","13","22","5.1904761904762"
"4","2018","30","Hotel","16","19","40","56","0","0","40","56","1"
"4","2018","30","","14","27","156","212","28","48","184","260","2.6666666666667"
"4","2018","30","Hotel","16","40","46","46","4","4","50","50","5.6666666666667"
"4","2018","30","Hotel","10","27","14","28","0","0","14","28","2.25"
"4","2018","30","Otros","2","29","139","309","190","554","329","863","3.28"
"4","2018","30","Hotel","13","27","10","20","17","25","27","45","1"
"4","2018","30","Otros","9","22","17","17","0","0","17","17","1"
"4","2018","30","Hotel","2","27","81","112","31","31","112","143","1"
"4","2018","9","Hotel","8","34","61","102","64","86","125","188","1"
"4","2018","30","Hotel","7","27","438","651","4","10","442","661","1"
"4","2018","30","Hotel","15","16","152","308","25","44","177","352","4"
"4","2018","30","Hotel","16","20","43","57","0","0","43","57","1"
"4","2018","30","Otros","4","13","97","308","2","25","99","333","1"
"4","2018","30","Hotel","2","1","231","632","5","7","236","639","6.4"
"4","2018","30","Otros","11","32","15","63","0","0","15","63","2.2857142857143"
"4","2018","30","Hotel","2","29","40","142","343","1615","383","1757","1"
"4","2018","30","Hotel","16","27","173","184","71","89","244","273","2.5"
"4","2018","30","Hotel","10","18","25","50","0","0","25","50","3.2"
"4","2018","30","Otros","11","36","346","474","63","71","409","545","1"
"4","2018","30","Otros","13","14","36","66","0","0","36","66","1"
"4","2018","0","Hotel","7","27","0","0","0","0","0","0","1"
"4","2018","30","Otros","7","17","125","359","6","32","131","391","3"
"4","2018","30","Otros","14","31","742","1080","178","586","920","1666","2.8"
"4","2018","30","Hotel","2","29","384","1142","202","619","586","1761","1"
"4","2018","30","Hotel","8","3","139","857","41","66","180","923","1"
"4","2018","30","Hotel","8","34","272","390","100","165","372","555","2.5714285714286"
"4","2018","30","Hotel","8","34","231","315","133","310","364","625","2.5714285714286"
"4","2018","30","Hotel","12","35","121","158","109","167","230","325","1"
"4","2018","30","Hotel","11","32","156","216","9","21","165","237","1"
"4","2018","30","Hotel","13","33","138","244","12","12","150","256","2"
"4","2018","30","Hotel","10","23","170","230","90","129","260","359","2.8"
"4","2018","30","Hotel","12","35","64","185","7","12","71","197","1"
"4","2018","30","","16","40","261","414","69","108","330","522","3.0555555555556"
"4","2018","30","Otros","16","19","6","12","0","0","6","12","1.3333333333333"
"4","2018","30","Otros","16","20","61","244","0","0","61","244","1"
"4","2018","30","Hotel","6","12","127","231","3","6","130","237","5"
"4","2018","30","Hotel","16","19","144","172","0","0","144","172","4"
"4","2018","30","Hotel","12","24","176","313","147","228","323","541","1"
"4","2018","30","Hotel","12","24","136","245","75","116","211","361","3"
"4","2018","30","Hotel","8","3","58","406","0","0","58","406","1"
"4","2018","0","Hotel","5","9","0","0","0","0","0","0","1"
"4","2018","30","Hotel","16","27","222","309","11","15","233","324","2.5"
"4","2018","30","Otros","10","23","39","39","0","0","39","39","7"
"4","2018","30","Otros","13","14","55","75","0","0","55","75","7.3846153846154"
"4","2018","30","Otros","2","6","52","111","5","9","57","120","1"
"4","2018","30","Hotel","15","16","3","3","41","46","44","49","7.8"
"4","2018","30","Hotel","8","3","240","1349","0","0","240","1349","1"
"4","2018","30","Hotel","8","34","273","366","154","261","427","627","1"
"4","2018","30","Hotel","8","3","67","156","36","87","103","243","1"
"4","2018","30","","2","29","89","286","35","133","124","419","1"
"4","2018","30","Hotel","2","1","335","437","16","28","351","465","6.4"
"4","2018","30","Hotel","7","17","126","326","1","2","127","328","4"
"4","2018","30","Otros","7","17","192","474","0","0","192","474","3"
"4","2018","30","Hotel","16","40","72","116","44","69","116","185","5.6666666666667"
"4","2018","30","Hotel","12","24","221","481","173","229","394","710","1"
"4","2018","30","Hotel","14","31","148","429","239","849","387","1278","17.4"
"4","2018","0","Hotel","9","26","0","0","0","0","0","0","1"
"4","2018","30","Hotel","6","12","15","15","0","0","15","15","5"
"4","2018","30","Otros","5","9","11","21","4","8","15","29","4.0454545454545"
"4","2018","30","Otros","5","9","2","2","2","2","4","4","4.0454545454545"
"4","2018","30","Otros","15","27","41","59","0","0","41","59","1.4222222222222"
"4","2018","30","Hotel","8","34","31","32","19","19","50","51","2.5714285714286"
"4","2018","30","Hotel","10","18","280","585","143","271","423","856","7.75"
"4","2018","30","Hotel","15","16","297","628","33","70","330","698","7.8"
"4","2018","30","Hotel","2","29","89","252","322","1021","411","1273","1"
"4","2018","30","Hotel","4","39","125","269","5","10","130","279","2.6"
"4","2018","30","Otros","4","39","89","139","2","2","91","141","2.2222222222222"
"4","2018","30","Hotel","4","13","83","127","11","11","94","138","5.4"
"4","2018","30","Otros","10","23","39","39","1","1","40","40","7"
"4","2018","30","Otros","14","31","99","150","346","975","445","1125","20.2"
"4","2018","30","Hotel","3","4","44","72","0","0","44","72","2.6"
"4","2018","30","Hotel","10","23","96","288","38","105","134","393","4"
"4","2018","30","Otros","9","22","216","1030","0","0","216","1030","1"
"4","2018","30","Hotel","12","24","245","446","200","305","445","751","3"
"4","2018","30","Hotel","13","14","22","24","2","2","24","26","1"
"4","2018","30","Hotel","12","35","122","262","112","170","234","432","1.7272727272727"
"4","2018","30","Hotel","6","28","355","560","0","0","355","560","1"
"4","2018","30","","6","28","54","221","0","0","54","221","1"
"4","2018","30","Hotel","12","24","258","566","145","293","403","859","3"
"4","2018","30","Otros","5","9","0","0","6","6","6","6","4.0454545454545"
"4","2018","30","Hotel","16","20","52","115","2","4","54","119","1"
"4","2018","30","Hotel","4","21","127","238","18","30","145","268","3"
"4","2018","30","Otros","10","11","25","32","0","0","25","32","11.764705882353"
"4","2018","30","Otros","13","14","20","20","0","0","20","20","7.3846153846154"
"4","2018","30","Otros","16","27","31","33","0","0","31","33","13.818181818182"
"4","2018","16","Hotel","9","26","506","506","0","0","506","506","1"
"4","2018","30","Hotel","16","27","685","704","409","448","1094","1152","2.5"
"4","2018","30","Hotel","3","4","499","1489","101","160","600","1649","3"
"4","2018","30","Otros","16","27","22","50","0","0","22","50","2"
"4","2018","30","Otros","16","19","225","623","6","14","231","637","1.3333333333333"
"4","2018","30","Hotel","6","12","518","701","18","18","536","719","5"
"4","2018","30","Hotel","2","1","222","345","8","8","230","353","6.4"
"4","2018","30","Hotel","10","11","368","601","20","29","388","630","1"
"4","2018","30","Otros","10","23","76","176","0","0","76","176","1"
"4","2018","30","Otros","10","27","584","645","78","92","662","737","4.84"
"4","2018","30","Hotel","16","27","217","350","49","606","266","956","2.5"
"4","2018","30","Hotel","6","28","114","183","7","9","121","192","1"
"4","2018","30","Hotel","4","13","36","84","4","6","40","90","5.4"
"4","2018","30","Hotel","14","27","566","908","39","41","605","949","8.5"
"4","2018","30","Hotel","10","27","84","135","225","291","309","426","1"
"4","2018","30","Hotel","13","27","251","339","37","51","288","390","4.2"
"4","2018","30","Hotel","3","4","592","803","8","19","600","822","3"
"4","2018","30","Otros","4","13","57","61","0","0","57","61","3.4"
"4","2018","30","Otros","11","15","8","16","0","0","8","16","2.3571428571429"
"4","2018","30","Otros","6","10","142","316","0","0","142","316","3.8518518518518"
"4","2018","30","Otros","2","1","45","52","15","18","60","70","1"
"4","2018","30","","6","12","60","249","1","2","61","251","1"
"4","2018","30","Otros","10","23","138","802","19","94","157","896","1"
"4","2018","30","Hotel","16","19","90","108","0","0","90","108","4"
"4","2018","30","Hotel","10","11","40","240","0","0","40","240","5.6666666666667"
"4","2018","30","Hotel","10","23","38","45","6","6","44","51","4"
"4","2018","30","Otros","14","31","40","90","224","550","264","640","2.8"
"4","2018","30","Otros","13","27","1","1","0","0","1","1","12.2"
"4","2018","30","Hotel","2","1","270","721","0","0","270","721","6.4"
"4","2018","8","Hotel","16","19","46","46","0","0","46","46","4"
"4","2018","30","Otros","12","35","1","1","0","0","1","1","3.5"
"4","2018","30","Otros","15","16","51","237","41","78","92","315","2"
"4","2018","30","Otros","9","22","229","458","35","70","264","528","1"
"4","2018","30","Hotel","10","27","244","393","381","492","625","885","1"
"4","2018","30","Hotel","2","27","112","143","5","5","117","148","3.6"
"4","2018","30","Hotel","16","20","30","202","2","4","32","206","1"
"4","2018","30","Hotel","10","18","0","0","10","25","10","25","7.75"
"4","2018","30","Hotel","6","12","238","238","0","0","238","238","5"
"4","2018","30","Hotel","2","27","60","98","1","2","61","100","3.6"
"4","2018","30","Hotel","15","16","66","133","23","35","89","168","7.8"
"4","2018","30","Hotel","10","23","80","80","16","16","96","96","4"
"4","2018","30","Hotel","11","32","6","6","2","2","8","8","1"
"4","2018","30","Hotel","14","27","84","241","25","161","109","402","8.5"
"4","2018","30","Otros","10","11","17","17","2","2","19","19","11.764705882353"
"4","2018","30","Hotel","2","27","81","115","8","10","89","125","3.6"
"4","2018","30","Otros","13","14","116","222","2","4","118","226","7.3846153846154"
"4","2018","30","Hotel","2","1","105","161","20","32","125","193","6.4"
"4","2018","30","Otros","7","17","165","385","0","0","165","385","17.166666666667"
"4","2018","30","Otros","10","23","24","152","5","15","29","167","7"
"4","2018","30","Hotel","13","27","126","126","5","5","131","131","2.75"
"4","2018","30","Otros","10","18","12","24","12","20","24","44","10.25"
"4","2018","30","Otros","5","9","39","188","0","0","39","188","4.0454545454545"
"4","2018","30","Hotel","4","39","96","279","0","0","96","279","2.6"
"4","2018","30","Otros","16","27","40","116","0","0","40","116","13.818181818182"
"4","2018","30","Hotel","14","27","34","42","64","157","98","199","8.5"
"4","2018","30","Hotel","10","11","107","200","25","39","132","239","5.6666666666667"
"4","2018","30","Hotel","10","18","149","343","64","206","213","549","7.75"
"4","2018","30","Otros","14","31","170","235","137","256","307","491","20.2"
"4","2018","30","Otros","11","32","2","2","2","4","4","6","2.2857142857143"
"4","2018","30","Otros","5","5","26","41","20","40","46","81","3.65625"
"4","2018","30","Otros","6","25","10","26","0","0","10","26","2.3846153846154"
"4","2018","30","Hotel","3","4","45","179","5","31","50","210","2.6"
"4","2018","30","Otros","7","27","138","228","6","8","144","236","4.8333333333333"
"4","2018","30","Otros","2","29","44","116","58","137","102","253","3.28"
"4","2018","30","Hotel","2","29","86","195","193","657","279","852","1"
"4","2018","30","Otros","4","21","106","239","8","16","114","255","1"
"4","2018","30","Hotel","7","27","251","376","1","1","252","377","4.1666666666667"
"4","2018","30","Otros","5","5","14","35","0","0","14","35","3.65625"
"4","2018","30","Otros","11","36","26","48","34","47","60","95","5.1904761904762"
"4","2018","30","Hotel","7","27","316","316","0","0","316","316","4.1666666666667"
"4","2018","30","Hotel","16","20","15","15","0","0","15","15","1"
"4","2018","30","Hotel","12","24","160","187","61","120","221","307","3"
"4","2018","30","Hotel","9","26","147","260","2","3","149","263","1.5"
"4","2018","30","Hotel","7","17","221","910","0","0","221","910","10"
"4","2018","30","Hotel","9","37","284","370","29","70","313","440","3.4"
"4","2018","30","Hotel","5","5","264","539","57","85","321","624","2.1428571428571"
"4","2018","30","Otros","6","27","68","136","0","0","68","136","3.960088691796"
"4","2018","30","Hotel","9","37","101","185","12","16","113","201","3.4"
"4","2018","30","Otros","10","27","48","48","91","116","139","164","4.84"
"4","2018","30","Otros","8","3","126","198","19","27","145","225","10"
"4","2018","30","Otros","16","20","25","35","0","0","25","35","3.0769230769231"
"4","2018","30","Otros","9","22","14","24","0","0","14","24","7.6428571428571"
"4","2018","30","Otros","10","27","258","295","18","18","276","313","4.84"
"4","2018","30","Otros","10","23","4","42","1","7","5","49","7"
"4","2018","30","Otros","2","6","433","433","134","134","567","567","1"
"4","2018","30","Otros","4","39","19","29","0","0","19","29","2.2222222222222"
"4","2018","30","Hotel","2","27","116","309","26","46","142","355","1"
"4","2018","30","Hotel","14","31","31","92","127","934","158","1026","24"
"4","2018","30","Otros","2","29","119","298","165","436","284","734","3.28"
"4","2018","30","Otros","8","3","308","1540","0","0","308","1540","10"
"4","2018","30","","13","14","20","44","4","12","24","56","1"
"4","2018","30","Hotel","6","10","185","251","40","42","225","293","6.6"
"4","2018","30","Hotel","8","34","60","81","44","56","104","137","2.5714285714286"
"4","2018","30","Hotel","9","22","319","1564","0","0","319","1564","2.5555555555556"
"4","2018","30","Hotel","2","6","87","208","30","30","117","238","2.2"
"4","2018","30","Hotel","10","27","81","133","112","142","193","275","2.25"
"4","2018","30","Otros","14","27","191","191","0","0","191","191","11.833333333333"
"4","2018","30","Otros","6","12","294","473","12","24","306","497","1.8256578947368"
"4","2018","30","Hotel","6","27","131","193","3","6","134","199","3"
"4","2018","30","Hotel","5","5","4","4","5","17","9","21","2.1428571428571"
"4","2018","30","Hotel","5","5","83","122","0","0","83","122","2.1428571428571"
"4","2018","30","Hotel","13","27","181","181","2","2","183","183","4.2"
"4","2018","30","Hotel","2","27","124","183","2","4","126","187","3.6"
"4","2018","30","Hotel","8","3","51","51","26","26","77","77","4.1111111111111"
"4","2018","30","Otros","11","36","60","147","8","22","68","169","5.1904761904762"
"4","2018","30","Otros","9","30","128","191","0","0","128","191","2.3333333333333"
"4","2018","30","Otros","16","19","17","30","0","0","17","30","10.263157894737"
"4","2018","30","Hotel","14","31","100","163","277","746","377","909","17.4"
"4","2018","30","Hotel","2","1","292","324","14","18","306","342","6.4"
"4","2018","30","Hotel","16","40","844","1535","356","584","1200","2119","5.6666666666667"
"4","2018","30","Otros","7","17","224","418","14","30","238","448","17.166666666667"
"4","2018","30","Hotel","13","27","254","363","172","266","426","629","2.75"
"4","2018","30","Hotel","14","31","144","181","327","690","471","871","24"
"4","2018","30","Otros","3","4","32","71","5","11","37","82","12.2"
"4","2018","30","Otros","8","34","197","281","100","149","297","430","5.75"
"4","2018","30","Hotel","9","22","90","92","4","8","94","100","2.5555555555556"
"4","2018","30","Hotel","4","21","46","55","1","2","47","57","3"
"4","2018","30","Hotel","6","27","77","86","0","0","77","86","3"
"4","2018","30","Hotel","12","35","108","175","110","198","218","373","1.7272727272727"
"4","2018","30","Hotel","2","29","39","95","52","108","91","203","2"
"4","2018","30","Otros","10","11","49","65","3","5","52","70","11.764705882353"
"4","2018","30","Hotel","6","10","76","179","0","0","76","179","6.6"
"4","2018","30","Hotel","13","14","18","18","5","5","23","23","2"
"4","2018","12","Otros","16","27","94","143","4","4","98","147","13.818181818182"
"4","2018","30","Otros","6","27","13","14","0","0","13","14","3.960088691796"
"4","2018","30","Hotel","16","40","64","89","243","504","307","593","5.6666666666667"
"4","2018","30","Otros","6","10","107","232","0","0","107","232","3.8518518518518"
"4","2018","30","Otros","10","23","11","18","15","31","26","49","7"
"4","2018","30","Hotel","6","28","323","423","6","23","329","446","1"
"4","2018","30","Otros","7","38","295","677","93","176","388","853","2.75"
"4","2018","30","Hotel","6","12","162","248","2","40","164","288","5"
"4","2018","30","Hotel","13","27","228","383","11","15","239","398","4.2"
"4","2018","30","Otros","4","21","14","27","0","0","14","27","4.8333333333333"
"4","2018","30","Hotel","16","27","71","207","7","7","78","214","5.8571428571429"
"4","2018","30","Hotel","5","5","52","138","17","26","69","164","2.1428571428571"
"4","2018","30","Otros","12","24","70","133","63","94","133","227","9.2"
"4","2018","30","Otros","15","16","59","117","42","72","101","189","9"
"4","2018","30","Hotel","8","27","163","185","19","23","182","208","4.5"
"4","2018","30","Hotel","9","22","6","6","0","0","6","6","2.5555555555556"
"4","2018","30","Hotel","10","11","108","196","38","67","146","263","5.6666666666667"
"4","2018","30","Hotel","8","3","61","107","25","55","86","162","4.1111111111111"
"4","2018","30","Hotel","6","10","218","358","5","14","223","372","6.6"
"4","2018","30","Otros","9","26","40","439","12","31","52","470","3.8888888888889"
"4","2018","30","Hotel","4","39","66","188","25","108","91","296","2.6"
"4","2018","30","Otros","6","27","0","0","1","5","1","5","3.960088691796"
"4","2018","30","Otros","6","12","158","208","0","0","158","208","1.8256578947368"
"4","2018","30","Hotel","6","27","108","224","0","0","108","224","3"
"4","2018","30","Otros","5","9","74","123","0","0","74","123","4.0454545454545"
"4","2018","30","Hotel","2","27","110","110","11","11","121","121","3.6"
"4","2018","30","Hotel","2","29","21","95","118","452","139","547","1"
"4","2018","30","Hotel","4","13","163","376","3","6","166","382","5.4"
"4","2018","30","","11","15","3","7","5","5","8","12","1"
"4","2018","30","Hotel","6","10","288","336","7","9","295","345","6.6"
"4","2018","30","Otros","6","12","4","4","0","0","4","4","1.8256578947368"
"4","2018","30","Otros","10","18","27","46","13","39","40","85","10.25"
"4","2018","30","Otros","9","22","129","223","4","6","133","229","7.6428571428571"
"4","2018","30","","14","27","130","429","12","28","142","457","1"
"4","2018","30","Hotel","16","27","63","80","6","10","69","90","5.8571428571429"
"4","2018","30","Otros","2","29","10","20","24","40","34","60","3.28"
"4","2018","30","Otros","13","33","56","60","0","0","56","60","5.125"
"4","2018","30","Otros","13","33","23","31","12","15","35","46","5.125"
"4","2018","30","Otros","6","10","71","388","0","0","71","388","3.8518518518518"
"4","2018","30","Hotel","10","18","56","101","45","79","101","180","7.75"
"4","2018","30","Hotel","14","31","151","338","24","82","175","420","24"
"4","2018","30","Hotel","4","21","59","59","2","2","61","61","3"
"4","2018","30","Hotel","3","4","162","1060","0","0","162","1060","2.6"
"4","2018","30","Otros","8","27","66","66","0","0","66","66","1"
"4","2018","30","Otros","6","27","8","19","0","0","8","19","3.960088691796"
"4","2018","30","Hotel","6","25","141","226","2","2","143","228","1"
"4","2018","30","Otros","6","12","174","382","2","4","176","386","1.8256578947368"
"4","2018","30","Hotel","6","27","32","60","0","0","32","60","3"
"4","2018","30","Otros","6","27","224","448","0","0","224","448","3.960088691796"
"4","2018","30","Otros","6","10","56","137","0","0","56","137","3.8518518518518"
"4","2018","30","Otros","6","12","72","188","0","0","72","188","1.8256578947368"
"4","2018","30","Otros","5","5","9","26","7","13","16","39","3.65625"
"4","2018","30","Hotel","12","24","60","281","5","18","65","299","3"
"4","2018","30","Hotel","15","16","53","125","7","9","60","134","7.8"
"4","2018","30","Otros","4","13","47","118","0","0","47","118","3.4"
"4","2018","30","Hotel","2","29","104","245","77","245","181","490","1"
"4","2018","30","Hotel","4","21","18","48","0","0","18","48","3"
"4","2018","30","Hotel","10","27","151","237","200","253","351","490","2.25"
"4","2018","30","Hotel","8","3","162","259","58","79","220","338","4.1111111111111"
"4","2018","30","Hotel","12","27","39","57","37","54","76","111","1"
"4","2018","30","Otros","5","5","312","609","30","50","342","659","3.65625"
"4","2018","30","Otros","13","14","7","7","0","0","7","7","7.3846153846154"
"4","2018","30","Otros","10","11","175","522","0","0","175","522","11.764705882353"
"4","2018","30","Otros","16","40","96","117","35","141","131","258","28.142857142857"
"4","2018","30","Hotel","11","36","117","255","9","13","126","268","1"
"4","2018","30","Otros","8","34","67","84","23","43","90","127","5.75"
"4","2018","30","Hotel","7","17","84","142","3","3","87","145","10"
"4","2018","30","Otros","12","35","187","382","2","2","189","384","3.5"
"4","2018","30","Otros","5","9","46","88","10","12","56","100","4.0454545454545"
"4","2018","15","Hotel","9","22","21","32","2","10","23","42","2.5555555555556"
"4","2018","30","Otros","2","29","19","38","36","59","55","97","3.28"
"4","2018","30","Otros","2","29","105","105","80","80","185","185","3.28"
"4","2018","30","Hotel","10","27","22","73","13","80","35","153","2.25"
"4","2018","30","Hotel","16","19","60","205","19","33","79","238","4"
"4","2018","30","Hotel","16","40","152","373","0","0","152","373","16.333333333333"
"4","2018","30","Hotel","8","27","223","358","0","0","223","358","4.5"
"4","2018","30","Otros","13","14","13","19","0","0","13","19","7.3846153846154"
"4","2018","30","Hotel","7","27","19","23","0","0","19","23","4.1666666666667"
"4","2018","30","Otros","2","6","43","562","0","0","43","562","5"
"4","2018","30","Hotel","7","17","262","535","33","157","295","692","10"
"4","2018","30","Hotel","3","4","91","150","32","55","123","205","2.6"
"4","2018","30","Otros","6","12","8","120","0","0","8","120","1.8256578947368"
"4","2018","30","Otros","6","10","2","2","0","0","2","2","3.8518518518518"
"4","2018","30","Hotel","16","40","57","75","48","127","105","202","16.333333333333"
"4","2018","30","Otros","4","39","26","50","0","0","26","50","2.2222222222222"
"4","2018","30","Otros","13","14","4","4","0","0","4","4","7.3846153846154"
"4","2018","30","Otros","7","38","50","91","8","8","58","99","2.75"
"4","2018","30","Hotel","11","32","150","281","5","9","155","290","1"
"4","2018","30","Otros","11","36","139","275","7","12","146","287","5.1904761904762"
"4","2018","30","Hotel","4","21","26","34","3","3","29","37","3"
"4","2018","30","Otros","3","4","6","13","0","0","6","13","12.2"
"4","2018","30","Otros","5","9","44","66","44","54","88","120","4.0454545454545"
"4","2018","30","Hotel","8","27","78","209","1","30","79","239","4.5"
"4","2018","30","","7","17","147","341","0","0","147","341","1"
"4","2018","30","Otros","16","20","32","92","6","6","38","98","3.0769230769231"
"4","2018","30","Otros","4","21","27","54","9","18","36","72","4.8333333333333"
"4","2018","30","Otros","13","33","73","90","11","11","84","101","5.125"
"4","2018","30","","12","35","0","0","282","1458","282","1458","1"
"4","2018","30","Hotel","13","33","11","11","4","4","15","15","2"
"4","2018","30","Otros","4","39","28","34","0","0","28","34","2.2222222222222"
"4","2018","30","Otros","10","18","19","30","0","0","19","30","10.25"
"4","2018","30","Otros","6","27","60","79","2","2","62","81","3.960088691796"
"4","2018","30","Hotel","4","39","62","246","0","0","62","246","2.6"
"4","2018","30","Otros","14","31","68","86","44","149","112","235","20.2"
"4","2018","30","Hotel","2","29","45","135","177","531","222","666","2"
"4","2018","30","Hotel","9","26","146","193","14","39","160","232","1.5"
"4","2018","30","Otros","12","35","4","4","3","3","7","7","3.5"
"4","2018","30","Hotel","14","27","128","152","41","51","169","203","8.5"
"4","2018","30","Otros","11","36","46","118","11","20","57","138","5.1904761904762"
"4","2018","30","Otros","16","20","178","452","9","11","187","463","3.0769230769231"
"4","2018","30","Otros","4","39","1","7","0","0","1","7","2.2222222222222"
"4","2018","30","Otros","7","27","100","131","1","1","101","132","4.8333333333333"
"4","2018","30","Otros","6","27","133","213","2","16","135","229","3.960088691796"
"4","2018","30","Otros","5","8","15","450","0","0","15","450","5"
"4","2018","30","Otros","9","37","103","170","3","3","106","173","4.5"
"4","2018","30","Hotel","2","6","50","172","0","0","50","172","5.5"
"4","2018","30","Hotel","10","27","98","128","73","85","171","213","2.25"
"4","2018","30","Hotel","9","30","104","222","11","15","115","237","1"
"4","2018","30","Otros","4","13","25","74","4","5","29","79","3.4"
"4","2018","30","Hotel","5","5","258","258","18","18","276","276","1"
"4","2018","30","Otros","7","38","184","380","6","12","190","392","2.75"
"4","2018","30","Hotel","13","14","7","14","3","3","10","17","1"
"4","2018","30","Otros","5","9","15","23","10","12","25","35","4.0454545454545"
"4","2018","30","Otros","5","8","10","10","0","0","10","10","5"
"4","2018","30","Otros","10","27","20","420","0","0","20","420","4.84"
"4","2018","30","Hotel","13","14","4","10","0","0","4","10","1"
"4","2018","30","Otros","11","15","1","30","0","0","1","30","2.3571428571429"
"4","2018","30","Hotel","9","22","98","153","0","0","98","153","2.5555555555556"
"4","2018","30","Otros","11","36","83","113","9","16","92","129","5.1904761904762"
"4","2018","30","Hotel","10","18","1956","3660","1377","2877","3333","6537","1"
"4","2018","30","Hotel","6","12","298","384","0","0","298","384","5"
"4","2018","30","","2","29","410","1018","486","1355","896","2373","1"
"4","2018","30","Hotel","16","27","2370","3236","47","96","2417","3332","1"
"4","2018","30","","14","31","320","709","328","1470","648","2179","1"
"4","2018","30","Hotel","8","3","19","65","17","35","36","100","4.1111111111111"
"4","2018","30","Otros","13","33","9","16","12","27","21","43","5.125"
"4","2018","30","","14","27","55","78","0","0","55","78","2.6666666666667"
"4","2018","30","Otros","9","22","83","455","0","0","83","455","7.6428571428571"
"4","2018","30","Hotel","10","11","17","26","0","0","17","26","5.6666666666667"
"4","2018","30","Otros","6","12","17","35","0","0","17","35","1.8256578947368"
"4","2018","30","Hotel","8","3","74","123","20","23","94","146","4.1111111111111"
"4","2018","30","Otros","6","12","132","209","0","0","132","209","1.8256578947368"
"4","2018","30","Hotel","8","27","228","228","0","0","228","228","4.5"
"4","2018","30","Hotel","6","28","177","196","12","14","189","210","2.4"
"4","2018","30","Otros","6","25","25","87","0","0","25","87","2.3846153846154"
"4","2018","30","Otros","6","25","89","103","0","0","89","103","2.3846153846154"
"4","2018","30","Hotel","11","36","573","847","0","0","573","847","1"
"4","2018","30","Otros","2","6","27","114","170","493","197","607","5"
"4","2018","30","Hotel","14","31","61","84","61","197","122","281","24"
"4","2018","15","Otros","4","21","9","17","0","0","9","17","4.8333333333333"
"4","2018","30","Otros","7","38","28","56","1","2","29","58","2.75"
"4","2018","30","Otros","13","14","74","86","4","4","78","90","7.3846153846154"
"4","2018","30","Otros","2","29","26","30","51","58","77","88","3.28"
"4","2018","30","Otros","3","4","92","92","7","7","99","99","12.2"
"4","2018","30","Hotel","3","4","303","602","19","33","322","635","3"
"4","2018","30","Otros","7","27","125","157","13","13","138","170","1"
"4","2018","30","Otros","7","17","132","165","0","0","132","165","3"
"4","2018","30","Hotel","12","27","231","394","39","43","270","437","1"
"4","2018","30","Otros","5","5","29","51","19","32","48","83","3.65625"
"4","2018","30","Hotel","6","10","111","197","0","0","111","197","6.6"
"4","2018","30","Otros","10","18","2","2","2","2","4","4","10.25"
"4","2018","30","Otros","8","27","42","71","0","0","42","71","9.4"
"4","2018","30","Otros","8","3","26","27","0","0","26","27","10"
"4","2018","30","Hotel","16","27","74","93","0","0","74","93","5.8571428571429"
"4","2018","30","Otros","6","10","23","63","0","0","23","63","3.8518518518518"
"4","2018","30","Hotel","2","6","21","29","7","8","28","37","5.5"
"4","2018","30","Hotel","8","3","14","28","2","4","16","32","4.1111111111111"
"4","2018","30","Otros","10","11","14","23","15","22","29","45","11.764705882353"
"4","2018","30","Otros","6","27","30","109","0","0","30","109","3.960088691796"
"4","2018","30","Otros","15","16","1","1","0","0","1","1","9"
"4","2018","30","Otros","5","5","10","10","18","18","28","28","3.65625"
"4","2018","30","Otros","10","27","36","125","21","21","57","146","4.84"
"4","2018","30","Hotel","7","38","69","88","12","12","81","100","1"
"4","2018","30","Hotel","13","27","8","56","0","0","8","56","4.2"
"4","2018","30","Hotel","16","20","50","78","0","0","50","78","1"
"4","2018","30","Otros","10","27","49","69","89","115","138","184","4.84"
"4","2018","30","Hotel","3","7","36","43","11","20","47","63","1"
"4","2018","30","Otros","2","29","60","118","32","49","92","167","3.28"
"4","2018","30","Otros","10","18","12","12","0","0","12","12","10.25"
"4","2018","30","Otros","9","22","158","414","0","0","158","414","7.6428571428571"
"4","2018","30","Otros","15","27","24","33","0","0","24","33","1.4222222222222"
"4","2018","30","Otros","11","36","3","6","0","0","3","6","5.1904761904762"
"4","2018","30","Otros","5","5","9","14","0","0","9","14","3.65625"
"4","2018","30","Otros","2","29","13","39","16","46","29","85","3.28"
"4","2018","30","Hotel","9","22","147","147","7","7","154","154","2.5555555555556"
"4","2018","30","Otros","11","32","9","14","0","0","9","14","2.2857142857143"
"4","2018","30","Hotel","10","27","227","409","134","184","361","593","1"
"4","2018","30","Otros","16","27","103","149","0","0","103","149","2"
"4","2018","30","Hotel","16","20","41","66","0","0","41","66","1"
"4","2018","30","Otros","11","15","26","59","0","0","26","59","2.3571428571429"
"4","2018","30","Otros","7","17","147","649","0","0","147","649","3"
"4","2018","30","Otros","5","8","7","7","3","3","10","10","5"
"4","2018","30","Hotel","13","33","61","103","3","6","64","109","2"
"4","2018","30","Otros","5","9","95","169","20","57","115","226","4.0454545454545"
"4","2018","30","Otros","10","27","100","150","27","29","127","179","4.84"
"4","2018","30","Otros","9","22","20","32","0","0","20","32","7.6428571428571"
"4","2018","30","Otros","16","40","78","150","0","0","78","150","28.142857142857"
"4","2018","30","Hotel","16","40","69","69","14","14","83","83","1"
"4","2018","30","Otros","15","16","9","29","2","4","11","33","9"
"4","2018","30","Hotel","8","2","13","13","8","8","21","21","3"
"4","2018","30","Otros","8","3","11","20","0","0","11","20","10"
"4","2018","30","Otros","7","17","46","62","0","0","46","62","17.166666666667"
"4","2018","30","Otros","16","20","46","84","0","0","46","84","3.0769230769231"
"4","2018","30","Otros","6","27","15","20","0","0","15","20","3.960088691796"
"4","2018","30","Otros","12","35","39","66","77","99","116","165","3.5"
"4","2018","30","Otros","6","28","127","318","15","25","142","343","4.65"
"4","2018","30","Otros","6","28","273","766","14","28","287","794","4.65"
"4","2018","30","Hotel","8","34","90","139","66","99","156","238","2.5714285714286"
"4","2018","30","Hotel","16","20","1818","2310","15","30","1833","2340","1"
"4","2018","30","Hotel","2","6","101","269","0","0","101","269","2.2"
"4","2018","30","Hotel","7","27","50","750","0","0","50","750","4.1666666666667"
"4","2018","30","Hotel","10","23","30","33","5","8","35","41","4"
"4","2018","30","Hotel","9","26","57","66","0","0","57","66","1.5"
"4","2018","30","Otros","8","27","45","59","0","0","45","59","9.4"
"4","2018","30","Otros","10","27","9","10","5","5","14","15","4.84"
"4","2018","30","Otros","11","15","14","20","0","0","14","20","2.3571428571429"
"4","2018","30","Otros","16","20","14","14","0","0","14","14","3.0769230769231"
"4","2018","30","Otros","11","32","55","73","0","0","55","73","1"
"4","2018","30","Otros","16","27","53","55","0","0","53","55","13.818181818182"
"4","2018","30","Otros","9","37","115","115","0","0","115","115","4.5"
"4","2018","30","Hotel","2","29","7","7","20","100","27","107","2"
"4","2018","30","Hotel","2","1","123","461","11","107","134","568","6.4"
"4","2018","30","Otros","5","8","6","9","1","1","7","10","5"
"4","2018","30","Otros","9","37","54","98","22","56","76","154","4.5"
"4","2018","30","Otros","7","38","120","241","0","0","120","241","2.75"
"4","2018","30","Otros","11","32","29","55","0","0","29","55","1"
"4","2018","30","Otros","4","39","71","136","0","0","71","136","2.2222222222222"
"4","2018","30","Hotel","11","36","31","65","16","32","47","97","2.375"
"4","2018","30","Otros","10","23","23","42","12","33","35","75","7"
"4","2018","30","Hotel","15","16","557","1185","100","315","657","1500","2"
"4","2018","30","Otros","2","29","32","41","148","342","180","383","3.28"
"4","2018","30","Hotel","6","12","1188","1542","36","43","1224","1585","1"
"4","2018","30","Hotel","11","15","155","222","0","0","155","222","1"
"4","2018","30","Otros","4","21","176","297","17","31","193","328","1"
"4","2018","30","Otros","16","19","36","92","0","0","36","92","10.263157894737"
"4","2018","30","","9","37","276","336","3","3","279","339","1"
"4","2018","30","Otros","10","27","19","78","25","110","44","188","4.84"
"4","2018","30","Otros","11","15","47","51","3","3","50","54","2.3571428571429"
"4","2018","30","Hotel","2","29","48","145","46","184","94","329","2"
"4","2018","30","Hotel","10","27","131","200","48","123","179","323","1"
"4","2018","30","Hotel","11","36","109","517","13","19","122","536","2.375"
"4","2018","30","Hotel","9","37","112","152","24","38","136","190","3.4"
"4","2018","30","Otros","14","27","16","32","2","4","18","36","11.833333333333"
"4","2018","30","Otros","7","38","65","161","0","0","65","161","1"
"4","2018","30","Hotel","2","1","15","225","0","0","15","225","6.4"
"4","2018","30","Otros","2","29","11","35","25","119","36","154","3.28"
"4","2018","30","Hotel","6","27","3","5","1","1","4","6","3"
"4","2018","30","Otros","5","9","5","150","0","0","5","150","4.0454545454545"
"4","2018","30","Hotel","2","1","17","23","0","0","17","23","6.4"
"4","2018","30","Hotel","3","7","13","14","48","67","61","81","1"
"4","2018","30","Otros","7","38","89","111","135","177","224","288","2.75"
"4","2018","30","Otros","7","17","15","48","0","0","15","48","17.166666666667"
"4","2018","30","Otros","7","38","1","1","0","0","1","1","2.75"
"4","2018","30","Otros","4","21","8","8","0","0","8","8","4.8333333333333"
"4","2018","30","Otros","2","1","76","76","8","8","84","84","5.5"
"4","2018","30","Otros","12","35","93","122","11","40","104","162","3.5"
"4","2018","30","Otros","12","35","4","4","15","19","19","23","3.5"
"4","2018","30","Otros","4","21","21","28","3","5","24","33","4.8333333333333"
"4","2018","30","Otros","12","24","22","86","20","80","42","166","9.2"
"4","2018","30","Otros","16","19","1","1","0","0","1","1","10.263157894737"
"4","2018","30","Otros","10","11","74","106","0","0","74","106","11.764705882353"
"4","2018","30","Otros","16","19","33","51","0","0","33","51","10.263157894737"
"4","2018","30","Hotel","2","27","138","365","12","56","150","421","1"
"4","2018","30","Otros","6","28","2","2","0","0","2","2","4.65"
"4","2018","30","Otros","10","18","153","431","65","171","218","602","10.25"
"4","2018","30","Otros","14","27","50","156","1","2","51","158","11.833333333333"
"4","2018","30","Hotel","11","32","20","48","4","8","24","56","1"
"4","2018","30","Otros","8","27","31","117","0","0","31","117","9.4"
"4","2018","30","Hotel","12","35","58","101","35","64","93","165","1.7272727272727"
"4","2018","30","Otros","13","14","61","106","0","0","61","106","7.3846153846154"
"4","2018","30","Otros","11","36","11","19","0","0","11","19","5.1904761904762"
"4","2018","30","Otros","16","20","46","56","6","6","52","62","3.0769230769231"
"4","2018","30","Hotel","14","31","143","200","887","1285","1030","1485","7.8"
"4","2018","30","Otros","2","27","99","170","10","12","109","182","3.2"
"4","2018","30","","16","40","298","744","0","0","298","744","3.0555555555556"
"4","2018","30","Hotel","11","36","65","117","13","21","78","138","2.375"
"4","2018","30","Hotel","9","22","16","29","2","4","18","33","2.5555555555556"
"4","2018","30","Otros","2","29","19","38","17","33","36","71","3.28"
"4","2018","30","Hotel","10","27","11","16","19","25","30","41","2.25"
"4","2018","30","Otros","10","27","5","22","0","0","5","22","4.84"
"4","2018","30","Hotel","16","19","23","38","0","0","23","38","4"
"4","2018","21","Otros","2","6","3","3","0","0","3","3","5"
"4","2018","30","Otros","7","27","129","173","0","0","129","173","4.8333333333333"
"4","2018","30","Hotel","2","6","79","790","0","0","79","790","5.5"
"4","2018","30","Hotel","6","28","2","2","5","5","7","7","2.4"
"4","2018","30","Otros","6","10","66","276","0","0","66","276","3.8518518518518"
"4","2018","30","Hotel","6","27","27","33","0","0","27","33","3"
"4","2018","30","Otros","5","5","26","37","1","1","27","38","3.65625"
"4","2018","30","Otros","12","24","32","75","37","55","69","130","9.2"
"4","2018","30","Hotel","8","2","62","85","9","18","71","103","3"
"4","2018","30","Hotel","11","32","13","53","6","11","19","64","1"
"4","2018","30","Otros","10","18","0","0","20","42","20","42","10.25"
"4","2018","30","Hotel","9","37","52","67","15","27","67","94","3.4"
"4","2018","30","Otros","5","9","89","164","47","95","136","259","4.0454545454545"
"4","2018","30","Otros","12","24","17","32","8","9","25","41","9.2"
"4","2018","30","Otros","9","22","8","14","0","0","8","14","7.6428571428571"
"4","2018","30","Otros","2","29","9","16","15","34","24","50","3.28"
"4","2018","30","Otros","10","23","5","150","0","0","5","150","7"
"4","2018","30","Otros","10","27","9","38","8","23","17","61","4.84"
"4","2018","30","Otros","10","11","44","144","0","0","44","144","11.764705882353"
"4","2018","30","Otros","8","3","31","64","0","0","31","64","10"
"4","2018","30","Otros","14","31","135","227","402","597","537","824","20.2"
"4","2018","30","Otros","2","29","240","664","136","352","376","1016","3.28"
"4","2018","0","Otros","6","25","0","0","0","0","0","0","1"
"4","2018","30","Hotel","15","16","12","24","0","0","12","24","7.8"
"4","2018","30","Hotel","15","27","74","98","0","0","74","98","1"
"4","2018","30","Otros","10","27","6","10","10","18","16","28","4.84"
"4","2018","30","Otros","10","23","45","45","0","0","45","45","7"
"4","2018","30","Otros","6","27","10","72","0","0","10","72","3.960088691796"
"4","2018","30","Otros","16","40","109","173","0","0","109","173","28.142857142857"
"4","2018","30","Otros","11","36","101","121","0","0","101","121","5.1904761904762"
"4","2018","30","Otros","8","34","39","53","9","13","48","66","5.75"
"4","2018","30","Otros","6","12","26","116","0","0","26","116","1.8256578947368"
"4","2018","30","Otros","6","10","97","120","0","0","97","120","3.8518518518518"
"4","2018","30","Hotel","4","21","116","218","14","14","130","232","3"
"4","2018","30","Hotel","11","36","98","164","20","29","118","193","2.375"
"4","2018","30","Otros","5","8","80","101","48","58","128","159","5"
"4","2018","30","Hotel","7","17","59","84","0","0","59","84","10"
"4","2018","24","Hotel","11","36","312","420","12","14","324","434","1"
"4","2018","30","Otros","9","30","32","42","0","0","32","42","2.3333333333333"
"4","2018","30","Hotel","12","35","53","97","56","116","109","213","1.7272727272727"
"4","2018","30","Otros","2","1","51","281","22","65","73","346","5.5"
"4","2018","30","Hotel","6","25","185","187","3","3","188","190","1"
"4","2018","30","Otros","5","5","4","120","0","0","4","120","3.65625"
"4","2018","30","Otros","2","29","41","91","82","179","123","270","3.28"
"4","2018","30","Hotel","2","6","20","29","17","26","37","55","5.5"
"4","2018","30","Otros","7","17","17","50","2","4","19","54","17.166666666667"
"4","2018","30","Hotel","8","2","7","7","10","10","17","17","3"
"4","2018","30","Hotel","13","14","17","17","0","0","17","17","1"
"4","2018","30","Otros","7","38","57","90","0","0","57","90","2.75"
"4","2018","30","Hotel","14","31","16","34","118","323","134","357","24"
"4","2018","30","Hotel","5","5","10","22","33","49","43","71","2.1428571428571"
"4","2018","30","Otros","2","27","9","14","4","4","13","18","3.2"
"4","2018","30","Otros","5","8","25","47","10","13","35","60","5"
"4","2018","30","Otros","3","4","94","221","0","0","94","221","12.2"
"4","2018","30","Otros","13","14","2","2","0","0","2","2","7.3846153846154"
"4","2018","30","Otros","9","37","54","84","0","0","54","84","4.5"
"4","2018","30","Hotel","10","23","413","515","54","82","467","597","1"
"4","2018","3","Otros","11","32","1","1","2","2","3","3","2.2857142857143"
"4","2018","30","Otros","11","15","2","4","0","0","2","4","2.3571428571429"
"4","2018","30","Otros","8","3","60","182","11","47","71","229","10"
"4","2018","30","Otros","16","20","10","18","0","0","10","18","3.0769230769231"
"4","2018","30","Otros","8","3","21","43","0","0","21","43","10"
"4","2018","30","Otros","16","27","28","36","0","0","28","36","2"
"4","2018","30","Hotel","16","19","37","47","0","0","37","47","4"
"4","2018","30","Hotel","16","27","37","136","0","0","37","136","5.8571428571429"
"4","2018","30","Otros","9","26","29","32","0","0","29","32","3.8888888888889"
"4","2018","30","Otros","5","5","10","10","0","0","10","10","3.65625"
"4","2018","30","Otros","14","27","12","74","0","0","12","74","11.833333333333"
"4","2018","30","Hotel","5","5","12","12","8","57","20","69","2.1428571428571"
"4","2018","30","Hotel","12","24","94","249","145","268","239","517","3"
"4","2018","13","Otros","16","27","12","40","0","0","12","40","13.818181818182"
"4","2018","30","Otros","8","3","5","5","4","8","9","13","1"
"4","2018","30","Otros","13","27","147","282","0","0","147","282","12.2"
"4","2018","30","Hotel","16","40","24","34","18","50","42","84","16.333333333333"
"4","2018","30","Otros","11","36","31","185","0","0","31","185","1"
"4","2018","30","Otros","10","27","12","27","0","0","12","27","4.84"
"4","2018","30","Otros","9","22","30","73","0","0","30","73","7.6428571428571"
"4","2018","30","Hotel","5","5","13","36","4","20","17","56","2.1428571428571"
"4","2018","30","Otros","2","29","31","81","72","212","103","293","3.28"
"4","2018","22","Otros","2","29","0","0","2","3","2","3","3.28"
"4","2018","30","Hotel","13","14","4","4","0","0","4","4","1"
"4","2018","30","Otros","6","25","4","6","0","0","4","6","2.3846153846154"
"4","2018","30","Otros","2","1","4","10","1","1","5","11","5.5"
"4","2018","30","Hotel","12","27","45","70","12","12","57","82","1"
"4","2018","30","Hotel","13","27","16","20","0","0","16","20","4.2"
"4","2018","30","Otros","6","12","121","224","1","3","122","227","1.8256578947368"
"4","2018","30","Otros","6","27","7","10","0","0","7","10","3.960088691796"
"4","2018","30","Otros","6","25","8","8","0","0","8","8","2.3846153846154"
"4","2018","30","Hotel","6","28","9","41","0","0","9","41","2.5833333333333"
"4","2018","30","Otros","5","5","3","3","0","0","3","3","3.65625"
"4","2018","30","Otros","5","9","10","14","0","0","10","14","4.0454545454545"
"4","2018","30","Otros","5","8","5","75","0","0","5","75","5"
"4","2018","30","Hotel","2","29","123","487","105","470","228","957","1"
"4","2018","30","Otros","5","5","119","170","46","78","165","248","3.65625"
"4","2018","30","Hotel","9","26","28","32","0","0","28","32","1.5"
"4","2018","30","Otros","9","30","3","3","0","0","3","3","2.3333333333333"
"4","2018","30","Otros","11","15","6","9","1","1","7","10","2.3571428571429"
"4","2018","30","Hotel","16","27","2","2","0","0","2","2","5.8571428571429"
"4","2018","30","Otros","9","30","18","29","0","0","18","29","2.3333333333333"
"4","2018","30","Otros","2","29","9","22","7","15","16","37","3.28"
"4","2018","30","Otros","7","38","47","77","22","33","69","110","2.75"
"4","2018","30","Otros","4","21","18","44","9","26","27","70","4.8333333333333"
"4","2018","30","Otros","9","22","10","20","0","0","10","20","7.6428571428571"
"4","2018","30","Otros","9","22","21","31","0","0","21","31","7.6428571428571"
"4","2018","2","Otros","13","27","7","14","0","0","7","14","12.2"
"4","2018","30","Hotel","11","36","1645","1687","37","117","1682","1804","1"
"4","2018","30","Otros","13","33","6","6","0","0","6","6","5.125"
"4","2018","30","Otros","11","36","77","178","45","107","122","285","5.1904761904762"
"4","2018","30","Otros","12","35","29","72","90","171","119","243","3.5"
"4","2018","30","Otros","12","35","8","17","4","4","12","21","3.5"
"4","2018","30","Otros","10","11","37","120","0","0","37","120","11.764705882353"
"4","2018","30","Otros","12","24","12","56","15","30","27","86","9.2"
"4","2018","30","Otros","16","20","19","38","0","0","19","38","3.0769230769231"
"4","2018","30","Hotel","7","27","12","12","0","0","12","12","1"
"4","2018","30","Otros","6","12","9","32","0","0","9","32","1.8256578947368"
"4","2018","30","Otros","11","32","41","120","10","28","51","148","2.2857142857143"
"4","2018","30","Otros","6","28","98","109","4","4","102","113","4.65"
"4","2018","30","Otros","8","34","1","1","0","0","1","1","5.75"
"4","2018","30","Otros","16","27","97","119","0","0","97","119","13.818181818182"
"4","2018","30","Otros","10","11","16","16","0","0","16","16","11.764705882353"
"4","2018","30","Otros","6","10","18","46","0","0","18","46","3.8518518518518"
"4","2018","30","Otros","8","3","4","12","0","0","4","12","10"
"4","2018","30","Hotel","16","20","76","152","54","88","130","240","1"
"4","2018","30","Hotel","11","32","90","126","22","30","112","156","1"
"4","2018","30","Otros","8","27","17","181","0","0","17","181","9.4"
"4","2018","30","Otros","12","27","34","84","6","10","40","94","3.4285714285714"
"4","2018","30","Otros","6","10","34","56","0","0","34","56","3.8518518518518"
"4","2018","30","Otros","6","10","53","53","0","0","53","53","3.8518518518518"
"4","2018","30","Otros","5","8","16","24","2","3","18","27","5"
"4","2018","30","Otros","5","8","2","4","6","6","8","10","5"
"4","2018","30","Hotel","9","26","33","47","8","29","41","76","1.5"
"4","2018","30","Hotel","13","14","12","20","0","0","12","20","1"
"4","2018","30","Otros","10","18","43","107","23","74","66","181","10.25"
"4","2018","30","Otros","8","2","37","39","17","18","54","57","6.4285714285714"
"4","2018","30","Otros","7","27","10","14","0","0","10","14","4.8333333333333"
"4","2018","30","Otros","2","29","16","38","11","35","27","73","3.28"
"4","2018","30","Otros","11","32","12","20","2","2","14","22","2.2857142857143"
"4","2018","30","Otros","9","30","6","12","0","0","6","12","2.3333333333333"
"4","2018","30","Otros","2","29","4","12","2","4","6","16","3.28"
"4","2018","30","Otros","5","5","10","47","1","1","11","48","3.65625"
"4","2018","30","Otros","11","15","6","6","0","0","6","6","2.3571428571429"
"4","2018","30","Otros","10","23","8","8","0","0","8","8","7"
"4","2018","30","Otros","11","36","58","88","11","16","69","104","5.1904761904762"
"4","2018","30","Hotel","3","7","28","34","48","102","76","136","1"
"4","2018","30","Otros","10","27","3","3","4","4","7","7","4.84"
"4","2018","30","Otros","2","27","7","7","0","0","7","7","3.2"
"4","2018","30","Otros","12","35","23","31","46","86","69","117","3.5"
"4","2018","30","Otros","10","27","0","0","4","8","4","8","4.84"
"4","2018","30","Otros","16","40","18","39","135","289","153","328","28.142857142857"
"4","2018","30","Hotel","8","3","266","476","139","304","405","780","4.1111111111111"
"4","2018","30","Otros","9","22","81","104","2","4","83","108","7.6428571428571"
"4","2018","30","Otros","13","14","15","30","0","0","15","30","7.3846153846154"
"4","2018","30","Otros","5","9","4","8","5","10","9","18","4.0454545454545"
"4","2018","30","Otros","10","18","21","29","31","63","52","92","10.25"
"4","2018","30","Otros","6","25","82","142","16","44","98","186","2.3846153846154"
"4","2018","30","Otros","9","22","13","17","0","0","13","17","7.6428571428571"
"4","2018","30","Otros","10","27","17","76","0","0","17","76","4.84"
"4","2018","30","Otros","16","20","6","8","0","0","6","8","3.0769230769231"
"4","2018","30","Hotel","7","17","30","108","0","0","30","108","10"
"4","2018","30","Otros","15","27","45","53","0","0","45","53","1.4222222222222"
"4","2018","30","Otros","12","35","7","7","3","3","10","10","3.5"
"4","2018","30","Otros","12","35","8","12","83","131","91","143","3.5"
"4","2018","30","Otros","3","7","2","6","1","3","3","9","2"
"4","2018","30","Otros","10","11","1","1","1","1","2","2","11.764705882353"
"4","2018","30","Otros","12","24","7","7","0","0","7","7","9.2"
"4","2018","30","Otros","10","23","24","53","0","0","24","53","7"
"4","2018","30","Otros","7","27","11","13","0","0","11","13","4.8333333333333"
"4","2018","30","","10","18","5","7","0","0","5","7","1"
"4","2018","30","Otros","16","27","1","1","0","0","1","1","13.818181818182"
"4","2018","30","Hotel","2","29","8","30","19","70","27","100","1"
"4","2018","30","Otros","14","27","51","51","0","0","51","51","11.833333333333"
"4","2018","30","Otros","11","32","71","89","0","0","71","89","2.2857142857143"
"4","2018","30","Otros","16","19","52","120","0","0","52","120","1"
"4","2018","30","Otros","16","27","9","9","0","0","9","9","13.818181818182"
"4","2018","30","Otros","8","3","10","34","2","6","12","40","10"
"4","2018","30","Otros","16","27","30","42","0","0","30","42","13.818181818182"
"4","2018","30","Otros","16","20","54","80","4","8","58","88","3.0769230769231"
"4","2018","30","Otros","16","40","83","149","24","34","107","183","28.142857142857"
"4","2018","30","Hotel","11","36","41","96","24","56","65","152","2.375"
"4","2018","30","Otros","6","10","54","62","0","0","54","62","3.8518518518518"
"4","2018","30","Otros","7","38","163","375","29","81","192","456","2.75"
"4","2018","30","Otros","13","14","15","30","0","0","15","30","7.3846153846154"
"4","2018","30","Otros","9","30","16","26","0","0","16","26","2.3333333333333"
"4","2018","30","Otros","13","27","58","174","0","0","58","174","12.2"
"4","2018","30","Otros","10","27","42","42","25","25","67","67","4.84"
"4","2018","30","Otros","6","25","25","29","7","10","32","39","2.3846153846154"
"4","2018","30","Otros","9","26","31","400","0","0","31","400","3.8888888888889"
"4","2018","30","Otros","10","18","28","40","10","46","38","86","10.25"
"4","2018","30","Otros","2","29","25","70","22","57","47","127","3.28"
"4","2018","30","Otros","6","25","2","2","0","0","2","2","2.3846153846154"
"4","2018","30","Otros","5","9","12","16","11","14","23","30","4.0454545454545"
"4","2018","30","Otros","5","9","5","15","10","19","15","34","4.0454545454545"
"4","2018","30","Hotel","9","37","41","58","4","10","45","68","3.4"
"4","2018","30","Hotel","7","38","144","178","30","38","174","216","1"
"4","2018","30","Otros","7","27","32","44","0","0","32","44","4.8333333333333"
"4","2018","30","Otros","5","9","1","1","0","0","1","1","4.0454545454545"
"4","2018","30","Otros","10","27","8","8","3","6","11","14","4.84"
"4","2018","30","Otros","7","27","10","10","0","0","10","10","4.8333333333333"
"4","2018","30","Otros","16","40","35","41","48","95","83","136","28.142857142857"
"4","2018","30","Otros","10","23","17","17","2","2","19","19","7"
"4","2018","30","Otros","15","16","51","310","1","2","52","312","9"
"4","2018","30","Otros","3","7","9","17","63","137","72","154","2"
"4","2018","30","Otros","7","17","42","82","0","0","42","82","17.166666666667"
"4","2018","30","Otros","8","27","31","162","2","2","33","164","9.4"
"4","2018","30","Otros","9","22","26","100","0","0","26","100","7.6428571428571"
"4","2018","30","Otros","16","19","18","40","0","0","18","40","10.263157894737"
"4","2018","0","","15","27","0","0","0","0","0","0","1"
"4","2018","30","Hotel","10","11","20","20","8","8","28","28","5.6666666666667"
"4","2018","30","Otros","2","27","3","8","0","0","3","8","3.2"
"4","2018","30","Otros","8","2","23","28","21","25","44","53","6.4285714285714"
"4","2018","30","Otros","5","5","2","3","0","0","2","3","3.65625"
"4","2018","30","Otros","12","35","5","7","8","10","13","17","3.5"
"4","2018","30","Otros","8","3","4","24","0","0","4","24","10"
"4","2018","30","Otros","12","24","0","0","42","65","42","65","9.2"
"4","2018","30","Otros","11","32","16","132","0","0","16","132","2.2857142857143"
"4","2018","30","Otros","10","27","37","68","22","30","59","98","4.84"
"4","2018","30","Otros","11","15","71","73","0","0","71","73","2.3571428571429"
"4","2018","30","Otros","5","8","7","17","0","0","7","17","5"
"4","2018","30","Otros","14","27","18","18","4","4","22","22","11.833333333333"
"4","2018","30","Otros","13","27","104","116","7","9","111","125","12.2"
"4","2018","30","Hotel","10","18","95","95","87","87","182","182","3.2"
"4","2018","30","Otros","10","27","16","21","13","13","29","34","4.84"
"4","2018","30","Otros","11","32","10","16","0","0","10","16","1"
"4","2018","30","Otros","9","37","29","76","0","0","29","76","4.5"
"4","2018","30","Otros","12","35","20","21","221","230","241","251","3.5"
"4","2018","30","Otros","8","34","100","174","44","78","144","252","5.75"
"4","2018","30","Hotel","16","40","21","41","43","92","64","133","16.333333333333"
"4","2018","27","Hotel","10","11","20","164","14","36","34","200","5.6666666666667"
"4","2018","30","Otros","7","27","20","43","0","0","20","43","4.8333333333333"
"4","2018","30","Hotel","7","38","16","18","0","0","16","18","1"
"4","2018","30","Otros","6","27","2","3","0","0","2","3","3.960088691796"
"4","2018","30","Otros","6","10","24","32","0","0","24","32","3.8518518518518"
"4","2018","15","Otros","6","25","52","82","0","0","52","82","1"
"4","2018","30","Otros","6","25","8","8","4","8","12","16","2.3846153846154"
"4","2018","30","Otros","6","27","8","240","0","0","8","240","3.960088691796"
"4","2018","30","Otros","6","27","103","208","0","0","103","208","3.960088691796"
"4","2018","30","Otros","5","5","4","5","3","7","7","12","3.65625"
"4","2018","30","Otros","5","5","7","9","0","0","7","9","3.65625"
"4","2018","30","Otros","3","4","8","18","2","2","10","20","12.2"
"4","2018","30","Otros","10","23","6","10","0","0","6","10","7"
"4","2018","30","Otros","8","3","15","29","0","0","15","29","10"
"4","2018","30","Otros","5","5","24","62","0","0","24","62","3.65625"
"4","2018","30","Otros","5","8","8","10","0","0","8","10","5"
"4","2018","30","Otros","6","10","34","66","0","0","34","66","3.8518518518518"
"4","2018","30","Otros","16","19","15","30","0","0","15","30","10.263157894737"
"4","2018","30","Otros","11","15","13","25","7","14","20","39","2.3571428571429"
"4","2018","30","Otros","7","38","43","66","0","0","43","66","2.75"
"4","2018","30","Otros","11","32","111","213","26","30","137","243","2.2857142857143"
"4","2018","30","Otros","8","2","44","166","0","0","44","166","6.4285714285714"
"4","2018","30","Otros","10","27","31","49","15","15","46","64","4.84"
"4","2018","30","Otros","6","27","19","38","0","0","19","38","3.960088691796"
"4","2018","30","Otros","11","32","26","36","1","1","27","37","2.2857142857143"
"4","2018","30","Otros","8","34","6","8","25","53","31","61","5.75"
"4","2018","30","Otros","11","32","4","4","0","0","4","4","2.2857142857143"
"4","2018","30","Otros","10","11","8","12","0","0","8","12","11.764705882353"
"4","2018","30","Otros","11","32","11","16","5","10","16","26","2.2857142857143"
"4","2018","30","Otros","14","31","17","24","22","37","39","61","20.2"
"4","2018","30","Hotel","14","31","189","549","567","1993","756","2542","17.4"
"4","2018","30","Otros","11","36","132","243","20","35","152","278","5.1904761904762"
"4","2018","30","Hotel","15","16","815","1761","173","367","988","2128","2"
"4","2018","30","Otros","15","27","6","6","0","0","6","6","1.4222222222222"
"4","2018","30","Otros","5","5","3","9","0","0","3","9","3.65625"
"4","2018","30","Otros","8","34","10","10","6","9","16","19","5.75"
"4","2018","30","Otros","7","27","6","12","0","0","6","12","4.8333333333333"
"4","2018","30","Otros","12","35","4","5","10","10","14","15","3.5"
"4","2018","30","Otros","5","5","39","127","0","0","39","127","3.65625"
"4","2018","30","Otros","10","11","2","3","0","0","2","3","11.764705882353"
"4","2018","30","Otros","10","11","1","3","0","0","1","3","11.764705882353"
"4","2018","30","Otros","9","30","4","80","0","0","4","80","2.3333333333333"
"4","2018","30","Otros","8","2","26","42","1","1","27","43","6.4285714285714"
"4","2018","30","Otros","10","27","73","127","6","6","79","133","4.84"
"4","2018","30","Otros","5","9","12","14","0","0","12","14","4.0454545454545"
"4","2018","30","Otros","6","27","10","11","0","0","10","11","3.960088691796"
"4","2018","30","Otros","6","10","61","106","5","10","66","116","3.8518518518518"
"4","2018","30","Otros","6","10","16","32","0","0","16","32","3.8518518518518"
"4","2018","30","Otros","6","27","10","10","0","0","10","10","3.960088691796"
"4","2018","30","Otros","6","12","3","20","0","0","3","20","1.8256578947368"
"4","2018","30","Otros","6","10","33","69","0","0","33","69","3.8518518518518"
"4","2018","8","Otros","6","10","12","20","0","0","12","20","3.8518518518518"
"4","2018","30","Otros","6","27","19","22","0","0","19","22","3.960088691796"
"4","2018","30","Otros","6","12","36","50","0","0","36","50","1.8256578947368"
"4","2018","30","Otros","6","10","13","13","0","0","13","13","3.8518518518518"
"4","2018","30","Hotel","6","25","17","67","0","0","17","67","1"
"4","2018","2","Otros","6","27","2","2","0","0","2","2","3.960088691796"
"4","2018","30","Otros","5","9","11","25","21","42","32","67","4.0454545454545"
"4","2018","30","Otros","5","5","12","58","2","5","14","63","3.65625"
"4","2018","30","Otros","5","5","25","25","18","18","43","43","3.65625"
"4","2018","30","Otros","5","5","35","65","17","26","52","91","3.65625"
"4","2018","30","Otros","11","36","82","154","4","12","86","166","5.1904761904762"
"4","2018","30","Hotel","6","10","683","1335","31","57","714","1392","1"
"4","2018","30","Otros","5","9","9","12","0","0","9","12","4.0454545454545"
"4","2018","30","Otros","5","8","19","34","12","26","31","60","5"
"4","2018","0","Hotel","15","27","0","0","0","0","0","0","1"
"4","2018","30","Hotel","3","4","208","1326","28","132","236","1458","3"
"4","2018","30","Otros","3","7","10","10","9","9","19","19","1"
"4","2018","30","Otros","7","38","68","110","4","6","72","116","2.75"
"4","2018","30","Hotel","10","27","32","34","59","68","91","102","1"
"4","2018","30","Hotel","12","35","0","0","23","25","23","25","1.7272727272727"
"4","2018","30","Hotel","10","27","2","4","0","0","2","4","2.25"
"4","2018","30","Hotel","7","17","538","913","45","84","583","997","4"
"4","2018","30","Hotel","16","19","6","7","0","0","6","7","4"
"4","2018","30","Hotel","2","6","43","194","0","0","43","194","2.2"
"4","2018","30","Otros","5","5","62","229","6","21","68","250","3.65625"
"4","2018","30","Otros","12","24","77","88","128","163","205","251","9.2"
"4","2018","30","Otros","5","8","7","10","15","17","22","27","5"
"4","2018","30","Otros","4","13","159","175","7","7","166","182","1"
"4","2018","30","Otros","10","11","128","128","0","0","128","128","11.764705882353"
"4","2018","30","Otros","12","35","32","51","111","150","143","201","3.5"
"4","2018","30","Otros","10","23","75","84","4","4","79","88","7"
"4","2018","30","Otros","11","36","673","1486","204","428","877","1914","5.1904761904762"
"4","2018","30","Otros","12","35","18","25","24","38","42","63","3.5"
"4","2018","30","Otros","11","36","47","141","0","0","47","141","5.1904761904762"
"4","2018","30","Otros","8","2","40","164","3","6","43","170","6.4285714285714"
"4","2018","30","Otros","9","30","48","151","0","0","48","151","2.3333333333333"
"4","2018","30","Otros","11","36","74","229","20","55","94","284","5.1904761904762"
"4","2018","30","Otros","6","10","9","11","0","0","9","11","3.8518518518518"
"4","2018","30","Otros","10","18","25","59","0","0","25","59","10.25"
"4","2018","30","Otros","7","27","5","16","4","6","9","22","4.8333333333333"
"4","2018","30","Otros","16","20","78","110","0","0","78","110","1"
"4","2018","9","Otros","9","22","1","3","0","0","1","3","7.6428571428571"
"4","2018","30","Otros","5","5","146","187","9","13","155","200","3.65625"
"4","2018","30","Otros","12","35","12","15","30","34","42","49","3.5"
"4","2018","30","Otros","10","11","0","0","4","7","4","7","11.764705882353"
"4","2018","30","Otros","10","11","1","2","0","0","1","2","11.764705882353"
"4","2018","25","Otros","5","9","34","75","4","6","38","81","4.0454545454545"
"4","2018","30","Otros","5","5","3","90","1","30","4","120","3.65625"
"4","2018","30","Otros","12","35","0","0","2","2","2","2","3.5"
"4","2018","30","Otros","7","38","107","239","16","38","123","277","2.75"
"4","2018","30","Hotel","12","35","0","0","41","93","41","93","1.7272727272727"
"4","2018","30","Otros","13","14","31","35","0","0","31","35","1"
"4","2018","30","Otros","5","5","17","25","9","24","26","49","3.65625"
"4","2018","30","Hotel","9","26","6","14","0","0","6","14","1.5"
"4","2018","30","Hotel","16","19","40","40","0","0","40","40","1"
"4","2018","30","Otros","16","19","17","17","0","0","17","17","10.263157894737"
"4","2018","30","Otros","9","30","45","47","0","0","45","47","2.3333333333333"
"4","2018","30","Otros","16","19","5","5","0","0","5","5","10.263157894737"
"4","2018","30","Otros","16","19","59","125","0","0","59","125","10.263157894737"
"4","2018","30","Otros","9","26","11","16","0","0","11","16","3.8888888888889"
"4","2018","30","Otros","16","40","2","2","0","0","2","2","28.142857142857"
"4","2018","30","Hotel","16","27","9","22","0","0","9","22","5.8571428571429"
"4","2018","30","Otros","16","19","6","10","0","0","6","10","10.263157894737"
"4","2018","30","Otros","16","19","34","72","2","4","36","76","10.263157894737"
"4","2018","30","","9","30","140","219","1","2","141","221","1"
"4","2018","30","Otros","16","19","12","16","0","0","12","16","10.263157894737"
"4","2018","30","Otros","10","11","3","3","0","0","3","3","11.764705882353"
"4","2018","30","Otros","11","36","23","23","0","0","23","23","5.1904761904762"
"4","2018","30","Otros","16","19","4","6","0","0","4","6","10.263157894737"
"4","2018","30","Otros","16","19","111","151","2","8","113","159","1.3333333333333"
"4","2018","30","Otros","16","19","32","47","0","0","32","47","10.263157894737"
"4","2018","30","Otros","10","18","7","16","23","75","30","91","10.25"
"4","2018","30","Otros","16","19","22","54","0","0","22","54","10.263157894737"
"4","2018","30","Otros","16","19","6","6","0","0","6","6","1.3333333333333"
"4","2018","30","","9","26","447","1396","0","0","447","1396","1"
"4","2018","30","Otros","16","19","20","22","0","0","20","22","10.263157894737"
"4","2018","21","Otros","16","19","28","30","0","0","28","30","10.263157894737"
"4","2018","30","Hotel","8","2","566","1053","39","63","605","1116","1"
"4","2018","30","Otros","6","10","6","10","0","0","6","10","3.8518518518518"
"4","2018","30","Otros","6","12","22","22","0","0","22","22","1.8256578947368"
"4","2018","30","Hotel","16","19","42","61","29","40","71","101","1"
"4","2018","30","Otros","3","7","0","0","22","22","22","22","2"
"4","2018","30","Hotel","2","6","870","2947","105","254","975","3201","1"
"4","2018","30","Hotel","3","4","296","524","30","60","326","584","2.6"
"4","2018","30","Hotel","16","40","1560","2255","845","1224","2405","3479","1"
"4","2018","30","Otros","16","27","42","47","0","0","42","47","13.818181818182"
"4","2018","30","Hotel","6","28","208","335","9","14","217","349","2.4"
"4","2018","30","Hotel","8","34","1835","2916","234","397","2069","3313","1"
"4","2018","30","Otros","9","30","2","40","0","0","2","40","2.3333333333333"
"4","2018","30","Hotel","10","18","59","59","143","143","202","202","1"
"4","2018","30","Hotel","9","30","67","257","0","0","67","257","1"
"4","2018","30","Hotel","15","27","4","5","0","0","4","5","1"
"4","2018","30","Hotel","9","22","112","672","0","0","112","672","2.5555555555556"
"4","2018","30","","11","15","1","1","0","0","1","1","1"
"4","2018","30","Otros","6","12","14","17","0","0","14","17","1.8256578947368"
"4","2018","30","Hotel","15","27","30","900","0","0","30","900","1"
"4","2018","30","Otros","15","27","37","55","0","0","37","55","1.4222222222222"
"4","2018","30","Otros","15","27","7","210","0","0","7","210","1.4222222222222"
"4","2018","30","Otros","2","1","13","13","15","15","28","28","1"
"4","2018","30","Otros","12","24","13","16","0","0","13","16","9.2"
"4","2018","30","Otros","5","5","33","33","16","16","49","49","3.65625"
"4","2018","30","Hotel","7","27","152","316","32","32","184","348","1"
"4","2018","30","Otros","16","20","14","14","2","4","16","18","3.0769230769231"
"4","2018","30","","10","11","119","261","23","54","142","315","1"
"4","2018","30","Hotel","16","40","21","34","4","4","25","38","16.333333333333"
"4","2018","30","Otros","12","35","10","42","0","0","10","42","3.5"
"4","2018","30","Hotel","6","27","18","18","5","11","23","29","3"
"4","2018","30","Otros","5","5","29","40","0","0","29","40","3.65625"
"4","2018","30","Hotel","6","27","30","30","0","0","30","30","3"
"4","2018","30","Otros","6","25","26","40","0","0","26","40","2.3846153846154"
"4","2018","0","Hotel","15","27","0","0","0","0","0","0","1"
"4","2018","30","Otros","5","9","18","41","13","16","31","57","4.0454545454545"
"4","2018","30","Hotel","15","27","30","30","5","5","35","35","1"
"4","2018","0","Hotel","5","9","0","0","0","0","0","0","1"
"4","2018","30","Hotel","8","34","79","97","35","66","114","163","2.5714285714286"
"4","2018","0","Hotel","15","27","0","0","0","0","0","0","1"
"4","2018","30","Hotel","6","27","185","307","0","0","185","307","3"
"4","2018","0","Otros","6","27","0","0","0","0","0","0","1"
"4","2018","30","Otros","12","27","0","0","27","39","27","39","3.4285714285714"
"4","2018","30","Hotel","2","27","455","471","153","160","608","631","1"
"4","2018","30","Hotel","2","6","371","371","0","0","371","371","1"
"4","2018","30","Otros","2","6","42","45","0","0","42","45","1"
"4","2018","30","Hotel","4","39","103","103","0","0","103","103","1"
"4","2018","30","Hotel","6","10","407","541","14","15","421","556","1"
"4","2018","30","Otros","5","8","39","62","11","17","50","79","5"
"4","2018","0","Hotel","13","33","0","0","0","0","0","0","1"
"4","2018","30","Hotel","13","33","135","270","52","104","187","374","1"
"4","2018","30","Otros","11","32","115","293","17","44","132","337","2.2857142857143"
"4","2018","30","Hotel","9","26","405","912","230","698","635","1610","1"
"4","2018","30","Hotel","16","20","59","63","2","4","61","67","1"
"4","2018","30","Otros","16","20","10","10","0","0","10","10","3.0769230769231"
"4","2018","30","","16","40","710","1363","52","170","762","1533","1"
"4","2018","30","Hotel","15","16","1123","2069","126","292","1249","2361","1"
"4","2018","30","Hotel","5","9","14","16","7","7","21","23","1"
"4","2018","30","Otros","7","38","35","96","0","0","35","96","2.75"
"4","2018","30","Otros","2","6","236","2948","0","0","236","2948","1"
"4","2018","30","Otros","2","6","319","416","0","0","319","416","1"
"4","2018","30","Hotel","15","27","222","976","16","16","238","992","1"
"4","2018","30","Otros","7","38","49","72","0","0","49","72","2.75"
"4","2018","30","Otros","2","1","19","68","10","30","29","98","1"
"4","2018","30","Otros","8","3","30","42","1","1","31","43","10"
"4","2018","30","Otros","11","36","5","34","0","0","5","34","5.1904761904762"
"4","2018","30","Otros","16","20","34","76","0","0","34","76","3.0769230769231"
"4","2018","30","Otros","8","3","307","430","8","16","315","446","1"
"4","2018","30","Otros","4","39","65","95","0","0","65","95","2.2222222222222"
"4","2018","30","Otros","5","5","224","512","28","59","252","571","3.65625"
"4","2018","30","Otros","12","27","15","22","22","33","37","55","3.4285714285714"
"4","2018","30","Otros","7","27","49","163","0","0","49","163","1"
"4","2018","30","Hotel","2","6","378","1540","44","52","422","1592","1"
"4","2018","30","Hotel","14","27","373","1277","76","118","449","1395","1"
"4","2018","30","Hotel","16","19","338","488","0","0","338","488","1"
"4","2018","30","","2","1","11","154","0","0","11","154","1"
"4","2018","30","Hotel","2","27","71","341","4","9","75","350","1"
"4","2018","30","Otros","16","20","13","15","0","0","13","15","1"
"4","2018","0","Otros","13","14","0","0","0","0","0","0","1"
"4","2018","30","Hotel","11","36","109","170","0","0","109","170","2.375"
"4","2018","30","Otros","13","14","6","62","0","0","6","62","7.3846153846154"
"4","2018","30","Otros","12","27","6","10","0","0","6","10","3.4285714285714"
"4","2018","30","Hotel","2","6","165","380","8","12","173","392","2.2"
"4","2018","30","Otros","2","6","1950","2580","0","0","1950","2580","1"
"4","2018","30","Otros","10","27","8","192","0","0","8","192","4.84"
"4","2018","30","Otros","12","27","10","12","12","14","22","26","3.4285714285714"
"4","2018","30","Otros","13","14","82","82","0","0","82","82","7.3846153846154"
"4","2018","30","Otros","6","12","136","184","21","54","157","238","1.8256578947368"
"4","2018","30","Otros","2","6","666","992","46","112","712","1104","1"
"4","2018","30","Hotel","12","35","21","28","1","1","22","29","1.7272727272727"
"4","2018","30","Otros","5","5","18","26","10","21","28","47","3.65625"
"4","2018","30","Otros","9","30","7","150","2","60","9","210","2.3333333333333"
"4","2018","0","Hotel","8","2","0","0","0","0","0","0","1"
"4","2018","30","Otros","9","30","18","306","0","0","18","306","2.3333333333333"
"4","2018","30","Hotel","15","27","26","26","0","0","26","26","1"
"4","2018","30","Hotel","3","7","4","4","5","5","9","9","1"
"4","2018","30","Otros","6","12","444","698","0","0","444","698","1.8256578947368"
"4","2018","30","Otros","12","27","17","44","8","8","25","52","3.4285714285714"
"4","2018","20","Otros","2","6","3","5","0","0","3","5","5"
"4","2018","14","Otros","6","27","1","5","0","0","1","5","3.960088691796"
"4","2018","0","Hotel","10","11","0","0","0","0","0","0","1"
"4","2018","30","Otros","2","1","9","63","0","0","9","63","1"
"4","2018","30","Otros","11","36","19","48","7","7","26","55","5.1904761904762"
"4","2018","30","Hotel","11","32","0","0","0","0","0","0","1"
"4","2018","30","Otros","2","27","7","210","0","0","7","210","1"
"4","2018","30","Otros","12","27","8","14","2","2","10","16","3.4285714285714"
"4","2018","30","Hotel","8","2","38","48","4","4","42","52","3"
"4","2018","30","Hotel","16","20","29","29","0","0","29","29","1"
"4","2018","30","Otros","12","35","6","11","18","29","24","40","3.5"
"4","2018","30","Otros","13","14","17","19","0","0","17","19","1"
"4","2018","30","Otros","2","27","21","57","0","0","21","57","3.2"
"4","2018","30","Hotel","6","27","10","10","0","0","10","10","3"
"4","2018","30","Hotel","8","3","17","34","4","12","21","46","4.1111111111111"
"4","2018","30","Hotel","15","27","29","48","5","9","34","57","1"
"4","2018","30","Otros","8","3","44","92","1","2","45","94","10"
"4","2018","30","Hotel","16","20","39","59","0","0","39","59","1"
"4","2018","30","Hotel","6","28","100","161","0","0","100","161","2.4"
"4","2018","30","Otros","2","1","28","90","4","4","32","94","5.5"
"4","2018","30","Hotel","11","36","72","146","93","175","165","321","2.375"
"4","2018","30","Otros","4","13","206","206","2","2","208","208","1"
"4","2018","30","Otros","2","6","209","1463","0","0","209","1463","1"
"4","2018","30","Otros","8","34","156","213","40","46","196","259","5.75"
"4","2018","0","Hotel","11","15","0","0","0","0","0","0","1"
"4","2018","30","Otros","15","27","11","20","0","0","11","20","1.4222222222222"
"4","2018","5","Hotel","13","14","80","150","3","5","83","155","1"
"4","2018","30","Hotel","13","14","133","205","25","32","158","237","1"
"4","2018","0","Hotel","9","30","0","0","0","0","0","0","1"
"4","2018","30","Hotel","4","13","170","316","24","32","194","348","5.4"
"4","2018","30","Otros","6","27","10","35","0","0","10","35","3.960088691796"
"4","2018","0","Hotel","15","27","0","0","0","0","0","0","1"
"4","2018","30","Hotel","2","29","10","39","30","101","40","140","2"
"4","2018","30","Hotel","13","33","17","26","0","0","17","26","2"
"4","2018","30","Hotel","12","35","53","97","56","116","109","213","1.7272727272727"
"4","2018","30","Hotel","13","14","226","347","7","13","233","360","1"
"4","2018","30","Otros","6","25","16","32","0","0","16","32","2.3846153846154"
"4","2018","30","Hotel","8","2","27","32","6","6","33","38","3"
"4","2018","30","Otros","4","39","39","60","0","0","39","60","2.2222222222222"
"4","2018","30","Otros","6","12","154","260","8","13","162","273","1.8256578947368"
"4","2018","30","Otros","13","33","25","35","28","40","53","75","5.125"
"4","2018","30","Hotel","4","13","132","242","6","12","138","254","5.4"
"4","2018","30","Hotel","7","27","183","249","4","4","187","253","4.1666666666667"
"4","2018","30","Hotel","4","13","581","1498","111","278","692","1776","1"
"4","2018","0","","5","8","0","0","0","0","0","0","1"
"4","2018","30","Otros","8","2","54","96","4","8","58","104","6.4285714285714"
"4","2018","30","Otros","2","6","18","18","17","17","35","35","1"
"4","2018","30","","6","10","18","22","0","0","18","22","1"
"4","2018","30","Hotel","2","29","36","123","35","108","71","231","2"
"4","2018","30","","14","31","160","382","401","1378","561","1760","1"
"4","2018","30","Hotel","16","27","3828","11486","0","0","3828","11486","1"
"4","2018","30","Hotel","12","35","39","56","68","109","107","165","1.7272727272727"
"4","2018","30","","12","35","286","326","1957","2053","2243","2379","1"
"4","2018","30","","9","26","75","114","5","8","80","122","1"
"4","2018","30","Otros","11","32","24","36","0","0","24","36","2.2857142857143"
"4","2018","30","Otros","12","24","27","88","53","71","80","159","9.2"
"4","2018","30","Hotel","6","25","32","38","0","0","32","38","1"
"4","2018","30","Otros","11","32","19","19","0","0","19","19","2.2857142857143"
"4","2018","30","Hotel","16","19","45","48","0","0","45","48","4"
"4","2018","30","Otros","13","33","17","19","7","9","24","28","5.125"
"4","2018","30","Otros","16","27","34","102","1","29","35","131","13.818181818182"
"4","2018","30","Otros","6","12","76","138","0","0","76","138","1.8256578947368"
"4","2018","30","Otros","2","29","20","58","0","0","20","58","3.28"
"4","2018","30","Hotel","14","27","557","642","128","162","685","804","1"
"4","2018","30","Otros","2","1","1","1","0","0","1","1","1"
"4","2018","30","Otros","11","32","24","24","0","0","24","24","2.2857142857143"
"4","2018","30","Otros","2","27","36","46","0","0","36","46","1"
"4","2018","30","Hotel","2","29","251","968","13","24","264","992","1"
"4","2018","30","Hotel","4","13","44","449","0","0","44","449","3.2"
"4","2018","30","Hotel","4","21","3","4","0","0","3","4","3"
"4","2018","30","Otros","7","27","51","67","0","0","51","67","4.8333333333333"
"4","2018","21","","3","4","24","53","0","0","24","53","1"
"4","2018","30","Hotel","6","27","12","20","1","1","13","21","3"
"4","2018","30","Otros","16","19","9","19","0","0","9","19","10.263157894737"
"4","2018","30","Otros","11","32","30","57","2","2","32","59","2.2857142857143"
"4","2018","30","Otros","3","7","16","21","10","13","26","34","2"
"4","2018","30","Otros","5","5","37","60","0","0","37","60","3.65625"
"4","2018","24","Otros","15","27","925","1323","0","0","925","1323","1.4222222222222"
"4","2018","30","Otros","6","25","34","48","0","0","34","48","2.3846153846154"
"4","2018","4","","10","27","3","9","0","0","3","9","1"
"4","2018","30","Otros","2","29","35","54","155","231","190","285","3.28"
"4","2018","30","Otros","12","35","0","0","10","23","10","23","3.5"
"4","2018","30","Otros","16","19","34","52","0","0","34","52","10.263157894737"
"4","2018","30","Otros","9","26","55","103","0","0","55","103","3.8888888888889"
"4","2018","30","Hotel","13","33","48","48","3","5","51","53","2"
"4","2018","30","Otros","11","32","15","21","7","9","22","30","2.2857142857143"
"4","2018","30","Otros","9","22","9","17","0","0","9","17","7.6428571428571"
"4","2018","30","Otros","6","27","15","315","0","0","15","315","3.960088691796"
"4","2018","30","Otros","15","27","6","6","0","0","6","6","1.4222222222222"
"4","2018","30","Otros","11","32","64","66","0","0","64","66","2.2857142857143"
"4","2018","30","Otros","11","15","23","32","1","1","24","33","2.3571428571429"
"4","2018","30","Otros","9","37","18","36","0","0","18","36","4.5"
"4","2018","30","Otros","5","9","24","38","5","10","29","48","4.0454545454545"
"4","2018","30","Hotel","10","27","41","79","0","0","41","79","2.25"
"4","2018","30","Otros","6","28","25","345","1","5","26","350","4.65"
"4","2018","30","Otros","4","13","21","24","2","5","23","29","3.4"
"4","2018","30","Otros","2","1","1","1","0","0","1","1","1"
"4","2018","30","Otros","2","29","20","40","22","47","42","87","3.28"
"4","2018","30","Hotel","8","3","18","30","0","0","18","30","4.1111111111111"
"4","2018","30","Otros","16","19","75","164","0","0","75","164","1.3333333333333"
"4","2018","30","Otros","12","35","3","5","8","9","11","14","3.5"
"4","2018","30","Hotel","12","35","22","31","54","83","76","114","1.7272727272727"
"4","2018","30","Otros","12","35","8","14","27","41","35","55","3.5"
"4","2018","30","Otros","2","29","70","104","100","163","170","267","3.28"
"4","2018","30","Hotel","7","27","110","171","2","2","112","173","1"
"4","2018","30","Hotel","9","22","42","54","4","4","46","58","2.5555555555556"
"4","2018","30","Hotel","12","35","32","68","62","82","94","150","1.7272727272727"
"4","2018","30","Otros","15","16","99","189","19","56","118","245","2"
"4","2018","30","Hotel","15","27","5","5","0","0","5","5","1"
"4","2018","30","Otros","4","13","65","70","19","19","84","89","3.4"
"4","2018","30","Hotel","8","34","67","125","30","54","97","179","2.5714285714286"
"4","2018","0","Hotel","16","20","0","0","0","0","0","0","1"
"4","2018","30","Hotel","6","28","144","190","21","42","165","232","2.4"
"4","2018","30","Hotel","15","27","73","95","10","10","83","105","1"
"4","2018","30","Otros","12","35","137","198","53","104","190","302","3.5"
"4","2018","30","Otros","11","15","35","85","8","16","43","101","2.3571428571429"
"4","2018","30","Otros","11","15","11","12","0","0","11","12","2.3571428571429"
"4","2018","30","Otros","11","36","55","130","69","123","124","253","5.1904761904762"
"4","2018","30","Hotel","11","36","72","94","4","8","76","102","2.375"
"4","2018","30","Hotel","6","12","97","154","0","0","97","154","5"
"4","2018","30","Otros","8","3","19","27","10","18","29","45","10"
"4","2018","30","Otros","10","27","7","7","7","7","14","14","4.84"
"4","2018","30","Otros","8","3","12","13","0","0","12","13","10"
"4","2018","30","Otros","6","25","6","6","0","0","6","6","2.3846153846154"
"4","2018","30","Hotel","2","27","53","136","0","0","53","136","1"
"4","2018","30","Hotel","10","18","0","0","56","168","56","168","3.2"
"4","2018","30","Otros","11","32","66","152","8","14","74","166","1"
"4","2018","30","Hotel","6","10","1665","2231","175","389","1840","2620","1"
"4","2018","30","Otros","11","32","50","82","9","18","59","100","2.2857142857143"
"4","2018","0","Otros","2","27","0","0","0","0","0","0","1"
"4","2018","30","","12","24","67","171","326","799","393","970","1"
"4","2018","30","Hotel","16","27","487","617","0","0","487","617","5.8571428571429"
"4","2018","30","Hotel","7","38","23","41","5","6","28","47","1"
"4","2018","30","Hotel","6","12","2632","2665","25","39","2657","2704","1"
"5","2018","31","Hotel","14","31","1399","2127","7759","8927","9158","11054","1"
"5","2018","31","Hotel","14","31","582","1047","2397","7842","2979","8889","1"
"5","2018","31","Hotel","14","31","725","874","543","2385","1268","3259","1"
"5","2018","0","Hotel","11","32","0","0","0","0","0","0","1"
"5","2018","31","Hotel","14","27","3489","4734","716","970","4205","5704","1"
"5","2018","31","Otros","11","32","44","57","0","0","44","57","2.2857142857143"
"5","2018","31","Hotel","14","31","641","835","3060","3857","3701","4692","5.4"
"5","2018","31","Hotel","15","16","1130","2004","40","76","1170","2080","1"
"5","2018","31","Hotel","14","31","1101","1807","1209","4384","2310","6191","5.4"
"5","2018","31","Hotel","12","24","3234","4026","650","1026","3884","5052","1"
"5","2018","31","Hotel","16","40","1176","1552","267","546","1443","2098","1"
"5","2018","31","Hotel","6","12","1536","2230","87","174","1623","2404","1"
"5","2018","31","Hotel","10","23","2035","2866","328","497","2363","3363","1"
"5","2018","31","Hotel","14","31","1462","3693","299","757","1761","4450","5.4"
"5","2018","31","Hotel","3","4","1151","2268","118","198","1269","2466","1"
"5","2018","31","","11","32","476","1267","62","159","538","1426","1"
"5","2018","31","Hotel","6","12","377","860","17","69","394","929","1"
"5","2018","31","Hotel","6","12","2623","3426","356","377","2979","3803","1"
"5","2018","31","Hotel","9","26","3176","5747","74","140","3250","5887","1"
"5","2018","31","Hotel","2","1","733","2188","22","264","755","2452","1"
"5","2018","31","Hotel","9","26","1190","1920","90","441","1280","2361","1"
"5","2018","31","Hotel","6","12","869","1392","71","173","940","1565","1"
"5","2018","31","Hotel","14","31","138","174","4228","8093","4366","8267","5.4"
"5","2018","31","Hotel","11","32","76","136","13","18","89","154","1"
"5","2018","31","Hotel","2","6","1547","2198","90","122","1637","2320","1"
"5","2018","31","Hotel","16","40","1155","2312","387","604","1542","2916","1"
"5","2018","31","Hotel","14","27","566","1753","1241","2078","1807","3831","1"
"5","2018","31","Otros","11","36","38","180","0","0","38","180","1"
"5","2018","31","Hotel","10","23","999","1208","588","1160","1587","2368","1"
"5","2018","31","Hotel","14","31","493","1267","481","2059","974","3326","7.8"
"5","2018","31","Hotel","7","17","354","701","22","52","376","753","1"
"5","2018","31","Hotel","2","1","2189","3270","0","0","2189","3270","2"
"5","2018","31","Hotel","2","1","1614","2333","256","596","1870","2929","2"
"5","2018","31","Hotel","4","13","977","1525","55","116","1032","1641","1"
"5","2018","31","Hotel","2","1","1227","2150","77","201","1304","2351","2"
"5","2018","31","Hotel","10","27","1378","3098","597","1000","1975","4098","1"
"5","2018","31","Hotel","14","27","831","884","1088","1229","1919","2113","1"
"5","2018","31","Hotel","14","27","2468","3248","1040","1901","3508","5149","1"
"5","2018","31","Hotel","6","12","1999","2000","94","154","2093","2154","1"
"5","2018","31","Hotel","6","12","1767","2345","524","560","2291","2905","1"
"5","2018","31","Hotel","13","27","1854","3717","0","0","1854","3717","1"
"5","2018","31","Hotel","14","31","35","78","1037","2877","1072","2955","7.8"
"5","2018","31","Hotel","6","12","1657","5064","337","1037","1994","6101","1"
"5","2018","31","Hotel","16","27","2018","3657","76","148","2094","3805","1"
"5","2018","31","","10","27","10","14","2","10","12","24","1"
"5","2018","31","Hotel","10","18","778","1309","268","576","1046","1885","1"
"5","2018","31","Hotel","9","37","1331","2275","313","573","1644","2848","1"
"5","2018","31","Hotel","16","27","836","3348","0","0","836","3348","1"
"5","2018","31","Hotel","15","16","960","1809","81","247","1041","2056","2"
"5","2018","31","Hotel","2","1","1528","2560","312","524","1840","3084","2"
"5","2018","31","Hotel","3","4","452","1179","190","290","642","1469","1"
"5","2018","31","Hotel","16","40","1371","1945","602","891","1973","2836","1"
"5","2018","31","Hotel","7","17","2495","2858","176","200","2671","3058","1"
"5","2018","31","Hotel","12","24","979","1719","392","806","1371","2525","1"
"5","2018","31","Hotel","12","35","688","1293","170","319","858","1612","1"
"5","2018","31","Hotel","2","6","546","1935","42","51","588","1986","1"
"5","2018","31","Hotel","13","33","1216","1780","85","188","1301","1968","1"
"5","2018","31","Hotel","10","27","1330","1505","716","965","2046","2470","1"
"5","2018","31","Hotel","10","23","1209","2156","246","441","1455","2597","1"
"5","2018","31","Hotel","11","36","1299","1909","63","98","1362","2007","1"
"5","2018","31","Hotel","8","34","1232","1932","245","245","1477","2177","1"
"5","2018","31","Hotel","2","6","693","1580","38","100","731","1680","1"
"5","2018","31","Hotel","14","31","867","1280","1264","1599","2131","2879","7.8"
"5","2018","31","Hotel","11","36","2027","3022","174","275","2201","3297","1"
"5","2018","31","","10","27","170","325","524","743","694","1068","1"
"5","2018","31","Hotel","14","31","2056","2723","1583","5147","3639","7870","5.4"
"5","2018","31","Hotel","4","13","2764","2778","3","7","2767","2785","1"
"5","2018","31","Hotel","6","28","1661","1906","74","92","1735","1998","1"
"5","2018","31","Otros","14","31","43","62","22","682","65","744","2.8"
"5","2018","31","Otros","16","27","71","71","0","0","71","71","2"
"5","2018","31","Hotel","2","1","1120","1816","61","115","1181","1931","2"
"5","2018","31","Hotel","10","18","643","925","141","203","784","1128","1"
"5","2018","31","Hotel","7","17","965","1982","91","131","1056","2113","1"
"5","2018","31","Hotel","12","24","571","1396","344","1234","915","2630","1"
"5","2018","31","Hotel","10","18","733","1361","133","252","866","1613","1"
"5","2018","31","Hotel","2","1","2664","3432","40","84","2704","3516","1"
"5","2018","31","Hotel","10","18","503","1253","205","421","708","1674","1"
"5","2018","31","Hotel","6","28","1667","2226","351","397","2018","2623","1"
"5","2018","31","Hotel","5","5","954","1700","71","113","1025","1813","1"
"5","2018","31","Hotel","4","13","426","751","28","41","454","792","1"
"5","2018","31","Hotel","10","18","544","813","153","229","697","1042","1"
"5","2018","31","Hotel","16","40","824","1372","16","23","840","1395","1"
"5","2018","31","Hotel","8","3","1923","4085","344","685","2267","4770","1"
"5","2018","31","Hotel","15","16","826","1096","250","268","1076","1364","2"
"5","2018","31","Hotel","14","31","53","114","288","1057","341","1171","7.8"
"5","2018","31","Hotel","13","33","402","946","148","301","550","1247","1"
"5","2018","31","Hotel","15","16","292","701","93","213","385","914","2"
"5","2018","31","Otros","4","21","678","862","0","0","678","862","1"
"5","2018","31","Hotel","6","10","696","1015","0","0","696","1015","1"
"5","2018","31","Hotel","16","19","197","283","7","11","204","294","1"
"5","2018","31","Hotel","16","27","695","1478","3","6","698","1484","1"
"5","2018","31","Hotel","10","11","1427","2458","74","117","1501","2575","1"
"5","2018","31","Otros","10","23","403","852","7","14","410","866","1"
"5","2018","12","Hotel","12","35","38","72","23","39","61","111","1"
"5","2018","31","Hotel","11","36","615","958","52","116","667","1074","1"
"5","2018","31","Hotel","14","31","17","40","204","1262","221","1302","17.4"
"5","2018","31","Hotel","10","18","432","952","404","937","836","1889","3.2"
"5","2018","31","Hotel","4","13","513","927","43","238","556","1165","1"
"5","2018","31","Hotel","6","12","523","1061","33","54","556","1115","5"
"5","2018","31","Hotel","6","10","565","896","97","156","662","1052","1"
"5","2018","31","Otros","5","5","167","237","35","45","202","282","3.65625"
"5","2018","31","Hotel","12","24","1109","1260","618","832","1727","2092","1"
"5","2018","31","Hotel","8","3","873","1629","78","153","951","1782","1"
"5","2018","31","Hotel","13","27","572","866","0","0","572","866","2.75"
"5","2018","31","Hotel","15","16","130","750","40","200","170","950","4"
"5","2018","31","Otros","15","16","260","1032","80","375","340","1407","2"
"5","2018","31","Otros","16","20","54","78","0","0","54","78","1"
"5","2018","31","Hotel","3","4","773","1536","94","94","867","1630","1"
"5","2018","31","Hotel","11","36","86","97","0","0","86","97","1"
"5","2018","31","Hotel","2","6","188","1071","3","53","191","1124","1"
"5","2018","31","Hotel","8","34","627","1205","129","246","756","1451","1"
"5","2018","31","Hotel","4","13","16","29","0","0","16","29","3.2"
"5","2018","31","Hotel","13","27","932","2048","0","0","932","2048","2.75"
"5","2018","31","Hotel","2","29","167","483","0","0","167","483","1"
"5","2018","31","Otros","11","36","72","134","0","0","72","134","1"
"5","2018","31","","10","11","2","2","0","0","2","2","1"
"5","2018","31","Hotel","4","13","955","1265","40","122","995","1387","1"
"5","2018","31","Hotel","16","40","2310","3468","207","312","2517","3780","5.6666666666667"
"5","2018","31","Hotel","10","23","875","1412","362","714","1237","2126","2.8"
"5","2018","31","Hotel","8","34","438","595","116","226","554","821","1"
"5","2018","31","Hotel","5","5","277","825","0","0","277","825","1"
"5","2018","31","Hotel","3","4","66","163","54","104","120","267","3"
"5","2018","31","Hotel","9","26","79","182","6","8","85","190","1"
"5","2018","31","Hotel","8","34","433","584","91","172","524","756","1"
"5","2018","31","Hotel","7","17","228","344","67","103","295","447","4"
"5","2018","31","Hotel","4","13","322","673","14","22","336","695","3.2"
"5","2018","31","Hotel","12","35","18","72","72","257","90","329","1"
"5","2018","31","Hotel","16","40","1011","2190","236","414","1247","2604","1"
"5","2018","31","Hotel","9","26","393","652","54","211","447","863","1"
"5","2018","31","","6","27","137","263","15","71","152","334","1"
"5","2018","31","Hotel","9","26","124","181","3","5","127","186","1"
"5","2018","31","Hotel","4","13","111","153","8","8","119","161","3.2"
"5","2018","31","Hotel","6","28","274","274","8","8","282","282","1"
"5","2018","31","","2","29","126","365","452","1454","578","1819","1"
"5","2018","31","Hotel","13","33","1239","1555","68","148","1307","1703","1"
"5","2018","31","Hotel","8","3","368","722","74","163","442","885","1"
"5","2018","31","Hotel","14","27","1624","2354","1133","1344","2757","3698","1"
"5","2018","31","Hotel","16","40","221","401","0","0","221","401","5.6666666666667"
"5","2018","31","Hotel","12","24","208","289","205","518","413","807","1"
"5","2018","31","Hotel","10","18","834","1426","107","196","941","1622","3.2"
"5","2018","31","Otros","15","16","106","106","10","10","116","116","9"
"5","2018","31","Hotel","6","10","465","501","0","0","465","501","1"
"5","2018","31","Hotel","10","11","617","982","66","484","683","1466","1"
"5","2018","31","Otros","6","10","26","62","0","0","26","62","3.8518518518518"
"5","2018","31","Otros","10","23","74","157","0","0","74","157","1"
"5","2018","31","Hotel","10","23","357","576","317","733","674","1309","2.8"
"5","2018","31","Hotel","6","12","308","542","7","14","315","556","5"
"5","2018","31","Hotel","6","27","92","160","2","2","94","162","3"
"5","2018","31","Hotel","10","23","656","1035","240","431","896","1466","2.8"
"5","2018","31","","4","39","204","404","0","0","204","404","1"
"5","2018","31","Hotel","8","34","436","663","136","208","572","871","1"
"5","2018","31","Hotel","8","34","343","533","41","67","384","600","1"
"5","2018","31","Otros","4","39","40","78","0","0","40","78","2.2222222222222"
"5","2018","31","Otros","13","14","160","320","0","0","160","320","1"
"5","2018","31","Hotel","10","23","178","253","23","40","201","293","2.8"
"5","2018","31","Otros","13","14","294","974","0","0","294","974","1"
"5","2018","31","Hotel","12","24","125","236","175","343","300","579","1"
"5","2018","31","","6","25","70","136","0","0","70","136","1"
"5","2018","31","Hotel","15","27","503","811","13","30","516","841","1"
"5","2018","0","Hotel","12","35","0","0","0","0","0","0","1"
"5","2018","31","Hotel","16","40","108","120","115","180","223","300","1"
"5","2018","31","Hotel","16","27","68","135","14","17","82","152","1"
"5","2018","31","Hotel","9","30","129","439","0","0","129","439","1"
"5","2018","31","Hotel","4","13","408","802","27","69","435","871","3.2"
"5","2018","31","Hotel","2","29","207","650","277","801","484","1451","1"
"5","2018","31","Hotel","16","20","196","256","24","42","220","298","1"
"5","2018","31","Hotel","5","5","714","835","34","56","748","891","1"
"5","2018","31","Hotel","13","33","616","974","66","132","682","1106","1"
"5","2018","31","Otros","16","19","101","168","0","0","101","168","1.3333333333333"
"5","2018","31","Hotel","12","24","169","410","186","428","355","838","1"
"5","2018","31","","8","2","449","848","12","22","461","870","1"
"5","2018","31","Hotel","12","35","13","101","46","310","59","411","1"
"5","2018","31","Hotel","16","27","86","117","193","220","279","337","2.5"
"5","2018","31","Otros","16","27","277","450","7","16","284","466","2"
"5","2018","31","Hotel","8","34","345","512","73","132","418","644","1"
"5","2018","31","Otros","8","3","24","66","0","0","24","66","1"
"5","2018","31","Hotel","7","27","234","367","153","444","387","811","1"
"5","2018","31","Hotel","4","39","206","337","87","322","293","659","1"
"5","2018","31","Hotel","15","16","266","423","27","48","293","471","4"
"5","2018","31","Hotel","4","39","31","33","0","0","31","33","1"
"5","2018","31","Hotel","4","39","243","604","2","3","245","607","1"
"5","2018","31","Hotel","15","16","275","1240","25","75","300","1315","4"
"5","2018","31","Hotel","14","31","45","88","129","430","174","518","17.4"
"5","2018","31","Hotel","8","34","314","522","106","159","420","681","1"
"5","2018","31","Hotel","6","28","254","346","20","35","274","381","1"
"5","2018","31","Hotel","7","17","673","1047","40","115","713","1162","4"
"5","2018","31","Otros","7","27","4","8","0","0","4","8","1"
"5","2018","31","Hotel","11","36","1319","1463","35","97","1354","1560","1"
"5","2018","31","Otros","4","21","275","531","29","52","304","583","1"
"5","2018","31","Otros","15","16","106","106","33","33","139","139","2"
"5","2018","31","Otros","7","17","136","357","0","0","136","357","3"
"5","2018","31","Hotel","7","38","35","41","40","240","75","281","1"
"5","2018","31","Hotel","16","27","605","654","23","53","628","707","2.5"
"5","2018","31","Hotel","2","6","21","37","0","0","21","37","2.2"
"5","2018","31","Hotel","11","36","248","498","20","56","268","554","1"
"5","2018","31","Hotel","6","28","10","12","1","2","11","14","1"
"5","2018","31","Hotel","6","12","189","381","0","0","189","381","5"
"5","2018","31","Otros","9","22","50","80","0","0","50","80","1"
"5","2018","31","","13","14","177","259","0","0","177","259","2"
"5","2018","31","Hotel","2","29","69","120","398","631","467","751","1"
"5","2018","31","Hotel","2","29","47","151","36","102","83","253","1"
"5","2018","31","Otros","4","13","398","424","13","13","411","437","1"
"5","2018","31","Hotel","15","16","83","198","28","77","111","275","4"
"5","2018","31","Hotel","2","1","185","417","4","10","189","427","6.4"
"5","2018","31","Otros","7","27","83","134","0","0","83","134","1"
"5","2018","31","Otros","13","33","10","18","0","0","10","18","5.125"
"5","2018","31","","4","21","207","380","1","1","208","381","1"
"5","2018","31","Hotel","6","10","348","348","3","3","351","351","1"
"5","2018","31","Hotel","11","36","105","222","4","12","109","234","1"
"5","2018","31","Otros","14","31","450","450","0","0","450","450","2.8"
"5","2018","31","Hotel","7","27","189","406","22","27","211","433","1"
"5","2018","31","Otros","6","10","52","234","0","0","52","234","3.8518518518518"
"5","2018","31","Hotel","4","39","7","9","4","4","11","13","2.6"
"5","2018","16","Otros","8","2","34","67","29","65","63","132","6.4285714285714"
"5","2018","31","Otros","11","36","38","46","2","4","40","50","5.1904761904762"
"5","2018","31","Hotel","13","33","162","162","15","15","177","177","1"
"5","2018","31","","3","4","96","177","68","106","164","283","1"
"5","2018","31","Hotel","7","17","251","659","44","112","295","771","4"
"5","2018","31","Hotel","8","2","186","268","13","13","199","281","1"
"5","2018","31","Otros","15","16","150","230","36","56","186","286","2"
"5","2018","31","Hotel","10","11","344","366","0","0","344","366","1"
"5","2018","31","Hotel","16","19","59","100","0","0","59","100","1"
"5","2018","31","Hotel","10","23","82","122","30","42","112","164","4"
"5","2018","31","","7","38","329","399","14","24","343","423","1"
"5","2018","31","Hotel","7","27","291","670","4","52","295","722","1"
"5","2018","31","Hotel","11","36","339","627","38","69","377","696","1"
"5","2018","31","Hotel","16","40","158","243","8","16","166","259","16.333333333333"
"5","2018","31","Hotel","16","19","27","33","0","0","27","33","1"
"5","2018","31","Hotel","16","19","0","0","0","0","0","0","1"
"5","2018","0","Hotel","16","20","0","0","0","0","0","0","1"
"5","2018","31","Hotel","10","11","253","425","11","42","264","467","1"
"5","2018","31","Otros","7","27","53","137","0","0","53","137","4.8333333333333"
"5","2018","31","Otros","7","27","40","108","0","0","40","108","1"
"5","2018","31","Hotel","7","27","51","65","0","0","51","65","4.1666666666667"
"5","2018","31","Otros","13","14","60","96","0","0","60","96","1"
"5","2018","31","Otros","11","15","51","51","0","0","51","51","2.3571428571429"
"5","2018","31","Otros","10","27","35","248","10","67","45","315","4.84"
"5","2018","31","Otros","14","31","2360","2360","110","110","2470","2470","2.8"
"5","2018","31","Otros","11","36","11","14","0","0","11","14","5.1904761904762"
"5","2018","31","Hotel","16","19","28","35","0","0","28","35","1"
"5","2018","31","","14","27","180","268","0","0","180","268","2.6666666666667"
"5","2018","31","Hotel","16","40","50","52","1","1","51","53","5.6666666666667"
"5","2018","31","Hotel","10","27","13","33","0","0","13","33","2.25"
"5","2018","31","Otros","2","29","129","295","128","311","257","606","3.28"
"5","2018","31","Hotel","13","27","5","10","10","20","15","30","1"
"5","2018","31","Otros","9","22","27","27","0","0","27","27","1"
"5","2018","31","Hotel","2","27","114","154","30","30","144","184","1"
"5","2018","31","Hotel","8","34","273","352","54","140","327","492","1"
"5","2018","31","Hotel","7","27","361","495","37","100","398","595","1"
"5","2018","31","Hotel","15","16","205","390","16","44","221","434","4"
"5","2018","31","Hotel","16","20","51","73","0","0","51","73","1"
"5","2018","31","Otros","4","13","100","259","0","0","100","259","1"
"5","2018","31","Hotel","2","1","246","729","0","0","246","729","6.4"
"5","2018","31","Otros","11","32","40","101","0","0","40","101","2.2857142857143"
"5","2018","31","Hotel","2","29","58","182","280","1108","338","1290","1"
"5","2018","31","Hotel","16","27","170","181","62","80","232","261","2.5"
"5","2018","31","Hotel","10","18","20","20","0","0","20","20","3.2"
"5","2018","31","Otros","11","36","272","390","19","21","291","411","1"
"5","2018","31","Otros","13","14","27","42","0","0","27","42","1"
"5","2018","0","Hotel","7","27","0","0","0","0","0","0","1"
"5","2018","31","Otros","7","17","76","148","6","13","82","161","3"
"5","2018","31","Otros","14","31","127","186","54","133","181","319","2.8"
"5","2018","31","Hotel","2","29","372","1144","217","651","589","1795","1"
"5","2018","0","Hotel","8","3","0","0","0","0","0","0","1"
"5","2018","31","Hotel","8","34","263","404","36","90","299","494","2.5714285714286"
"5","2018","31","Hotel","8","34","241","291","60","154","301","445","2.5714285714286"
"5","2018","31","Hotel","12","35","152","181","112","165","264","346","1"
"5","2018","0","Hotel","11","32","0","0","0","0","0","0","1"
"5","2018","31","Hotel","13","33","135","196","4","4","139","200","2"
"5","2018","31","Hotel","10","23","103","168","43","81","146","249","2.8"
"5","2018","31","Hotel","12","35","54","178","3","3","57","181","1"
"5","2018","31","","16","40","293","391","19","52","312","443","3.0555555555556"
"5","2018","31","Otros","16","19","9","16","0","0","9","16","1.3333333333333"
"5","2018","31","Otros","16","20","18","72","0","0","18","72","1"
"5","2018","31","Hotel","6","12","158","300","4","12","162","312","5"
"5","2018","31","Hotel","16","19","103","134","0","0","103","134","4"
"5","2018","31","Hotel","12","24","176","313","147","228","323","541","1"
"5","2018","31","Hotel","12","24","183","321","88","135","271","456","3"
"5","2018","31","Hotel","8","3","80","500","0","0","80","500","1"
"5","2018","0","Hotel","5","9","0","0","0","0","0","0","1"
"5","2018","31","Hotel","16","27","187","224","9","10","196","234","2.5"
"5","2018","31","Otros","10","23","45","45","0","0","45","45","7"
"5","2018","31","Otros","13","14","54","76","0","0","54","76","7.3846153846154"
"5","2018","31","Otros","2","6","55","75","6","6","61","81","1"
"5","2018","25","Hotel","15","16","7","9","31","38","38","47","7.8"
"5","2018","31","Hotel","8","3","107","556","0","0","107","556","1"
"5","2018","31","Hotel","8","34","273","361","34","48","307","409","1"
"5","2018","31","Hotel","8","3","48","80","14","26","62","106","1"
"5","2018","31","","2","29","111","314","77","250","188","564","1"
"5","2018","31","Hotel","2","1","413","539","13","19","426","558","6.4"
"5","2018","31","Hotel","7","17","73","126","3","8","76","134","4"
"5","2018","31","Otros","7","17","170","374","0","0","170","374","3"
"5","2018","31","Hotel","16","40","95","141","10","18","105","159","5.6666666666667"
"5","2018","31","Hotel","12","24","215","503","123","165","338","668","1"
"5","2018","31","Hotel","14","31","141","372","260","1099","401","1471","17.4"
"5","2018","0","Hotel","9","26","0","0","0","0","0","0","1"
"5","2018","31","Hotel","6","12","21","21","0","0","21","21","5"
"5","2018","31","Otros","5","9","8","12","0","0","8","12","4.0454545454545"
"5","2018","31","Otros","5","9","1","2","0","0","1","2","4.0454545454545"
"5","2018","31","Otros","15","27","59","73","0","0","59","73","1.4222222222222"
"5","2018","31","Hotel","8","34","15","15","4","4","19","19","2.5714285714286"
"5","2018","31","Hotel","10","18","328","635","73","153","401","788","7.75"
"5","2018","31","Hotel","15","16","289","551","52","97","341","648","7.8"
"5","2018","31","Hotel","2","29","97","270","281","857","378","1127","1"
"5","2018","31","Hotel","4","39","81","124","8","11","89","135","2.6"
"5","2018","31","Otros","4","39","105","105","0","0","105","105","2.2222222222222"
"5","2018","31","Hotel","4","13","117","179","11","11","128","190","5.4"
"5","2018","31","Otros","10","23","40","40","3","3","43","43","7"
"5","2018","31","Otros","14","31","92","156","132","347","224","503","20.2"
"5","2018","31","Hotel","3","4","63","84","0","0","63","84","2.6"
"5","2018","31","Hotel","10","23","106","286","30","77","136","363","4"
"5","2018","31","Otros","9","22","212","863","0","0","212","863","1"
"5","2018","31","Hotel","12","24","221","492","117","218","338","710","3"
"5","2018","31","Hotel","13","14","25","39","1","2","26","41","1"
"5","2018","31","Hotel","12","35","73","107","35","41","108","148","1.7272727272727"
"5","2018","31","Hotel","6","28","370","575","0","0","370","575","1"
"5","2018","31","","6","28","73","441","0","0","73","441","1"
"5","2018","31","Hotel","12","24","277","589","121","326","398","915","3"
"5","2018","31","Otros","5","9","5","5","5","5","10","10","4.0454545454545"
"5","2018","31","Hotel","16","20","65","106","0","0","65","106","1"
"5","2018","31","Hotel","4","21","118","164","20","24","138","188","3"
"5","2018","31","Otros","10","11","26","35","0","0","26","35","11.764705882353"
"5","2018","31","Otros","13","14","15","15","0","0","15","15","7.3846153846154"
"5","2018","31","Otros","16","27","10","10","0","0","10","10","13.818181818182"
"5","2018","16","Hotel","9","26","372","372","0","0","372","372","1"
"5","2018","31","Hotel","16","27","402","418","177","194","579","612","2.5"
"5","2018","31","Hotel","3","4","1106","2121","54","142","1160","2263","3"
"5","2018","31","Otros","16","27","50","150","0","0","50","150","2"
"5","2018","31","Otros","16","19","355","525","0","0","355","525","1.3333333333333"
"5","2018","31","Hotel","6","12","560","807","4","4","564","811","5"
"5","2018","31","Hotel","2","1","307","461","5","5","312","466","6.4"
"5","2018","31","Hotel","10","11","382","604","28","45","410","649","1"
"5","2018","31","Otros","10","23","58","58","0","0","58","58","1"
"5","2018","31","Otros","10","27","436","494","18","22","454","516","4.84"
"5","2018","31","Hotel","16","27","223","336","25","213","248","549","2.5"
"5","2018","31","Hotel","6","28","163","235","8","8","171","243","1"
"5","2018","31","Hotel","4","13","50","170","13","51","63","221","5.4"
"5","2018","31","Hotel","14","27","610","783","30","38","640","821","8.5"
"5","2018","31","Hotel","10","27","95","140","99","118","194","258","1"
"5","2018","31","Hotel","13","27","194","301","46","114","240","415","4.2"
"5","2018","31","Hotel","3","4","574","796","10","20","584","816","3"
"5","2018","31","Otros","4","13","105","196","5","5","110","201","3.4"
"5","2018","31","Otros","11","15","11","16","0","0","11","16","2.3571428571429"
"5","2018","31","Otros","6","10","166","294","0","0","166","294","3.8518518518518"
"5","2018","31","Otros","2","1","73","87","0","0","73","87","1"
"5","2018","31","","6","12","30","103","0","0","30","103","1"
"5","2018","31","Otros","10","23","175","887","10","34","185","921","1"
"5","2018","31","Hotel","16","19","51","57","0","0","51","57","4"
"5","2018","31","Hotel","10","11","9","54","0","0","9","54","5.6666666666667"
"5","2018","31","Hotel","10","23","22","23","2","2","24","25","4"
"5","2018","31","Otros","14","31","29","73","185","453","214","526","2.8"
"5","2018","31","Otros","13","27","1","1","0","0","1","1","12.2"
"5","2018","31","Hotel","2","1","249","652","0","0","249","652","6.4"
"5","2018","8","Hotel","16","19","36","36","0","0","36","36","4"
"5","2018","31","Otros","12","35","31","31","3","3","34","34","3.5"
"5","2018","31","Otros","15","16","68","252","18","63","86","315","2"
"5","2018","31","Otros","9","22","145","290","0","0","145","290","1"
"5","2018","31","Hotel","10","27","252","379","227","266","479","645","1"
"5","2018","31","Hotel","2","27","62","108","1","1","63","109","3.6"
"5","2018","31","Hotel","16","20","33","161","10","23","43","184","1"
"5","2018","31","Hotel","10","18","0","0","5","9","5","9","7.75"
"5","2018","31","Hotel","6","12","261","267","0","0","261","267","5"
"5","2018","31","Hotel","2","27","76","172","0","0","76","172","3.6"
"5","2018","31","Hotel","15","16","99","168","23","61","122","229","7.8"
"5","2018","31","Hotel","10","23","65","65","32","32","97","97","4"
"5","2018","31","Hotel","11","32","36","44","1","1","37","45","1"
"5","2018","31","Hotel","14","27","98","244","24","95","122","339","8.5"
"5","2018","31","Otros","10","11","38","58","0","0","38","58","11.764705882353"
"5","2018","31","Hotel","2","27","37","51","7","10","44","61","3.6"
"5","2018","31","Otros","13","14","114","236","5","10","119","246","7.3846153846154"
"5","2018","31","Hotel","2","1","125","233","5","8","130","241","6.4"
"5","2018","31","Otros","7","17","201","405","0","0","201","405","17.166666666667"
"5","2018","31","Otros","10","23","30","108","8","24","38","132","7"
"5","2018","31","Hotel","13","27","240","240","7","7","247","247","2.75"
"5","2018","31","Otros","10","18","15","30","18","22","33","52","10.25"
"5","2018","31","Otros","5","9","23","194","0","0","23","194","4.0454545454545"
"5","2018","31","Hotel","4","39","66","204","28","218","94","422","2.6"
"5","2018","31","Otros","16","27","37","136","0","0","37","136","13.818181818182"
"5","2018","31","Hotel","14","27","31","33","32","72","63","105","8.5"
"5","2018","31","Hotel","10","11","160","274","11","12","171","286","5.6666666666667"
"5","2018","31","Hotel","10","18","127","241","32","63","159","304","7.75"
"5","2018","31","Otros","14","31","173","234","102","180","275","414","20.2"
"5","2018","31","Otros","11","32","21","38","0","0","21","38","2.2857142857143"
"5","2018","31","Otros","5","5","15","29","12","31","27","60","3.65625"
"5","2018","31","Otros","6","25","10","20","0","0","10","20","2.3846153846154"
"5","2018","31","Hotel","3","4","48","160","3","12","51","172","2.6"
"5","2018","31","Otros","7","27","74","126","1","1","75","127","4.8333333333333"
"5","2018","31","Otros","2","29","65","146","109","217","174","363","3.28"
"5","2018","31","Hotel","2","29","84","194","177","591","261","785","1"
"5","2018","31","Otros","4","21","87","322","0","0","87","322","1"
"5","2018","31","Hotel","7","27","243","299","0","0","243","299","4.1666666666667"
"5","2018","31","Otros","5","5","14","46","0","0","14","46","3.65625"
"5","2018","31","Otros","11","36","25","45","6","6","31","51","5.1904761904762"
"5","2018","31","Hotel","7","27","315","315","0","0","315","315","4.1666666666667"
"5","2018","31","Hotel","16","20","4","8","0","0","4","8","1"
"5","2018","31","Hotel","12","24","239","321","38","72","277","393","3"
"5","2018","31","Hotel","9","26","95","120","6","8","101","128","1.5"
"5","2018","31","Hotel","7","17","182","697","2","6","184","703","10"
"5","2018","31","Hotel","9","37","211","272","39","62","250","334","3.4"
"5","2018","31","Hotel","5","5","224","376","15","15","239","391","2.1428571428571"
"5","2018","31","Otros","6","27","74","148","3","6","77","154","3.960088691796"
"5","2018","31","Hotel","9","37","50","88","3","6","53","94","3.4"
"5","2018","31","Otros","10","27","24","24","75","80","99","104","4.84"
"5","2018","31","Otros","8","3","126","207","7","9","133","216","10"
"5","2018","31","Otros","16","20","9","9","0","0","9","9","3.0769230769231"
"5","2018","31","Otros","9","22","16","18","0","0","16","18","7.6428571428571"
"5","2018","31","Otros","10","27","199","243","26","26","225","269","4.84"
"5","2018","31","Otros","10","23","2","36","0","0","2","36","7"
"5","2018","31","Otros","2","6","383","383","82","82","465","465","1"
"5","2018","31","Otros","4","39","26","79","0","0","26","79","2.2222222222222"
"5","2018","31","Hotel","2","27","75","77","19","25","94","102","1"
"5","2018","31","Hotel","14","31","75","215","103","619","178","834","24"
"5","2018","31","Otros","2","29","99","260","100","282","199","542","3.28"
"5","2018","31","Otros","8","3","352","1760","0","0","352","1760","10"
"5","2018","31","","13","14","8","16","4","8","12","24","1"
"5","2018","31","Hotel","6","10","133","168","5","5","138","173","6.6"
"5","2018","31","Hotel","8","34","74","78","28","37","102","115","2.5714285714286"
"5","2018","31","Hotel","9","22","330","1802","0","0","330","1802","2.5555555555556"
"5","2018","31","Hotel","2","6","94","208","41","54","135","262","2.2"
"5","2018","31","Hotel","10","27","93","189","89","113","182","302","2.25"
"5","2018","31","Otros","14","27","140","140","0","0","140","140","11.833333333333"
"5","2018","31","Otros","6","12","291","451","11","45","302","496","1.8256578947368"
"5","2018","31","Hotel","6","27","140","192","0","0","140","192","3"
"5","2018","31","Hotel","5","5","21","141","4","5","25","146","2.1428571428571"
"5","2018","31","Hotel","5","5","72","140","0","0","72","140","2.1428571428571"
"5","2018","31","Hotel","13","27","323","323","0","0","323","323","4.2"
"5","2018","31","Hotel","2","27","124","180","2","4","126","184","3.6"
"5","2018","31","Hotel","8","3","33","33","28","28","61","61","4.1111111111111"
"5","2018","31","Otros","11","36","53","106","0","0","53","106","5.1904761904762"
"5","2018","31","Otros","9","30","14","14","0","0","14","14","2.3333333333333"
"5","2018","31","Otros","16","19","10","12","0","0","10","12","10.263157894737"
"5","2018","31","Hotel","14","31","84","129","254","731","338","860","17.4"
"5","2018","31","Hotel","2","1","303","377","7","8","310","385","6.4"
"5","2018","31","Hotel","16","40","691","1287","248","350","939","1637","5.6666666666667"
"5","2018","31","Otros","7","17","186","352","20","120","206","472","17.166666666667"
"5","2018","31","Hotel","13","27","237","296","55","73","292","369","2.75"
"5","2018","31","Hotel","14","31","230","256","273","530","503","786","24"
"5","2018","31","Otros","3","4","26","79","4","6","30","85","12.2"
"5","2018","31","Otros","8","34","210","299","130","181","340","480","5.75"
"5","2018","31","Hotel","9","22","85","100","5","5","90","105","2.5555555555556"
"5","2018","31","Hotel","4","21","54","117","6","9","60","126","3"
"5","2018","31","Hotel","6","27","85","116","0","0","85","116","3"
"5","2018","31","Hotel","12","35","140","202","62","103","202","305","1.7272727272727"
"5","2018","31","Hotel","2","29","22","57","64","118","86","175","2"
"5","2018","31","Otros","10","11","45","64","5","7","50","71","11.764705882353"
"5","2018","31","Hotel","6","10","12","22","0","0","12","22","6.6"
"5","2018","10","Hotel","13","14","8","16","0","0","8","16","2"
"5","2018","10","Otros","16","27","58","92","0","0","58","92","13.818181818182"
"5","2018","31","Otros","6","27","7","10","0","0","7","10","3.960088691796"
"5","2018","31","Hotel","16","40","71","115","95","188","166","303","5.6666666666667"
"5","2018","31","Otros","6","10","96","166","0","0","96","166","3.8518518518518"
"5","2018","31","Otros","10","23","27","34","7","7","34","41","7"
"5","2018","31","Hotel","6","28","294","358","4","4","298","362","1"
"5","2018","31","Otros","7","38","265","559","95","169","360","728","2.75"
"5","2018","31","Hotel","6","12","164","259","4","10","168","269","5"
"5","2018","31","Hotel","13","27","202","304","2","2","204","306","4.2"
"5","2018","31","Otros","4","21","4","10","0","0","4","10","4.8333333333333"
"5","2018","30","Hotel","16","27","80","167","5","5","85","172","5.8571428571429"
"5","2018","31","Hotel","5","5","53","138","2","3","55","141","2.1428571428571"
"5","2018","31","Otros","12","24","63","97","36","53","99","150","9.2"
"5","2018","31","Otros","15","16","52","90","10","16","62","106","9"
"5","2018","31","Hotel","8","27","140","176","0","0","140","176","4.5"
"5","2018","31","Hotel","9","22","11","26","0","0","11","26","2.5555555555556"
"5","2018","31","Hotel","10","11","89","156","7","14","96","170","5.6666666666667"
"5","2018","31","Hotel","8","3","44","60","19","39","63","99","4.1111111111111"
"5","2018","31","Hotel","6","10","217","331","0","0","217","331","6.6"
"5","2018","31","Otros","9","26","54","464","5","36","59","500","3.8888888888889"
"5","2018","31","Hotel","4","39","76","163","9","123","85","286","2.6"
"5","2018","31","Otros","6","27","4","80","0","0","4","80","3.960088691796"
"5","2018","31","Otros","6","12","131","197","0","0","131","197","1.8256578947368"
"5","2018","31","Hotel","6","27","113","228","2","3","115","231","3"
"5","2018","31","Otros","5","9","45","75","7","13","52","88","4.0454545454545"
"5","2018","31","Hotel","2","27","101","101","8","8","109","109","3.6"
"5","2018","31","Hotel","2","29","70","223","133","400","203","623","1"
"5","2018","31","Hotel","4","13","183","329","0","0","183","329","5.4"
"5","2018","31","","11","15","10","19","0","0","10","19","1"
"5","2018","31","Hotel","6","10","303","340","11","15","314","355","6.6"
"5","2018","31","Otros","6","12","24","72","0","0","24","72","1.8256578947368"
"5","2018","31","Otros","10","18","49","49","0","0","49","49","10.25"
"5","2018","31","Otros","9","22","106","195","0","0","106","195","7.6428571428571"
"5","2018","31","","14","27","158","229","27","42","185","271","1"
"5","2018","31","Hotel","16","27","77","144","2","2","79","146","5.8571428571429"
"5","2018","31","Otros","2","29","6","18","4","4","10","22","3.28"
"5","2018","31","Otros","13","33","36","50","0","0","36","50","5.125"
"5","2018","31","Otros","13","33","0","0","10","10","10","10","5.125"
"5","2018","31","Otros","6","10","72","656","0","0","72","656","3.8518518518518"
"5","2018","31","Hotel","10","18","67","108","13","22","80","130","7.75"
"5","2018","31","Hotel","14","31","73","125","15","40","88","165","24"
"5","2018","31","Hotel","4","21","72","72","3","3","75","75","3"
"5","2018","31","Hotel","3","4","68","341","0","0","68","341","2.6"
"5","2018","0","Otros","8","27","0","0","0","0","0","0","1"
"5","2018","31","Otros","6","27","6","18","0","0","6","18","3.960088691796"
"5","2018","31","Hotel","6","25","146","212","1","1","147","213","1"
"5","2018","31","Otros","6","12","209","512","0","0","209","512","1.8256578947368"
"5","2018","31","Hotel","6","27","23","40","0","0","23","40","3"
"5","2018","31","Otros","6","27","1","2","0","0","1","2","3.960088691796"
"5","2018","31","Otros","6","10","78","150","0","0","78","150","3.8518518518518"
"5","2018","31","Otros","6","12","83","219","0","0","83","219","1.8256578947368"
"5","2018","31","Otros","5","5","6","10","0","0","6","10","3.65625"
"5","2018","31","Hotel","12","24","49","165","7","15","56","180","3"
"5","2018","31","Hotel","15","16","63","162","2","6","65","168","7.8"
"5","2018","31","Otros","4","13","89","104","0","0","89","104","3.4"
"5","2018","31","Hotel","2","29","105","309","31","88","136","397","1"
"5","2018","31","Hotel","4","21","22","46","4","6","26","52","3"
"5","2018","31","Hotel","10","27","143","271","111","123","254","394","2.25"
"5","2018","31","Hotel","8","3","114","193","25","62","139","255","4.1111111111111"
"5","2018","31","Hotel","12","27","62","94","6","8","68","102","1"
"5","2018","31","Otros","5","5","210","419","10","22","220","441","3.65625"
"5","2018","31","Otros","13","14","6","6","0","0","6","6","7.3846153846154"
"5","2018","31","Otros","10","11","161","206","9","9","170","215","11.764705882353"
"5","2018","31","Otros","16","40","67","110","1","4","68","114","28.142857142857"
"5","2018","31","Hotel","11","36","66","182","4","16","70","198","1"
"5","2018","31","Otros","8","34","49","67","32","53","81","120","5.75"
"5","2018","31","Hotel","7","17","66","115","8","8","74","123","10"
"5","2018","31","Otros","12","35","175","285","2","2","177","287","3.5"
"5","2018","31","Otros","5","9","15","41","0","0","15","41","4.0454545454545"
"5","2018","31","Hotel","9","22","39","46","2","2","41","48","2.5555555555556"
"5","2018","31","Otros","2","29","37","78","72","99","109","177","3.28"
"5","2018","31","Otros","2","29","96","96","110","110","206","206","3.28"
"5","2018","31","Hotel","10","27","61","118","37","37","98","155","2.25"
"5","2018","31","Hotel","16","19","39","63","1","2","40","65","4"
"5","2018","31","Hotel","16","40","105","208","8","16","113","224","16.333333333333"
"5","2018","31","Hotel","8","27","200","316","19","28","219","344","4.5"
"5","2018","31","Otros","13","14","25","25","0","0","25","25","7.3846153846154"
"5","2018","31","Hotel","7","27","25","33","0","0","25","33","4.1666666666667"
"5","2018","31","Otros","2","6","36","279","0","0","36","279","5"
"5","2018","31","Hotel","7","17","248","428","5","15","253","443","10"
"5","2018","31","Hotel","3","4","103","185","31","96","134","281","2.6"
"5","2018","31","Otros","6","12","14","128","0","0","14","128","1.8256578947368"
"5","2018","31","Otros","6","10","4","4","0","0","4","4","3.8518518518518"
"5","2018","31","Hotel","16","40","25","51","1","3","26","54","16.333333333333"
"5","2018","31","Otros","4","39","38","65","0","0","38","65","2.2222222222222"
"5","2018","31","Otros","13","14","42","74","0","0","42","74","7.3846153846154"
"5","2018","31","Otros","7","38","27","36","0","0","27","36","2.75"
"5","2018","31","Hotel","11","32","190","295","3","7","193","302","1"
"5","2018","30","Otros","11","36","115","236","3","4","118","240","5.1904761904762"
"5","2018","31","Hotel","4","21","33","59","7","10","40","69","3"
"5","2018","31","Otros","3","4","0","0","4","10","4","10","12.2"
"5","2018","31","Otros","5","9","22","43","32","55","54","98","4.0454545454545"
"5","2018","31","Hotel","8","27","57","199","2","32","59","231","4.5"
"5","2018","31","","7","17","112","214","0","0","112","214","1"
"5","2018","31","Otros","16","20","28","48","0","0","28","48","3.0769230769231"
"5","2018","31","Otros","4","21","23","36","1","1","24","37","4.8333333333333"
"5","2018","31","Otros","13","33","72","77","9","12","81","89","5.125"
"5","2018","0","","12","35","0","0","0","0","0","0","1"
"5","2018","31","Hotel","13","33","0","0","1","1","1","1","2"
"5","2018","31","Otros","4","39","12","24","3","3","15","27","2.2222222222222"
"5","2018","31","Otros","10","18","10","35","0","0","10","35","10.25"
"5","2018","31","Otros","6","27","72","95","0","0","72","95","3.960088691796"
"5","2018","31","Hotel","4","39","59","248","0","0","59","248","2.6"
"5","2018","31","Otros","14","31","96","137","63","265","159","402","20.2"
"5","2018","31","Hotel","2","29","44","123","198","321","242","444","2"
"5","2018","31","Hotel","9","26","115","174","1","3","116","177","1.5"
"5","2018","31","Otros","12","35","4","5","0","0","4","5","3.5"
"5","2018","31","Hotel","14","27","113","137","24","31","137","168","8.5"
"5","2018","31","Otros","11","36","37","190","0","0","37","190","5.1904761904762"
"5","2018","31","Otros","16","20","148","293","4","8","152","301","3.0769230769231"
"5","2018","31","Otros","4","39","2","10","0","0","2","10","2.2222222222222"
"5","2018","31","Otros","7","27","92","97","1","1","93","98","4.8333333333333"
"5","2018","31","Otros","6","27","83","101","0","0","83","101","3.960088691796"
"5","2018","31","Otros","5","8","15","300","0","0","15","300","5"
"5","2018","31","Otros","9","37","160","255","2","2","162","257","4.5"
"5","2018","31","Hotel","2","6","49","120","0","0","49","120","5.5"
"5","2018","31","Hotel","10","27","72","74","46","82","118","156","2.25"
"5","2018","31","Hotel","9","30","130","230","14","31","144","261","1"
"5","2018","31","Otros","4","13","122","122","0","0","122","122","3.4"
"5","2018","31","Hotel","5","5","267","267","17","17","284","284","1"
"5","2018","31","Otros","7","38","107","212","2","8","109","220","2.75"
"5","2018","31","Hotel","13","14","8","18","4","4","12","22","1"
"5","2018","31","Otros","5","9","8","15","7","11","15","26","4.0454545454545"
"5","2018","31","Otros","5","8","4","7","0","0","4","7","5"
"5","2018","31","Otros","10","27","16","496","0","0","16","496","4.84"
"5","2018","0","Hotel","13","14","0","0","0","0","0","0","1"
"5","2018","31","Otros","11","15","1","31","0","0","1","31","2.3571428571429"
"5","2018","31","Hotel","9","22","152","248","0","0","152","248","2.5555555555556"
"5","2018","31","Otros","11","36","95","195","4","6","99","201","5.1904761904762"
"5","2018","31","Hotel","10","18","1973","4037","1081","2407","3054","6444","1"
"5","2018","31","Hotel","6","12","240","389","0","0","240","389","5"
"5","2018","31","","2","29","483","1092","320","680","803","1772","1"
"5","2018","31","Hotel","16","27","2087","3571","56","118","2143","3689","1"
"5","2018","31","","14","31","303","618","144","832","447","1450","1"
"5","2018","31","Hotel","8","3","2","4","0","0","2","4","4.1111111111111"
"5","2018","31","Otros","13","33","42","42","0","0","42","42","5.125"
"5","2018","31","","14","27","50","87","0","0","50","87","2.6666666666667"
"5","2018","31","Otros","9","22","50","300","0","0","50","300","7.6428571428571"
"5","2018","31","Hotel","10","11","12","14","0","0","12","14","5.6666666666667"
"5","2018","31","Otros","6","12","14","16","0","0","14","16","1.8256578947368"
"5","2018","31","Hotel","8","3","37","44","8","10","45","54","4.1111111111111"
"5","2018","31","Otros","6","12","125","140","0","0","125","140","1.8256578947368"
"5","2018","31","Hotel","8","27","171","171","0","0","171","171","4.5"
"5","2018","31","Hotel","6","28","188","218","12","13","200","231","2.4"
"5","2018","31","Otros","6","25","19","101","0","0","19","101","2.3846153846154"
"5","2018","31","Otros","6","25","10","16","0","0","10","16","2.3846153846154"
"5","2018","31","Hotel","11","36","477","1289","0","0","477","1289","1"
"5","2018","31","Otros","2","6","22","56","155","478","177","534","5"
"5","2018","31","Hotel","14","31","36","92","41","129","77","221","24"
"5","2018","30","Otros","4","21","35","45","0","0","35","45","4.8333333333333"
"5","2018","31","Otros","7","38","11","23","0","0","11","23","2.75"
"5","2018","31","Otros","13","14","33","38","0","0","33","38","7.3846153846154"
"5","2018","31","Otros","2","29","19","28","18","26","37","54","3.28"
"5","2018","31","Otros","3","4","98","98","23","23","121","121","12.2"
"5","2018","31","Hotel","3","4","315","714","34","57","349","771","3"
"5","2018","31","Otros","7","27","129","139","8","12","137","151","1"
"5","2018","31","Otros","7","17","85","87","0","0","85","87","3"
"5","2018","31","Hotel","12","27","199","307","10","11","209","318","1"
"5","2018","31","Otros","5","5","26","47","0","0","26","47","3.65625"
"5","2018","31","Hotel","6","10","260","299","5","5","265","304","6.6"
"5","2018","31","Otros","10","18","1","1","4","4","5","5","10.25"
"5","2018","31","Otros","8","27","51","89","0","0","51","89","9.4"
"5","2018","31","Otros","8","3","4","6","0","0","4","6","10"
"5","2018","31","Hotel","16","27","60","71","4","24","64","95","5.8571428571429"
"5","2018","31","Otros","6","10","26","60","0","0","26","60","3.8518518518518"
"5","2018","31","Hotel","2","6","43","60","1","1","44","61","5.5"
"5","2018","31","Hotel","8","3","29","59","13","18","42","77","4.1111111111111"
"5","2018","31","Otros","10","11","17","25","5","8","22","33","11.764705882353"
"5","2018","31","Otros","6","27","23","72","0","0","23","72","3.960088691796"
"5","2018","31","Otros","15","16","5","5","0","0","5","5","9"
"5","2018","31","Otros","5","5","4","4","10","14","14","18","3.65625"
"5","2018","31","Otros","10","27","36","70","18","18","54","88","4.84"
"5","2018","31","Hotel","7","38","29","33","1","1","30","34","1"
"5","2018","31","Hotel","13","27","2","34","0","0","2","34","4.2"
"5","2018","31","Hotel","16","20","35","46","0","0","35","46","1"
"5","2018","31","Otros","10","27","53","76","0","0","53","76","4.84"
"5","2018","31","Hotel","3","7","36","56","1","4","37","60","1"
"5","2018","31","Otros","2","29","70","148","4","8","74","156","3.28"
"5","2018","31","Otros","10","18","4","6","0","0","4","6","10.25"
"5","2018","31","Otros","9","22","200","376","0","0","200","376","7.6428571428571"
"5","2018","31","Otros","15","27","41","41","0","0","41","41","1.4222222222222"
"5","2018","31","Otros","11","36","5","12","1","2","6","14","5.1904761904762"
"5","2018","31","Otros","5","5","4","4","0","0","4","4","3.65625"
"5","2018","31","Otros","2","29","18","39","21","58","39","97","3.28"
"5","2018","31","Hotel","9","22","324","324","12","12","336","336","2.5555555555556"
"5","2018","31","Otros","11","32","8","16","0","0","8","16","2.2857142857143"
"5","2018","31","Hotel","10","27","257","430","51","77","308","507","1"
"5","2018","31","Otros","16","27","40","70","0","0","40","70","2"
"5","2018","31","Hotel","16","20","15","29","0","0","15","29","1"
"5","2018","31","Otros","11","15","32","90","0","0","32","90","2.3571428571429"
"5","2018","31","Otros","7","17","140","687","0","0","140","687","3"
"5","2018","31","Otros","5","8","9","12","0","0","9","12","5"
"5","2018","31","Hotel","13","33","74","124","8","16","82","140","2"
"5","2018","31","Otros","5","9","35","65","7","16","42","81","4.0454545454545"
"5","2018","31","Otros","10","27","103","156","22","26","125","182","4.84"
"5","2018","31","Otros","9","22","18","36","0","0","18","36","7.6428571428571"
"5","2018","31","Otros","16","40","87","158","0","0","87","158","28.142857142857"
"5","2018","31","Hotel","16","40","70","84","14","16","84","100","1"
"5","2018","31","Otros","15","16","2","6","0","0","2","6","9"
"5","2018","31","Hotel","8","2","13","17","2","2","15","19","3"
"5","2018","31","Otros","8","3","3","3","0","0","3","3","10"
"5","2018","31","Otros","7","17","38","48","0","0","38","48","17.166666666667"
"5","2018","31","Otros","16","20","60","66","0","0","60","66","3.0769230769231"
"5","2018","31","Otros","6","27","15","33","0","0","15","33","3.960088691796"
"5","2018","31","Otros","12","35","80","128","42","84","122","212","3.5"
"5","2018","31","Otros","6","28","139","549","5","5","144","554","4.65"
"5","2018","31","Otros","6","28","350","1198","15","26","365","1224","4.65"
"5","2018","31","Hotel","8","34","93","204","42","82","135","286","2.5714285714286"
"5","2018","31","Hotel","16","20","880","1268","15","15","895","1283","1"
"5","2018","31","Hotel","2","6","462","862","0","0","462","862","2.2"
"5","2018","31","Hotel","7","27","50","775","0","0","50","775","4.1666666666667"
"5","2018","31","Hotel","10","23","12","52","0","0","12","52","4"
"5","2018","31","Hotel","9","26","54","68","5","8","59","76","1.5"
"5","2018","31","Otros","8","27","37","63","0","0","37","63","9.4"
"5","2018","31","Otros","10","27","9","12","2","2","11","14","4.84"
"5","2018","31","Otros","11","15","1","1","0","0","1","1","2.3571428571429"
"5","2018","31","Otros","16","20","18","28","0","0","18","28","3.0769230769231"
"5","2018","31","Otros","11","32","80","126","0","0","80","126","1"
"5","2018","31","Otros","16","27","23","23","0","0","23","23","13.818181818182"
"5","2018","31","Otros","9","37","120","120","0","0","120","120","4.5"
"5","2018","31","Hotel","2","29","12","32","13","46","25","78","2"
"5","2018","31","Hotel","2","1","209","733","0","0","209","733","6.4"
"5","2018","31","Otros","5","8","3","4","0","0","3","4","5"
"5","2018","31","Otros","9","37","35","99","15","17","50","116","4.5"
"5","2018","31","Otros","7","38","132","229","0","0","132","229","2.75"
"5","2018","31","Otros","11","32","24","35","0","0","24","35","1"
"5","2018","31","Otros","4","39","64","118","6","90","70","208","2.2222222222222"
"5","2018","31","Hotel","11","36","39","78","14","24","53","102","2.375"
"5","2018","31","Otros","10","23","6","20","0","0","6","20","7"
"5","2018","31","Hotel","15","16","460","981","100","304","560","1285","2"
"5","2018","31","Otros","2","29","25","60","111","196","136","256","3.28"
"5","2018","31","Hotel","6","12","900","1160","42","49","942","1209","1"
"5","2018","31","Hotel","11","15","2","6","0","0","2","6","1"
"5","2018","31","Otros","4","21","162","240","6","10","168","250","1"
"5","2018","31","Otros","16","19","40","93","0","0","40","93","10.263157894737"
"5","2018","31","","9","37","355","426","1","1","356","427","1"
"5","2018","31","Otros","10","27","11","22","15","30","26","52","4.84"
"5","2018","31","Otros","11","15","63","86","0","0","63","86","2.3571428571429"
"5","2018","31","Hotel","2","29","50","150","14","42","64","192","2"
"5","2018","31","Hotel","10","27","59","189","18","41","77","230","1"
"5","2018","31","Hotel","11","36","117","640","0","0","117","640","2.375"
"5","2018","31","Hotel","9","37","96","106","20","24","116","130","3.4"
"5","2018","31","Otros","14","27","16","32","0","0","16","32","11.833333333333"
"5","2018","31","Otros","7","38","70","151","0","0","70","151","1"
"5","2018","31","Hotel","2","1","10","150","0","0","10","150","6.4"
"5","2018","31","Otros","2","29","18","38","33","110","51","148","3.28"
"5","2018","31","Hotel","6","27","24","44","0","0","24","44","3"
"5","2018","31","Otros","5","9","5","150","0","0","5","150","4.0454545454545"
"5","2018","31","Hotel","2","1","19","29","0","0","19","29","6.4"
"5","2018","31","Hotel","3","7","7","7","33","61","40","68","1"
"5","2018","31","Otros","7","38","41","64","61","84","102","148","2.75"
"5","2018","31","Otros","7","17","11","23","0","0","11","23","17.166666666667"
"5","2018","31","Otros","7","38","10","24","0","0","10","24","2.75"
"5","2018","31","Otros","4","21","9","9","0","0","9","9","4.8333333333333"
"5","2018","31","Otros","2","1","54","54","3","3","57","57","5.5"
"5","2018","31","Otros","12","35","26","34","5","6","31","40","3.5"
"5","2018","31","Otros","12","35","1","1","0","0","1","1","3.5"
"5","2018","31","Otros","4","21","8","13","1","2","9","15","4.8333333333333"
"5","2018","31","Otros","12","24","14","37","0","0","14","37","9.2"
"5","2018","31","Otros","16","19","1","1","0","0","1","1","10.263157894737"
"5","2018","31","Otros","10","11","42","67","0","0","42","67","11.764705882353"
"5","2018","31","Otros","16","19","32","49","0","0","32","49","10.263157894737"
"5","2018","31","Hotel","2","27","33","93","0","0","33","93","1"
"5","2018","31","Otros","6","28","5","5","0","0","5","5","4.65"
"5","2018","31","Otros","10","18","164","312","26","68","190","380","10.25"
"5","2018","31","Otros","14","27","74","269","0","0","74","269","11.833333333333"
"5","2018","31","Hotel","11","32","21","39","2","4","23","43","1"
"5","2018","31","Otros","8","27","21","78","0","0","21","78","9.4"
"5","2018","31","Hotel","12","35","50","73","8","14","58","87","1.7272727272727"
"5","2018","31","Otros","13","14","21","29","0","0","21","29","7.3846153846154"
"5","2018","31","Otros","11","36","22","50","0","0","22","50","5.1904761904762"
"5","2018","31","Otros","16","20","42","60","0","0","42","60","3.0769230769231"
"5","2018","31","Hotel","14","31","117","137","720","937","837","1074","7.8"
"5","2018","31","Otros","2","27","122","220","4","6","126","226","3.2"
"5","2018","31","","16","40","149","342","0","0","149","342","3.0555555555556"
"5","2018","31","Hotel","11","36","62","98","4","8","66","106","2.375"
"5","2018","31","Hotel","9","22","24","34","0","0","24","34","2.5555555555556"
"5","2018","31","Otros","2","29","19","26","24","43","43","69","3.28"
"5","2018","31","Hotel","10","27","7","8","50","51","57","59","2.25"
"5","2018","1","Otros","10","27","2","2","0","0","2","2","4.84"
"5","2018","31","Hotel","16","19","7","10","0","0","7","10","4"
"5","2018","21","Otros","2","6","11","72","0","0","11","72","5"
"5","2018","31","Otros","7","27","103","141","0","0","103","141","4.8333333333333"
"5","2018","31","Hotel","2","6","105","825","0","0","105","825","5.5"
"5","2018","31","Hotel","6","28","2","2","0","0","2","2","2.4"
"5","2018","31","Otros","6","10","62","405","0","0","62","405","3.8518518518518"
"5","2018","31","Hotel","6","27","19","29","0","0","19","29","3"
"5","2018","31","Otros","5","5","21","26","0","0","21","26","3.65625"
"5","2018","31","Otros","12","24","32","55","13","17","45","72","9.2"
"5","2018","31","Hotel","8","2","77","179","1","4","78","183","3"
"5","2018","31","Hotel","11","32","15","63","5","5","20","68","1"
"5","2018","31","Otros","10","18","8","14","1","1","9","15","10.25"
"5","2018","31","Hotel","9","37","37","48","8","12","45","60","3.4"
"5","2018","31","Otros","5","9","25","42","10","14","35","56","4.0454545454545"
"5","2018","17","Otros","12","24","11","15","5","5","16","20","9.2"
"5","2018","31","Otros","9","22","2","2","0","0","2","2","7.6428571428571"
"5","2018","31","Otros","2","29","18","36","21","61","39","97","3.28"
"5","2018","31","Otros","10","23","8","168","0","0","8","168","7"
"5","2018","31","Otros","10","27","7","20","4","8","11","28","4.84"
"5","2018","31","Otros","10","11","25","25","0","0","25","25","11.764705882353"
"5","2018","31","Otros","8","3","2","2","0","0","2","2","10"
"5","2018","31","Otros","14","31","90","137","299","458","389","595","20.2"
"5","2018","31","Otros","2","29","167","416","168","452","335","868","3.28"
"5","2018","0","Otros","6","25","0","0","0","0","0","0","1"
"5","2018","31","Hotel","15","16","15","28","0","0","15","28","7.8"
"5","2018","31","Hotel","15","27","87","104","0","0","87","104","1"
"5","2018","31","Otros","10","27","7","10","10","18","17","28","4.84"
"5","2018","31","Otros","10","23","29","29","0","0","29","29","7"
"5","2018","31","Otros","6","27","12","19","0","0","12","19","3.960088691796"
"5","2018","31","Otros","16","40","79","148","0","0","79","148","28.142857142857"
"5","2018","31","Otros","11","36","90","100","0","0","90","100","5.1904761904762"
"5","2018","31","Otros","8","34","28","49","3","5","31","54","5.75"
"5","2018","31","Otros","6","12","25","153","0","0","25","153","1.8256578947368"
"5","2018","31","Otros","6","10","150","227","0","0","150","227","3.8518518518518"
"5","2018","31","Hotel","4","21","148","238","14","20","162","258","3"
"5","2018","31","Hotel","11","36","43","94","22","38","65","132","2.375"
"5","2018","31","Otros","5","8","65","91","10","10","75","101","5"
"5","2018","31","Hotel","7","17","63","104","0","0","63","104","10"
"5","2018","25","Hotel","11","36","297","356","13","15","310","371","1"
"5","2018","31","Otros","9","30","6","16","0","0","6","16","2.3333333333333"
"5","2018","31","Hotel","12","35","38","55","17","25","55","80","1.7272727272727"
"5","2018","31","Otros","2","1","37","238","16","76","53","314","5.5"
"5","2018","31","Hotel","6","25","129","135","0","0","129","135","1"
"5","2018","31","Otros","5","5","4","120","0","0","4","120","3.65625"
"5","2018","31","Otros","2","29","34","80","44","98","78","178","3.28"
"5","2018","31","Hotel","2","6","15","25","7","11","22","36","5.5"
"5","2018","31","Otros","7","17","11","17","0","0","11","17","17.166666666667"
"5","2018","31","Hotel","8","2","3","3","0","0","3","3","3"
"5","2018","31","Hotel","13","14","9","18","3","11","12","29","1"
"5","2018","31","Otros","7","38","36","71","0","0","36","71","2.75"
"5","2018","31","Hotel","14","31","14","19","61","225","75","244","24"
"5","2018","31","Hotel","5","5","24","67","0","0","24","67","2.1428571428571"
"5","2018","31","Otros","2","27","1","8","5","5","6","13","3.2"
"5","2018","31","Otros","5","8","4","8","0","0","4","8","5"
"5","2018","31","Otros","3","4","37","118","0","0","37","118","12.2"
"5","2018","31","Otros","13","14","1","1","0","0","1","1","7.3846153846154"
"5","2018","31","Otros","9","37","35","48","0","0","35","48","4.5"
"5","2018","31","Hotel","10","23","546","731","46","64","592","795","1"
"5","2018","15","Otros","11","32","11","17","1","1","12","18","2.2857142857143"
"5","2018","31","Otros","11","15","1","3","0","0","1","3","2.3571428571429"
"5","2018","31","Otros","8","3","32","145","2","6","34","151","10"
"5","2018","31","Otros","16","20","27","59","0","0","27","59","3.0769230769231"
"5","2018","31","Otros","8","3","35","35","0","0","35","35","10"
"5","2018","31","Otros","16","27","11","12","0","0","11","12","2"
"5","2018","31","Hotel","16","19","6","6","0","0","6","6","4"
"5","2018","31","Hotel","16","27","29","107","0","0","29","107","5.8571428571429"
"5","2018","31","Otros","9","26","21","32","0","0","21","32","3.8888888888889"
"5","2018","31","Otros","5","5","7","9","2","4","9","13","3.65625"
"5","2018","31","Otros","14","27","9","25","3","3","12","28","11.833333333333"
"5","2018","31","Hotel","5","5","11","18","0","0","11","18","2.1428571428571"
"5","2018","31","Hotel","12","24","164","273","109","109","273","382","3"
"5","2018","31","Otros","16","27","5","24","0","0","5","24","13.818181818182"
"5","2018","31","Otros","8","3","14","38","0","0","14","38","1"
"5","2018","31","Otros","13","27","88","125","0","0","88","125","12.2"
"5","2018","31","Hotel","16","40","12","14","19","28","31","42","16.333333333333"
"5","2018","31","Otros","11","36","28","201","0","0","28","201","1"
"5","2018","31","Otros","10","27","6","8","4","4","10","12","4.84"
"5","2018","31","Otros","9","22","29","58","0","0","29","58","7.6428571428571"
"5","2018","31","Hotel","5","5","29","57","5","10","34","67","2.1428571428571"
"5","2018","31","Otros","2","29","59","110","69","194","128","304","3.28"
"5","2018","31","Otros","2","29","3","4","5","5","8","9","3.28"
"5","2018","31","Hotel","13","14","17","17","2","2","19","19","1"
"5","2018","31","Otros","6","25","5","7","0","0","5","7","2.3846153846154"
"5","2018","31","Otros","2","1","31","31","1","1","32","32","5.5"
"5","2018","31","Hotel","12","27","31","62","2","2","33","64","1"
"5","2018","31","Hotel","13","27","10","14","0","0","10","14","4.2"
"5","2018","31","Otros","6","12","84","230","0","0","84","230","1.8256578947368"
"5","2018","31","Otros","6","27","16","42","0","0","16","42","3.960088691796"
"5","2018","31","Otros","6","25","6","6","0","0","6","6","2.3846153846154"
"5","2018","31","Hotel","6","28","20","54","0","0","20","54","2.5833333333333"
"5","2018","31","Otros","5","5","1","1","0","0","1","1","3.65625"
"5","2018","31","Otros","5","9","13","17","0","0","13","17","4.0454545454545"
"5","2018","31","Otros","5","8","11","35","0","0","11","35","5"
"5","2018","31","Hotel","2","29","237","958","16","56","253","1014","1"
"5","2018","31","Otros","5","5","83","158","29","60","112","218","3.65625"
"5","2018","31","Hotel","9","26","0","0","2","4","2","4","1.5"
"5","2018","31","Otros","9","30","10","30","0","0","10","30","2.3333333333333"
"5","2018","31","Otros","11","15","7","18","0","0","7","18","2.3571428571429"
"5","2018","31","Hotel","16","27","2","2","0","0","2","2","5.8571428571429"
"5","2018","31","Otros","9","30","6","6","0","0","6","6","2.3333333333333"
"5","2018","31","Otros","2","29","13","23","9","14","22","37","3.28"
"5","2018","31","Otros","7","38","25","40","16","74","41","114","2.75"
"5","2018","31","Otros","4","21","27","64","2","6","29","70","4.8333333333333"
"5","2018","31","Otros","9","22","25","51","0","0","25","51","7.6428571428571"
"5","2018","31","Otros","9","22","55","66","0","0","55","66","7.6428571428571"
"5","2018","31","Otros","13","27","2","2","0","0","2","2","12.2"
"5","2018","31","Hotel","11","36","1318","1378","27","42","1345","1420","1"
"5","2018","31","Otros","13","33","21","42","5","10","26","52","5.125"
"5","2018","31","Otros","11","36","46","96","39","99","85","195","5.1904761904762"
"5","2018","31","Otros","12","35","23","32","17","26","40","58","3.5"
"5","2018","31","Otros","12","35","5","7","0","0","5","7","3.5"
"5","2018","31","Otros","10","11","18","22","5","5","23","27","11.764705882353"
"5","2018","31","Otros","12","24","6","7","6","8","12","15","9.2"
"5","2018","31","Otros","16","20","32","72","0","0","32","72","3.0769230769231"
"5","2018","31","Hotel","7","27","7","13","0","0","7","13","1"
"5","2018","31","Otros","6","12","14","17","4","4","18","21","1.8256578947368"
"5","2018","31","Otros","11","32","11","39","5","14","16","53","2.2857142857143"
"5","2018","31","Otros","6","28","32","34","5","5","37","39","4.65"
"5","2018","31","Otros","8","34","1","1","0","0","1","1","5.75"
"5","2018","30","Otros","16","27","25","67","0","0","25","67","13.818181818182"
"5","2018","31","Otros","10","11","1","1","0","0","1","1","11.764705882353"
"5","2018","31","Otros","6","10","36","86","0","0","36","86","3.8518518518518"
"5","2018","31","Otros","8","3","2","2","0","0","2","2","10"
"5","2018","31","Hotel","16","20","33","66","34","68","67","134","1"
"5","2018","31","Hotel","11","32","16","65","2","5","18","70","1"
"5","2018","31","Otros","8","27","14","82","0","0","14","82","9.4"
"5","2018","31","Otros","12","27","16","88","2","2","18","90","3.4285714285714"
"5","2018","31","Otros","6","10","37","59","0","0","37","59","3.8518518518518"
"5","2018","31","Otros","6","10","6","12","0","0","6","12","3.8518518518518"
"5","2018","31","Otros","5","8","5","14","3","3","8","17","5"
"5","2018","31","Otros","5","8","3","6","1","1","4","7","5"
"5","2018","31","Hotel","9","26","35","100","9","34","44","134","1.5"
"5","2018","31","Hotel","13","14","11","24","0","0","11","24","1"
"5","2018","31","Otros","10","18","49","81","6","12","55","93","10.25"
"5","2018","22","Otros","8","2","22","22","9","9","31","31","6.4285714285714"
"5","2018","31","Otros","7","27","12","15","2","2","14","17","4.8333333333333"
"5","2018","31","Otros","2","29","22","55","13","27","35","82","3.28"
"5","2018","31","Otros","11","32","10","20","0","0","10","20","2.2857142857143"
"5","2018","31","Otros","9","30","10","18","0","0","10","18","2.3333333333333"
"5","2018","31","Otros","2","29","9","32","4","8","13","40","3.28"
"5","2018","31","Otros","5","5","6","27","3","9","9","36","3.65625"
"5","2018","31","Otros","11","15","11","20","0","0","11","20","2.3571428571429"
"5","2018","31","Otros","10","23","11","14","0","0","11","14","7"
"5","2018","31","Otros","11","36","65","111","7","11","72","122","5.1904761904762"
"5","2018","31","Hotel","3","7","16","28","46","88","62","116","1"
"5","2018","31","Otros","10","27","8","22","1","1","9","23","4.84"
"5","2018","31","Otros","2","27","19","28","0","0","19","28","3.2"
"5","2018","31","Otros","12","35","7","8","16","34","23","42","3.5"
"5","2018","31","Otros","10","27","4","4","0","0","4","4","4.84"
"5","2018","31","Otros","16","40","25","47","110","242","135","289","28.142857142857"
"5","2018","31","Hotel","8","3","262","485","65","117","327","602","4.1111111111111"
"5","2018","31","Otros","9","22","24","31","0","0","24","31","7.6428571428571"
"5","2018","31","Otros","13","14","12","20","0","0","12","20","7.3846153846154"
"5","2018","31","Otros","5","9","1","1","0","0","1","1","4.0454545454545"
"5","2018","31","Otros","10","18","19","23","1","7","20","30","10.25"
"5","2018","31","Otros","6","25","39","63","0","0","39","63","2.3846153846154"
"5","2018","31","Otros","9","22","36","74","0","0","36","74","7.6428571428571"
"5","2018","31","Otros","10","27","21","44","3","3","24","47","4.84"
"5","2018","31","Otros","16","20","14","19","2","2","16","21","3.0769230769231"
"5","2018","31","Hotel","7","17","73","172","0","0","73","172","10"
"5","2018","31","Otros","15","27","38","56","0","0","38","56","1.4222222222222"
"5","2018","31","Otros","12","35","4","4","0","0","4","4","3.5"
"5","2018","31","Otros","12","35","4","4","22","40","26","44","3.5"
"5","2018","24","Otros","3","7","5","5","0","0","5","5","2"
"5","2018","31","Otros","10","11","1","1","0","0","1","1","11.764705882353"
"5","2018","31","Otros","12","24","2","2","0","0","2","2","9.2"
"5","2018","31","Otros","10","23","23","27","0","0","23","27","7"
"5","2018","31","Otros","7","27","15","28","1","3","16","31","4.8333333333333"
"5","2018","31","","10","18","5","11","2","2","7","13","1"
"5","2018","31","Otros","16","27","5","5","1","2","6","7","13.818181818182"
"5","2018","31","Hotel","2","29","7","23","14","54","21","77","1"
"5","2018","31","Otros","14","27","25","150","0","0","25","150","11.833333333333"
"5","2018","31","Otros","11","32","102","117","0","0","102","117","2.2857142857143"
"5","2018","31","Otros","16","19","4","8","0","0","4","8","1"
"5","2018","31","Otros","16","27","8","10","0","0","8","10","13.818181818182"
"5","2018","31","Otros","8","3","16","28","1","3","17","31","10"
"5","2018","31","Otros","16","27","36","44","0","0","36","44","13.818181818182"
"5","2018","31","Otros","16","20","51","107","0","0","51","107","3.0769230769231"
"5","2018","31","Otros","16","40","68","111","10","13","78","124","28.142857142857"
"5","2018","31","Hotel","11","36","42","54","11","15","53","69","2.375"
"5","2018","31","Otros","6","10","44","59","0","0","44","59","3.8518518518518"
"5","2018","31","Otros","7","38","151","392","33","72","184","464","2.75"
"5","2018","31","Otros","13","14","12","15","0","0","12","15","7.3846153846154"
"5","2018","31","Otros","9","30","24","42","0","0","24","42","2.3333333333333"
"5","2018","31","Otros","13","27","31","92","0","0","31","92","12.2"
"5","2018","31","Otros","10","27","42","42","13","13","55","55","4.84"
"5","2018","31","Otros","6","25","3","4","0","0","3","4","2.3846153846154"
"5","2018","31","Otros","9","26","38","696","0","0","38","696","3.8888888888889"
"5","2018","31","Otros","10","18","7","10","8","34","15","44","10.25"
"5","2018","31","Otros","2","29","17","49","13","24","30","73","3.28"
"5","2018","31","Otros","6","25","8","16","0","0","8","16","2.3846153846154"
"5","2018","31","Otros","5","9","7","175","0","0","7","175","4.0454545454545"
"5","2018","31","Otros","5","9","12","19","0","0","12","19","4.0454545454545"
"5","2018","31","Hotel","9","37","28","55","7","19","35","74","3.4"
"5","2018","31","Hotel","7","38","80","124","32","35","112","159","1"
"5","2018","31","Otros","7","27","48","80","0","0","48","80","4.8333333333333"
"5","2018","31","Otros","5","9","1","1","0","0","1","1","4.0454545454545"
"5","2018","31","Otros","10","27","16","16","5","5","21","21","4.84"
"5","2018","31","Otros","7","27","57","256","0","0","57","256","4.8333333333333"
"5","2018","31","Otros","16","40","44","54","11","24","55","78","28.142857142857"
"5","2018","31","Otros","10","23","24","24","0","0","24","24","7"
"5","2018","31","Otros","15","16","48","464","0","0","48","464","9"
"5","2018","21","Otros","3","7","13","19","47","90","60","109","2"
"5","2018","31","Otros","7","17","17","37","0","0","17","37","17.166666666667"
"5","2018","31","Otros","8","27","19","186","0","0","19","186","9.4"
"5","2018","31","Otros","9","22","25","74","0","0","25","74","7.6428571428571"
"5","2018","31","Otros","16","19","1","1","0","0","1","1","10.263157894737"
"5","2018","0","","15","27","0","0","0","0","0","0","1"
"5","2018","31","Hotel","10","11","27","27","10","10","37","37","5.6666666666667"
"5","2018","31","Otros","2","27","2","4","3","3","5","7","3.2"
"5","2018","31","Otros","8","2","44","58","16","17","60","75","6.4285714285714"
"5","2018","31","Otros","5","5","1","1","0","0","1","1","3.65625"
"5","2018","31","Otros","12","35","0","0","27","32","27","32","3.5"
"5","2018","20","Otros","8","3","3","15","4","18","7","33","10"
"5","2018","31","Otros","12","24","4","5","18","23","22","28","9.2"
"5","2018","31","Otros","11","32","18","157","4","20","22","177","2.2857142857143"
"5","2018","31","Otros","10","27","22","24","15","28","37","52","4.84"
"5","2018","31","Otros","11","15","20","31","0","0","20","31","2.3571428571429"
"5","2018","31","Otros","5","8","4","6","2","2","6","8","5"
"5","2018","31","Otros","14","27","17","17","2","2","19","19","11.833333333333"
"5","2018","31","Otros","13","27","62","81","0","0","62","81","12.2"
"5","2018","31","Hotel","10","18","45","45","105","105","150","150","3.2"
"5","2018","31","Otros","10","27","22","22","6","6","28","28","4.84"
"5","2018","31","Otros","11","32","23","30","0","0","23","30","1"
"5","2018","31","Otros","9","37","11","58","0","0","11","58","4.5"
"5","2018","31","Otros","12","35","13","13","82","82","95","95","3.5"
"5","2018","31","Otros","8","34","107","189","20","33","127","222","5.75"
"5","2018","31","Hotel","16","40","20","28","31","62","51","90","16.333333333333"
"5","2018","31","Hotel","10","11","18","38","12","24","30","62","5.6666666666667"
"5","2018","31","Otros","7","27","23","47","0","0","23","47","4.8333333333333"
"5","2018","31","Hotel","7","38","10","15","0","0","10","15","1"
"5","2018","31","Otros","6","27","4","8","0","0","4","8","3.960088691796"
"5","2018","31","Otros","6","10","35","60","0","0","35","60","3.8518518518518"
"5","2018","15","Otros","6","25","26","38","0","0","26","38","1"
"5","2018","31","Otros","6","25","1","1","1","2","2","3","2.3846153846154"
"5","2018","31","Otros","6","27","8","248","0","0","8","248","3.960088691796"
"5","2018","31","Otros","6","27","64","185","0","0","64","185","3.960088691796"
"5","2018","31","Otros","5","5","8","71","0","0","8","71","3.65625"
"5","2018","31","Otros","5","5","4","5","0","0","4","5","3.65625"
"5","2018","31","Otros","3","4","9","27","1","1","10","28","12.2"
"5","2018","31","Otros","10","23","2","2","0","0","2","2","7"
"5","2018","31","Otros","8","3","2","2","0","0","2","2","10"
"5","2018","31","Otros","5","5","16","29","0","0","16","29","3.65625"
"5","2018","31","Otros","5","8","2","4","4","16","6","20","5"
"5","2018","31","Otros","6","10","22","64","0","0","22","64","3.8518518518518"
"5","2018","31","Otros","16","19","6","10","0","0","6","10","10.263157894737"
"5","2018","31","Otros","11","15","14","28","2","4","16","32","2.3571428571429"
"5","2018","31","Otros","7","38","25","32","0","0","25","32","2.75"
"5","2018","31","Otros","11","32","82","171","13","25","95","196","2.2857142857143"
"5","2018","31","Otros","8","2","22","45","0","0","22","45","6.4285714285714"
"5","2018","31","Otros","10","27","21","25","6","12","27","37","4.84"
"5","2018","31","Otros","6","27","15","27","0","0","15","27","3.960088691796"
"5","2018","31","Otros","11","32","22","30","0","0","22","30","2.2857142857143"
"5","2018","31","Otros","8","34","13","54","4","12","17","66","5.75"
"5","2018","31","Otros","11","32","1","1","0","0","1","1","2.2857142857143"
"5","2018","31","Otros","10","11","8","10","0","0","8","10","11.764705882353"
"5","2018","31","Otros","11","32","20","36","0","0","20","36","2.2857142857143"
"5","2018","31","Otros","14","31","2","3","9","17","11","20","20.2"
"5","2018","31","Hotel","14","31","219","431","457","1575","676","2006","17.4"
"5","2018","31","Otros","11","36","48","157","3","12","51","169","5.1904761904762"
"5","2018","31","Hotel","15","16","1035","2232","217","462","1252","2694","2"
"5","2018","31","Otros","15","27","19","29","10","14","29","43","1.4222222222222"
"5","2018","31","Otros","5","5","3","3","1","1","4","4","3.65625"
"5","2018","31","Otros","8","34","9","10","4","5","13","15","5.75"
"5","2018","31","Otros","7","27","6","10","0","0","6","10","4.8333333333333"
"5","2018","31","Otros","12","35","1","1","0","0","1","1","3.5"
"5","2018","31","Otros","5","5","35","110","0","0","35","110","3.65625"
"5","2018","31","Otros","10","11","2","6","0","0","2","6","11.764705882353"
"5","2018","31","Otros","10","11","1","1","0","0","1","1","11.764705882353"
"5","2018","31","Otros","9","30","5","70","0","0","5","70","2.3333333333333"
"5","2018","31","Otros","8","2","21","29","0","0","21","29","6.4285714285714"
"5","2018","31","Otros","10","27","62","143","5","5","67","148","4.84"
"5","2018","31","Otros","5","9","5","7","0","0","5","7","4.0454545454545"
"5","2018","31","Otros","6","27","4","11","0","0","4","11","3.960088691796"
"5","2018","31","Otros","6","10","76","125","4","8","80","133","3.8518518518518"
"5","2018","31","Otros","6","10","24","42","0","0","24","42","3.8518518518518"
"5","2018","31","Otros","6","27","7","36","0","0","7","36","3.960088691796"
"5","2018","31","Otros","6","12","4","36","0","0","4","36","1.8256578947368"
"5","2018","31","Otros","6","10","28","50","0","0","28","50","3.8518518518518"
"5","2018","2","Otros","6","10","2","2","0","0","2","2","3.8518518518518"
"5","2018","31","Otros","6","27","1","1","0","0","1","1","3.960088691796"
"5","2018","31","Otros","6","12","29","33","4","8","33","41","1.8256578947368"
"5","2018","31","Otros","6","10","10","20","0","0","10","20","3.8518518518518"
"5","2018","31","Hotel","6","25","20","76","0","0","20","76","1"
"5","2018","2","Otros","6","27","2","2","0","0","2","2","3.960088691796"
"5","2018","31","Otros","5","9","12","20","5","10","17","30","4.0454545454545"
"5","2018","31","Otros","5","5","14","24","11","13","25","37","3.65625"
"5","2018","31","Otros","5","5","13","23","0","0","13","23","3.65625"
"5","2018","31","Otros","5","5","27","49","10","27","37","76","3.65625"
"5","2018","31","Otros","11","36","64","86","0","0","64","86","5.1904761904762"
"5","2018","31","Hotel","6","10","805","1548","15","25","820","1573","1"
"5","2018","31","Otros","5","9","5","10","0","0","5","10","4.0454545454545"
"5","2018","31","Otros","5","8","7","11","1","1","8","12","5"
"5","2018","0","Hotel","15","27","0","0","0","0","0","0","1"
"5","2018","31","Hotel","3","4","172","864","6","16","178","880","3"
"5","2018","31","Otros","3","7","8","8","7","7","15","15","1"
"5","2018","31","Otros","7","38","109","145","2","2","111","147","2.75"
"5","2018","31","Hotel","10","27","31","33","8","10","39","43","1"
"5","2018","31","Hotel","12","35","1","1","0","0","1","1","1.7272727272727"
"5","2018","31","Hotel","10","27","4","5","0","0","4","5","2.25"
"5","2018","31","Hotel","7","17","563","951","55","93","618","1044","4"
"5","2018","31","Hotel","16","19","18","19","0","0","18","19","4"
"5","2018","31","Hotel","2","6","134","317","0","0","134","317","2.2"
"5","2018","31","Otros","5","5","47","137","2","10","49","147","3.65625"
"5","2018","31","Otros","12","24","88","116","71","85","159","201","9.2"
"5","2018","31","Otros","5","8","7","13","0","0","7","13","5"
"5","2018","31","Otros","4","13","197","249","7","7","204","256","1"
"5","2018","31","Otros","10","11","78","78","0","0","78","78","11.764705882353"
"5","2018","31","Otros","12","35","47","67","42","72","89","139","3.5"
"5","2018","31","Otros","10","23","58","58","4","4","62","62","7"
"5","2018","31","Otros","11","36","394","919","37","83","431","1002","5.1904761904762"
"5","2018","31","Otros","12","35","10","13","3","3","13","16","3.5"
"5","2018","31","Otros","11","36","31","55","0","0","31","55","5.1904761904762"
"5","2018","31","Otros","8","2","49","207","0","0","49","207","6.4285714285714"
"5","2018","31","Otros","9","30","55","156","0","0","55","156","2.3333333333333"
"5","2018","31","Otros","11","36","51","59","4","10","55","69","5.1904761904762"
"5","2018","31","Otros","6","10","9","9","0","0","9","9","3.8518518518518"
"5","2018","31","Otros","10","18","26","54","0","0","26","54","10.25"
"5","2018","31","Otros","7","27","1","4","7","16","8","20","4.8333333333333"
"5","2018","31","Otros","16","20","5","18","0","0","5","18","1"
"5","2018","31","Otros","9","22","21","31","0","0","21","31","7.6428571428571"
"5","2018","31","Otros","5","5","185","388","21","57","206","445","3.65625"
"5","2018","31","Otros","12","35","5","5","0","0","5","5","3.5"
"5","2018","31","Otros","10","11","0","0","1","1","1","1","11.764705882353"
"5","2018","31","Otros","10","11","1","31","0","0","1","31","11.764705882353"
"5","2018","26","Otros","5","9","24","56","2","3","26","59","4.0454545454545"
"5","2018","31","Otros","5","5","3","90","1","30","4","120","3.65625"
"5","2018","31","Otros","12","35","0","0","3","3","3","3","3.5"
"5","2018","26","Otros","7","38","113","210","10","20","123","230","2.75"
"5","2018","31","Hotel","12","35","0","0","10","10","10","10","1.7272727272727"
"5","2018","31","Otros","13","14","19","19","0","0","19","19","1"
"5","2018","31","Otros","5","5","8","12","5","10","13","22","3.65625"
"5","2018","31","Hotel","9","26","4","8","0","0","4","8","1.5"
"5","2018","31","Hotel","16","19","6","22","0","0","6","22","1"
"5","2018","31","Otros","16","19","31","224","0","0","31","224","10.263157894737"
"5","2018","31","Otros","9","30","55","71","1","1","56","72","2.3333333333333"
"5","2018","31","Otros","16","19","8","8","0","0","8","8","10.263157894737"
"5","2018","31","Otros","16","19","76","162","0","0","76","162","10.263157894737"
"5","2018","31","Otros","9","26","14","28","0","0","14","28","3.8888888888889"
"5","2018","31","Otros","16","40","1","2","0","0","1","2","28.142857142857"
"5","2018","31","Hotel","16","27","8","8","0","0","8","8","5.8571428571429"
"5","2018","31","Otros","16","19","18","30","0","0","18","30","10.263157894737"
"5","2018","31","Otros","16","19","26","44","0","0","26","44","10.263157894737"
"5","2018","31","","9","30","53","278","0","0","53","278","1"
"5","2018","31","Otros","16","19","14","16","0","0","14","16","10.263157894737"
"5","2018","31","Otros","10","11","12","32","0","0","12","32","11.764705882353"
"5","2018","31","Otros","11","36","17","17","0","0","17","17","5.1904761904762"
"5","2018","31","Otros","16","19","1","3","0","0","1","3","10.263157894737"
"5","2018","31","Otros","16","19","109","159","0","0","109","159","1.3333333333333"
"5","2018","31","Otros","16","19","32","48","0","0","32","48","10.263157894737"
"5","2018","31","Otros","10","18","17","36","17","30","34","66","10.25"
"5","2018","31","Otros","16","19","10","12","0","0","10","12","10.263157894737"
"5","2018","31","Otros","16","19","6","10","0","0","6","10","1.3333333333333"
"5","2018","31","","9","26","328","1480","0","0","328","1480","1"
"5","2018","31","Otros","16","19","8","8","0","0","8","8","10.263157894737"
"5","2018","22","Otros","16","19","26","30","0","0","26","30","10.263157894737"
"5","2018","31","Hotel","8","2","509","910","21","39","530","949","1"
"5","2018","31","Otros","6","10","2","4","0","0","2","4","3.8518518518518"
"5","2018","31","Otros","6","12","21","21","0","0","21","21","1.8256578947368"
"5","2018","31","Hotel","16","19","26","43","23","35","49","78","1"
"5","2018","31","Otros","3","7","18","36","18","18","36","54","2"
"5","2018","31","Hotel","2","6","1552","3179","61","175","1613","3354","1"
"5","2018","31","Hotel","3","4","390","552","31","64","421","616","2.6"
"5","2018","31","Hotel","16","40","1405","2021","1068","1533","2473","3554","1"
"5","2018","31","Otros","16","27","44","44","0","0","44","44","13.818181818182"
"5","2018","31","Hotel","6","28","185","275","5","7","190","282","2.4"
"5","2018","31","Hotel","8","34","2467","3220","148","308","2615","3528","1"
"5","2018","31","Otros","9","30","2","2","0","0","2","2","2.3333333333333"
"5","2018","31","Hotel","10","18","54","54","105","105","159","159","1"
"5","2018","31","Hotel","9","30","38","131","0","0","38","131","1"
"5","2018","31","Hotel","15","27","22","22","0","0","22","22","1"
"5","2018","31","Hotel","9","22","75","450","0","0","75","450","2.5555555555556"
"5","2018","0","","11","15","0","0","0","0","0","0","1"
"5","2018","31","Otros","6","12","15","15","0","0","15","15","1.8256578947368"
"5","2018","31","Hotel","15","27","30","930","0","0","30","930","1"
"5","2018","31","Otros","15","27","19","24","0","0","19","24","1.4222222222222"
"5","2018","31","Otros","15","27","1","1","0","0","1","1","1.4222222222222"
"5","2018","31","Otros","2","1","14","14","11","11","25","25","1"
"5","2018","31","Otros","12","24","3","3","2","2","5","5","9.2"
"5","2018","31","Otros","5","5","6","12","0","0","6","12","3.65625"
"5","2018","31","Hotel","7","27","113","173","10","10","123","183","1"
"5","2018","31","Otros","16","20","69","71","0","0","69","71","3.0769230769231"
"5","2018","31","","10","11","82","153","5","8","87","161","1"
"5","2018","31","Hotel","16","40","23","27","7","7","30","34","16.333333333333"
"5","2018","31","Otros","12","35","5","15","0","0","5","15","3.5"
"5","2018","31","Hotel","6","27","5","5","0","0","5","5","3"
"5","2018","31","Otros","5","5","40","40","0","0","40","40","3.65625"
"5","2018","31","Hotel","6","27","38","38","0","0","38","38","3"
"5","2018","31","Otros","6","25","36","42","0","0","36","42","2.3846153846154"
"5","2018","0","Hotel","15","27","0","0","0","0","0","0","1"
"5","2018","31","Otros","5","9","21","39","0","0","21","39","4.0454545454545"
"5","2018","31","Hotel","15","27","30","30","0","0","30","30","1"
"5","2018","31","Hotel","5","9","10","19","0","0","10","19","1"
"5","2018","31","Hotel","8","34","85","114","10","27","95","141","2.5714285714286"
"5","2018","0","Hotel","15","27","0","0","0","0","0","0","1"
"5","2018","31","Hotel","6","27","158","287","0","0","158","287","3"
"5","2018","0","Otros","6","27","0","0","0","0","0","0","1"
"5","2018","31","Otros","12","27","2","2","40","40","42","42","3.4285714285714"
"5","2018","31","Hotel","2","27","803","817","166","170","969","987","1"
"5","2018","31","Hotel","2","6","176","176","0","0","176","176","1"
"5","2018","31","Otros","2","6","27","27","0","0","27","27","1"
"5","2018","31","Hotel","4","39","158","158","0","0","158","158","1"
"5","2018","31","Hotel","6","10","326","406","16","16","342","422","1"
"5","2018","31","Otros","5","8","25","36","0","0","25","36","5"
"5","2018","0","Hotel","13","33","0","0","0","0","0","0","1"
"5","2018","31","Hotel","13","33","135","270","52","104","187","374","1"
"5","2018","31","Otros","11","32","131","283","7","13","138","296","2.2857142857143"
"5","2018","31","Hotel","9","26","151","382","77","141","228","523","1"
"5","2018","31","Hotel","16","20","59","73","3","4","62","77","1"
"5","2018","31","Otros","16","20","12","14","0","0","12","14","3.0769230769231"
"5","2018","31","","16","40","675","1194","17","39","692","1233","1"
"5","2018","31","Hotel","15","16","1307","2273","149","328","1456","2601","1"
"5","2018","31","Hotel","5","9","6","9","5","5","11","14","1"
"5","2018","31","Otros","7","38","62","117","0","0","62","117","2.75"
"5","2018","31","Otros","2","6","303","2962","0","0","303","2962","1"
"5","2018","31","Otros","2","6","313","472","0","0","313","472","1"
"5","2018","31","Hotel","15","27","312","1213","5","7","317","1220","1"
"5","2018","31","Otros","7","38","32","51","0","0","32","51","2.75"
"5","2018","31","Otros","2","1","12","41","9","27","21","68","1"
"5","2018","31","Otros","8","3","22","35","0","0","22","35","10"
"5","2018","31","Otros","11","36","21","45","0","0","21","45","5.1904761904762"
"5","2018","31","Otros","16","20","27","76","0","0","27","76","3.0769230769231"
"5","2018","31","Otros","8","3","257","362","0","0","257","362","1"
"5","2018","31","Otros","4","39","52","486","2","62","54","548","2.2222222222222"
"5","2018","31","Otros","5","5","202","405","15","38","217","443","3.65625"
"5","2018","31","Otros","12","27","2","2","2","6","4","8","3.4285714285714"
"5","2018","31","Otros","7","27","22","176","0","0","22","176","1"
"5","2018","31","Hotel","2","6","455","1010","12","12","467","1022","1"
"5","2018","31","Hotel","14","27","248","1115","89","195","337","1310","1"
"5","2018","31","Hotel","16","19","481","672","0","0","481","672","1"
"5","2018","31","","2","1","12","168","0","0","12","168","1"
"5","2018","31","Hotel","2","27","69","248","3","90","72","338","1"
"5","2018","31","Otros","16","20","14","16","0","0","14","16","1"
"5","2018","0","Otros","13","14","0","0","0","0","0","0","1"
"5","2018","31","Hotel","11","36","74","130","1","1","75","131","2.375"
"5","2018","31","Otros","13","14","5","26","0","0","5","26","7.3846153846154"
"5","2018","31","Otros","12","27","1","2","0","0","1","2","3.4285714285714"
"5","2018","31","Hotel","2","6","125","411","2","2","127","413","2.2"
"5","2018","31","Otros","2","6","475","1418","0","0","475","1418","1"
"5","2018","31","Otros","10","27","2","33","0","0","2","33","4.84"
"5","2018","31","Otros","12","27","3","3","4","4","7","7","3.4285714285714"
"5","2018","31","Otros","13","14","35","103","0","0","35","103","7.3846153846154"
"5","2018","31","Otros","6","12","109","195","26","47","135","242","1.8256578947368"
"5","2018","31","Otros","2","6","704","1697","7","25","711","1722","1"
"5","2018","31","Hotel","12","35","28","30","0","0","28","30","1.7272727272727"
"5","2018","31","Otros","5","5","12","15","5","10","17","25","3.65625"
"5","2018","31","Otros","9","30","1","31","2","62","3","93","2.3333333333333"
"5","2018","0","Hotel","8","2","0","0","0","0","0","0","1"
"5","2018","31","Otros","9","30","4","4","0","0","4","4","2.3333333333333"
"5","2018","31","Hotel","15","27","32","32","0","0","32","32","1"
"5","2018","31","Hotel","3","7","34","34","0","0","34","34","1"
"5","2018","31","Otros","6","12","369","577","0","0","369","577","1.8256578947368"
"5","2018","31","Otros","12","27","17","25","3","3","20","28","3.4285714285714"
"5","2018","31","Otros","2","6","6","11","0","0","6","11","5"
"5","2018","31","Otros","6","27","16","34","0","0","16","34","3.960088691796"
"5","2018","0","Hotel","10","11","0","0","0","0","0","0","1"
"5","2018","31","Otros","2","1","7","105","0","0","7","105","1"
"5","2018","31","Otros","11","36","21","81","0","0","21","81","5.1904761904762"
"5","2018","31","Hotel","11","32","0","0","0","0","0","0","1"
"5","2018","31","Otros","2","27","10","99","0","0","10","99","1"
"5","2018","31","Otros","12","27","11","33","0","0","11","33","3.4285714285714"
"5","2018","31","Hotel","8","2","8","8","0","0","8","8","3"
"5","2018","31","Hotel","16","20","43","61","0","0","43","61","1"
"5","2018","31","Otros","12","35","0","0","10","13","10","13","3.5"
"5","2018","31","Otros","13","14","19","25","0","0","19","25","1"
"5","2018","31","Otros","2","27","20","34","0","0","20","34","3.2"
"5","2018","31","Hotel","6","27","13","13","0","0","13","13","3"
"5","2018","31","Hotel","8","3","36","92","12","40","48","132","4.1111111111111"
"5","2018","31","Hotel","15","27","35","110","0","0","35","110","1"
"5","2018","31","Otros","8","3","36","78","0","0","36","78","10"
"5","2018","0","Hotel","16","20","0","0","0","0","0","0","1"
"5","2018","31","Hotel","6","28","75","118","1","11","76","129","2.4"
"5","2018","31","Otros","2","1","38","146","2","4","40","150","5.5"
"5","2018","31","Hotel","11","36","107","189","78","127","185","316","2.375"
"5","2018","31","Otros","4","13","289","289","0","0","289","289","1"
"5","2018","31","Otros","2","6","239","1673","0","0","239","1673","1"
"5","2018","31","Otros","8","34","91","172","27","36","118","208","5.75"
"5","2018","0","Hotel","11","15","0","0","0","0","0","0","1"
"5","2018","31","Otros","15","27","5","9","0","0","5","9","1.4222222222222"
"5","2018","31","Hotel","13","14","83","142","0","0","83","142","1"
"5","2018","31","Hotel","13","14","179","275","3","5","182","280","1"
"5","2018","0","Hotel","9","30","0","0","0","0","0","0","1"
"5","2018","31","Hotel","4","13","261","490","24","52","285","542","5.4"
"5","2018","31","Otros","6","27","8","19","0","0","8","19","3.960088691796"
"5","2018","0","Hotel","15","27","0","0","0","0","0","0","1"
"5","2018","31","Hotel","2","29","5","13","49","175","54","188","2"
"5","2018","31","Hotel","13","33","18","25","0","0","18","25","2"
"5","2018","31","Hotel","12","35","38","55","17","25","55","80","1.7272727272727"
"5","2018","31","Hotel","13","14","375","573","8","47","383","620","1"
"5","2018","31","Otros","6","25","22","26","0","0","22","26","2.3846153846154"
"5","2018","31","Hotel","8","2","19","34","0","0","19","34","3"
"5","2018","31","Otros","4","39","40","91","0","0","40","91","2.2222222222222"
"5","2018","31","Otros","6","12","131","174","6","6","137","180","1.8256578947368"
"5","2018","31","Otros","13","33","49","87","5","19","54","106","5.125"
"5","2018","31","Hotel","4","13","127","245","11","22","138","267","5.4"
"5","2018","31","Hotel","7","27","258","418","0","0","258","418","4.1666666666667"
"5","2018","31","Hotel","4","13","601","1613","115","181","716","1794","1"
"5","2018","31","","5","8","0","0","0","0","0","0","1"
"5","2018","31","Otros","8","2","5","5","0","0","5","5","6.4285714285714"
"5","2018","31","Otros","2","6","6","6","12","12","18","18","1"
"5","2018","31","","6","10","32","72","0","0","32","72","1"
"5","2018","31","Hotel","2","29","43","133","30","69","73","202","2"
"5","2018","31","","14","31","218","483","330","1149","548","1632","1"
"5","2018","31","Hotel","16","27","3525","10578","0","0","3525","10578","1"
"5","2018","31","Hotel","12","35","69","117","24","38","93","155","1.7272727272727"
"5","2018","31","","12","35","29","49","139","239","168","288","1"
"5","2018","31","","9","26","113","124","5","5","118","129","1"
"5","2018","31","Otros","11","32","157","204","0","0","157","204","2.2857142857143"
"5","2018","31","Otros","12","24","18","43","14","17","32","60","9.2"
"5","2018","31","Hotel","6","25","31","40","0","0","31","40","1"
"5","2018","31","Otros","11","32","19","24","0","0","19","24","2.2857142857143"
"5","2018","31","Hotel","16","19","66","89","0","0","66","89","4"
"5","2018","31","Otros","13","33","4","7","0","0","4","7","5.125"
"5","2018","31","Otros","16","27","27","62","1","27","28","89","13.818181818182"
"5","2018","31","Otros","6","12","84","139","5","5","89","144","1.8256578947368"
"5","2018","31","Otros","2","29","5","5","0","0","5","5","3.28"
"5","2018","31","Hotel","14","27","392","467","68","96","460","563","1"
"5","2018","31","Otros","2","1","77","1078","0","0","77","1078","1"
"5","2018","31","Otros","11","32","21","21","0","0","21","21","2.2857142857143"
"5","2018","31","Otros","2","27","34","47","0","0","34","47","1"
"5","2018","31","Hotel","2","29","160","392","3","31","163","423","1"
"5","2018","31","Hotel","4","13","61","526","2","14","63","540","3.2"
"5","2018","31","Hotel","4","21","9","18","4","6","13","24","3"
"5","2018","31","Otros","7","27","64","111","0","0","64","111","4.8333333333333"
"5","2018","21","","3","4","38","59","5","5","43","64","1"
"5","2018","31","Hotel","6","27","17","41","1","6","18","47","3"
"5","2018","31","Otros","16","19","7","12","0","0","7","12","10.263157894737"
"5","2018","31","Otros","11","32","30","48","1","1","31","49","2.2857142857143"
"5","2018","31","Otros","3","7","44","63","25","41","69","104","2"
"5","2018","31","Otros","5","5","34","54","12","28","46","82","3.65625"
"5","2018","24","Otros","15","27","422","620","0","0","422","620","1.4222222222222"
"5","2018","31","Otros","6","25","2","2","0","0","2","2","2.3846153846154"
"5","2018","31","","10","27","2","2","0","0","2","2","1"
"5","2018","31","Otros","2","29","35","68","139","216","174","284","3.28"
"5","2018","31","Otros","12","35","1","1","0","0","1","1","3.5"
"5","2018","31","Otros","16","19","40","68","0","0","40","68","10.263157894737"
"5","2018","31","Otros","9","26","34","38","0","0","34","38","3.8888888888889"
"5","2018","31","Hotel","13","33","35","35","0","0","35","35","2"
"5","2018","31","Otros","11","32","10","22","0","0","10","22","2.2857142857143"
"5","2018","31","Otros","9","22","7","12","0","0","7","12","7.6428571428571"
"5","2018","31","Otros","6","27","15","315","0","0","15","315","3.960088691796"
"5","2018","31","Otros","15","27","7","12","0","0","7","12","1.4222222222222"
"5","2018","31","Otros","11","32","58","58","0","0","58","58","2.2857142857143"
"5","2018","31","Otros","11","15","19","30","0","0","19","30","2.3571428571429"
"5","2018","31","Otros","9","37","8","61","0","0","8","61","4.5"
"5","2018","31","Otros","5","9","24","32","0","0","24","32","4.0454545454545"
"5","2018","31","Hotel","10","27","28","38","0","0","28","38","2.25"
"5","2018","31","Otros","6","28","67","452","0","0","67","452","4.65"
"5","2018","31","Otros","4","13","20","26","0","0","20","26","3.4"
"5","2018","31","Otros","2","1","1","1","0","0","1","1","1"
"5","2018","31","Otros","2","29","51","102","34","70","85","172","3.28"
"5","2018","31","Hotel","8","3","14","32","2","2","16","34","4.1111111111111"
"5","2018","31","Otros","16","19","25","58","0","0","25","58","1.3333333333333"
"5","2018","31","Otros","12","35","6","9","7","11","13","20","3.5"
"5","2018","15","Hotel","12","35","15","23","15","32","30","55","1.7272727272727"
"5","2018","31","Otros","12","35","9","23","7","12","16","35","3.5"
"5","2018","31","Otros","2","29","33","57","53","111","86","168","3.28"
"5","2018","31","Hotel","7","27","61","91","11","11","72","102","1"
"5","2018","31","Hotel","9","22","22","31","1","3","23","34","2.5555555555556"
"5","2018","31","Hotel","12","35","40","70","17","33","57","103","1.7272727272727"
"5","2018","31","Otros","15","16","93","192","7","55","100","247","2"
"5","2018","31","Hotel","15","27","3","3","0","0","3","3","1"
"5","2018","31","Otros","4","13","58","62","11","13","69","75","3.4"
"5","2018","31","Hotel","8","34","63","145","7","13","70","158","2.5714285714286"
"5","2018","31","Hotel","16","20","15","15","0","0","15","15","1"
"5","2018","31","Hotel","6","28","97","234","11","17","108","251","2.4"
"5","2018","31","Hotel","15","27","96","356","10","37","106","393","1"
"5","2018","31","Otros","12","35","105","167","36","84","141","251","3.5"
"5","2018","31","Otros","11","15","35","70","0","0","35","70","2.3571428571429"
"5","2018","31","Otros","11","15","26","41","0","0","26","41","2.3571428571429"
"5","2018","31","Otros","11","36","41","104","45","90","86","194","5.1904761904762"
"5","2018","31","Hotel","11","36","31","98","4","10","35","108","2.375"
"5","2018","31","Hotel","6","12","87","146","0","0","87","146","5"
"5","2018","31","Otros","8","3","8","8","6","8","14","16","10"
"5","2018","31","Otros","10","27","18","41","3","5","21","46","4.84"
"5","2018","31","Otros","8","3","7","7","0","0","7","7","10"
"5","2018","31","Otros","6","25","5","9","0","0","5","9","2.3846153846154"
"5","2018","31","Hotel","2","27","88","179","0","0","88","179","1"
"5","2018","31","Hotel","10","18","0","0","147","419","147","419","3.2"
"5","2018","31","Otros","11","32","54","120","4","12","58","132","1"
"5","2018","31","Hotel","6","10","1569","2026","97","132","1666","2158","1"
"5","2018","31","Otros","11","32","38","54","0","0","38","54","2.2857142857143"
"5","2018","0","Otros","2","27","0","0","0","0","0","0","1"
"5","2018","0","","12","24","0","0","0","0","0","0","1"
"5","2018","31","Hotel","16","27","305","422","2","8","307","430","5.8571428571429"
"5","2018","31","Hotel","7","38","32","62","5","7","37","69","1"
"5","2018","31","Hotel","6","12","1810","1810","19","19","1829","1829","1"
"6","2018","30","Hotel","14","31","1598","2186","11617","13248","13215","15434","1"
"6","2018","30","Hotel","14","31","594","976","2411","6930","3005","7906","1"
"6","2018","30","Hotel","14","31","636","874","592","2648","1228","3522","1"
"6","2018","0","Hotel","11","32","0","0","0","0","0","0","1"
"6","2018","30","Hotel","14","27","3255","4799","666","984","3921","5783","1"
"6","2018","30","Otros","11","32","76","256","0","0","76","256","2.2857142857143"
"6","2018","30","Hotel","14","31","500","632","2925","3539","3425","4171","5.4"
"6","2018","30","Hotel","15","16","1024","1924","46","76","1070","2000","1"
"6","2018","30","Hotel","14","31","1047","1976","1190","5041","2237","7017","5.4"
"6","2018","30","Hotel","12","24","2650","3433","179","244","2829","3677","1"
"6","2018","30","Hotel","16","40","1050","1321","162","286","1212","1607","1"
"6","2018","30","Hotel","6","12","1680","2325","88","205","1768","2530","1"
"6","2018","30","Hotel","10","23","1091","1468","93","171","1184","1639","1"
"6","2018","30","Hotel","14","31","1526","3302","313","676","1839","3978","5.4"
"6","2018","30","Hotel","3","4","1170","2238","111","217","1281","2455","1"
"6","2018","30","","11","32","272","617","0","0","272","617","1"
"6","2018","30","Hotel","6","12","433","821","20","69","453","890","1"
"6","2018","30","Hotel","6","12","2502","3283","295","349","2797","3632","1"
"6","2018","30","Hotel","9","26","3574","6417","145","196","3719","6613","1"
"6","2018","30","Hotel","2","1","777","2284","31","273","808","2557","1"
"6","2018","30","Hotel","9","26","1207","2089","136","401","1343","2490","1"
"6","2018","30","Hotel","6","12","735","1277","58","133","793","1410","1"
"6","2018","30","Hotel","14","31","95","134","3796","7570","3891","7704","5.4"
"6","2018","30","Hotel","11","32","148","384","0","0","148","384","1"
"6","2018","30","Hotel","2","6","1198","1771","91","209","1289","1980","1"
"6","2018","30","Hotel","16","40","1225","2340","323","526","1548","2866","1"
"6","2018","30","Hotel","14","27","725","1191","1104","2083","1829","3274","1"
"6","2018","30","Otros","11","36","26","62","0","0","26","62","1"
"6","2018","30","Hotel","10","23","1478","2393","115","206","1593","2599","1"
"6","2018","30","Hotel","14","31","497","1417","400","2113","897","3530","7.8"
"6","2018","30","Hotel","7","17","302","609","36","87","338","696","1"
"6","2018","30","Hotel","2","1","1897","3354","0","0","1897","3354","2"
"6","2018","30","Hotel","2","1","1625","2354","133","413","1758","2767","2"
"6","2018","30","Hotel","4","13","1031","1917","44","77","1075","1994","1"
"6","2018","30","Hotel","2","1","1066","2145","66","224","1132","2369","2"
"6","2018","30","Hotel","10","27","2054","4504","257","495","2311","4999","1"
"6","2018","30","Hotel","14","27","1555","1698","1004","1260","2559","2958","1"
"6","2018","30","Hotel","14","27","2366","3193","900","1994","3266","5187","1"
"6","2018","30","Hotel","6","12","2146","2164","82","215","2228","2379","1"
"6","2018","30","Hotel","6","12","1557","1957","537","563","2094","2520","1"
"6","2018","30","Hotel","13","27","1873","3472","0","0","1873","3472","1"
"6","2018","30","Hotel","14","31","78","141","961","2774","1039","2915","7.8"
"6","2018","30","Hotel","6","12","1455","3773","297","778","1752","4551","1"
"6","2018","30","Hotel","16","27","2085","3752","163","214","2248","3966","1"
"6","2018","30","","10","27","4","6","0","0","4","6","1"
"6","2018","30","Hotel","10","18","637","1128","182","400","819","1528","1"
"6","2018","30","Hotel","9","37","1828","2636","166","242","1994","2878","1"
"6","2018","30","Hotel","16","27","487","1950","0","0","487","1950","1"
"6","2018","30","Hotel","15","16","1037","1908","51","114","1088","2022","2"
"6","2018","30","Hotel","2","1","1497","2397","305","493","1802","2890","2"
"6","2018","30","Hotel","3","4","599","1322","100","163","699","1485","1"
"6","2018","30","Hotel","16","40","1401","2064","565","772","1966","2836","1"
"6","2018","30","Hotel","7","17","3888","4471","145","162","4033","4633","1"
"6","2018","30","Hotel","12","24","797","1522","171","461","968","1983","1"
"6","2018","30","Hotel","12","35","394","687","87","168","481","855","1"
"6","2018","30","Hotel","2","6","386","1513","7","36","393","1549","1"
"6","2018","30","Hotel","13","33","1092","1558","44","97","1136","1655","1"
"6","2018","30","Hotel","10","27","1145","1333","591","735","1736","2068","1"
"6","2018","30","Hotel","10","23","1139","2032","233","416","1372","2448","1"
"6","2018","30","Hotel","11","36","1426","1831","86","109","1512","1940","1"
"6","2018","30","Hotel","8","34","1489","1969","96","183","1585","2152","1"
"6","2018","30","Hotel","2","6","398","1294","92","178","490","1472","1"
"6","2018","30","Hotel","14","31","549","771","1420","1917","1969","2688","7.8"
"6","2018","30","Hotel","11","36","2115","3408","91","141","2206","3549","1"
"6","2018","30","","10","27","434","883","221","499","655","1382","1"
"6","2018","30","Hotel","14","31","1192","5144","1572","5144","2764","10288","5.4"
"6","2018","30","Hotel","4","13","3004","3018","2","4","3006","3022","1"
"6","2018","30","Hotel","6","28","1355","1714","61","65","1416","1779","1"
"6","2018","30","Otros","14","31","8","39","14","420","22","459","2.8"
"6","2018","30","Otros","16","27","40","40","0","0","40","40","2"
"6","2018","30","Hotel","2","1","1013","1720","59","102","1072","1822","2"
"6","2018","30","Hotel","10","18","625","931","141","233","766","1164","1"
"6","2018","30","Hotel","7","17","924","1134","69","104","993","1238","1"
"6","2018","30","Hotel","12","24","934","1655","237","404","1171","2059","1"
"6","2018","30","Hotel","10","18","771","1358","79","141","850","1499","1"
"6","2018","30","Hotel","2","1","2355","2798","14","20","2369","2818","1"
"6","2018","30","Hotel","10","18","558","1077","152","333","710","1410","1"
"6","2018","30","Hotel","6","28","1453","1873","219","241","1672","2114","1"
"6","2018","30","Hotel","5","5","732","1282","75","101","807","1383","1"
"6","2018","30","Hotel","4","13","431","828","11","11","442","839","1"
"6","2018","30","Hotel","10","18","290","415","87","124","377","539","1"
"6","2018","30","Hotel","16","40","418","673","50","95","468","768","1"
"6","2018","30","Hotel","8","3","2235","4629","240","447","2475","5076","1"
"6","2018","30","Hotel","15","16","1115","1451","52","97","1167","1548","2"
"6","2018","30","Hotel","14","31","72","163","391","1403","463","1566","7.8"
"6","2018","30","Hotel","13","33","611","753","51","147","662","900","1"
"6","2018","30","Hotel","15","16","425","1089","84","202","509","1291","2"
"6","2018","30","Otros","4","21","299","456","1","2","300","458","1"
"6","2018","30","Hotel","6","10","713","1405","6","24","719","1429","1"
"6","2018","30","Hotel","16","19","75","83","0","0","75","83","1"
"6","2018","30","Hotel","16","27","790","2065","43","79","833","2144","1"
"6","2018","30","Hotel","10","11","1374","2263","74","89","1448","2352","1"
"6","2018","30","Otros","10","23","456","954","2","4","458","958","1"
"6","2018","0","Hotel","12","35","0","0","0","0","0","0","1"
"6","2018","30","Hotel","11","36","602","1081","25","39","627","1120","1"
"6","2018","30","Hotel","14","31","25","44","278","1953","303","1997","17.4"
"6","2018","30","Hotel","10","18","408","918","153","310","561","1228","3.2"
"6","2018","30","Hotel","4","13","104","184","30","97","134","281","1"
"6","2018","30","Hotel","6","12","271","399","35","49","306","448","5"
"6","2018","30","Hotel","6","10","576","796","73","126","649","922","1"
"6","2018","30","Otros","5","5","143","231","25","25","168","256","3.65625"
"6","2018","30","Hotel","12","24","841","1024","493","703","1334","1727","1"
"6","2018","30","Hotel","8","3","914","1716","116","216","1030","1932","1"
"6","2018","30","Hotel","13","27","482","752","0","0","482","752","2.75"
"6","2018","30","Hotel","15","16","170","740","29","160","199","900","4"
"6","2018","30","Otros","15","16","202","555","36","164","238","719","2"
"6","2018","30","Otros","16","20","139","189","0","0","139","189","1"
"6","2018","30","Hotel","3","4","441","521","0","0","441","521","1"
"6","2018","30","Hotel","11","36","38","51","0","0","38","51","1"
"6","2018","30","Hotel","2","6","672","1475","7","101","679","1576","1"
"6","2018","30","Hotel","8","34","687","1171","140","239","827","1410","1"
"6","2018","30","Hotel","4","13","25","46","0","0","25","46","3.2"
"6","2018","30","Hotel","13","27","1102","2393","3","6","1105","2399","2.75"
"6","2018","30","Hotel","2","29","931","1894","993","1958","1924","3852","1"
"6","2018","30","Otros","11","36","20","31","0","0","20","31","1"
"6","2018","30","","10","11","0","0","0","0","0","0","1"
"6","2018","30","Hotel","4","13","1061","1334","26","121","1087","1455","1"
"6","2018","30","Hotel","16","40","2212","3320","250","378","2462","3698","5.6666666666667"
"6","2018","30","Hotel","10","23","959","1571","101","167","1060","1738","2.8"
"6","2018","30","Hotel","8","34","943","1291","34","47","977","1338","1"
"6","2018","30","Hotel","5","5","321","1006","0","0","321","1006","1"
"6","2018","30","Hotel","3","4","56","146","45","96","101","242","3"
"6","2018","30","Hotel","9","26","19","30","0","0","19","30","1"
"6","2018","30","Hotel","8","34","343","443","64","753","407","1196","1"
"6","2018","30","Hotel","7","17","147","291","19","75","166","366","4"
"6","2018","30","Hotel","4","13","351","690","19","37","370","727","3.2"
"6","2018","30","Hotel","12","35","7","23","78","272","85","295","1"
"6","2018","30","Hotel","16","40","771","1120","378","724","1149","1844","1"
"6","2018","30","Hotel","9","26","424","832","59","324","483","1156","1"
"6","2018","30","","6","27","126","226","6","28","132","254","1"
"6","2018","30","Hotel","9","26","135","199","1","1","136","200","1"
"6","2018","30","Hotel","4","13","92","129","3","3","95","132","3.2"
"6","2018","30","Hotel","6","28","237","289","5","5","242","294","1"
"6","2018","30","","2","29","112","249","234","707","346","956","1"
"6","2018","30","Hotel","13","33","1320","1645","59","136","1379","1781","1"
"6","2018","30","Hotel","8","3","405","833","248","500","653","1333","1"
"6","2018","30","Hotel","14","27","1776","3520","735","1295","2511","4815","1"
"6","2018","30","Hotel","16","40","240","480","34","60","274","540","5.6666666666667"
"6","2018","30","Hotel","12","24","210","386","257","397","467","783","1"
"6","2018","30","Hotel","10","18","871","1679","65","131","936","1810","3.2"
"6","2018","30","Otros","15","16","110","110","0","0","110","110","9"
"6","2018","30","Hotel","6","10","545","594","2","4","547","598","1"
"6","2018","30","Hotel","10","11","548","813","48","582","596","1395","1"
"6","2018","30","Otros","6","10","96","464","0","0","96","464","3.8518518518518"
"6","2018","30","Otros","10","23","100","128","0","0","100","128","1"
"6","2018","30","Hotel","10","23","498","847","63","114","561","961","2.8"
"6","2018","30","Hotel","6","12","315","633","0","0","315","633","5"
"6","2018","30","Hotel","6","27","93","127","2","2","95","129","3"
"6","2018","30","Hotel","10","23","513","907","71","168","584","1075","2.8"
"6","2018","30","","4","39","353","721","0","0","353","721","1"
"6","2018","30","Hotel","8","34","142","202","17","33","159","235","1"
"6","2018","30","Hotel","8","34","381","616","17","28","398","644","1"
"6","2018","30","Otros","4","39","83","184","0","0","83","184","2.2222222222222"
"6","2018","30","Otros","13","14","104","208","0","0","104","208","1"
"6","2018","30","Hotel","10","23","146","221","8","53","154","274","2.8"
"6","2018","30","Otros","13","14","133","797","0","0","133","797","1"
"6","2018","30","Hotel","12","24","120","231","90","160","210","391","1"
"6","2018","30","","6","25","28","28","0","0","28","28","1"
"6","2018","30","Hotel","15","27","458","995","4","6","462","1001","1"
"6","2018","0","Hotel","12","35","0","0","0","0","0","0","1"
"6","2018","30","Hotel","16","40","75","82","120","185","195","267","1"
"6","2018","30","Hotel","16","27","156","302","566","1413","722","1715","1"
"6","2018","30","Hotel","9","30","84","324","0","0","84","324","1"
"6","2018","30","Hotel","4","13","404","1002","57","139","461","1141","3.2"
"6","2018","30","Hotel","2","29","153","457","239","588","392","1045","1"
"6","2018","30","Hotel","16","20","341","537","44","60","385","597","1"
"6","2018","30","Hotel","5","5","438","699","17","27","455","726","1"
"6","2018","30","Hotel","13","33","674","1066","69","146","743","1212","1"
"6","2018","30","Otros","16","19","73","100","3","5","76","105","1.3333333333333"
"6","2018","30","Hotel","12","24","136","356","120","365","256","721","1"
"6","2018","30","","8","2","457","855","6","16","463","871","1"
"6","2018","0","Hotel","12","35","0","0","0","0","0","0","1"
"6","2018","30","Hotel","16","27","18","33","54","63","72","96","2.5"
"6","2018","30","Otros","16","27","313","424","9","20","322","444","2"
"6","2018","30","Hotel","8","34","362","571","30","54","392","625","1"
"6","2018","30","Otros","8","3","24","72","0","0","24","72","1"
"6","2018","30","Hotel","7","27","196","330","70","175","266","505","1"
"6","2018","30","Hotel","4","39","263","475","1","1","264","476","1"
"6","2018","30","Hotel","15","16","235","475","14","28","249","503","4"
"6","2018","30","Hotel","4","39","5","7","5","15","10","22","1"
"6","2018","30","Hotel","4","39","184","389","4","8","188","397","1"
"6","2018","30","Hotel","15","16","162","885","18","26","180","911","4"
"6","2018","30","Hotel","14","31","68","138","193","585","261","723","17.4"
"6","2018","30","Hotel","8","34","236","324","20","30","256","354","1"
"6","2018","30","Hotel","6","28","194","271","9","10","203","281","1"
"6","2018","30","Hotel","7","17","897","1281","31","59","928","1340","4"
"6","2018","30","Otros","7","27","5","7","0","0","5","7","1"
"6","2018","30","Hotel","11","36","905","980","6","18","911","998","1"
"6","2018","30","Otros","4","21","183","270","46","66","229","336","1"
"6","2018","30","Otros","15","16","88","129","31","49","119","178","2"
"6","2018","30","Otros","7","17","174","344","0","0","174","344","3"
"6","2018","30","Hotel","7","38","39","56","0","0","39","56","1"
"6","2018","30","Hotel","16","27","460","577","11","42","471","619","2.5"
"6","2018","30","Hotel","2","6","37","49","2","2","39","51","2.2"
"6","2018","30","Hotel","11","36","258","409","27","58","285","467","1"
"6","2018","30","Hotel","6","28","10","25","0","0","10","25","1"
"6","2018","30","Hotel","6","12","204","395","0","0","204","395","5"
"6","2018","30","Otros","9","22","37","44","0","0","37","44","1"
"6","2018","30","","13","14","197","245","3","3","200","248","2"
"6","2018","30","Hotel","2","29","75","143","238","584","313","727","1"
"6","2018","30","Hotel","2","29","49","129","29","82","78","211","1"
"6","2018","30","Otros","4","13","339","364","8","8","347","372","1"
"6","2018","30","Hotel","15","16","93","243","32","82","125","325","4"
"6","2018","30","Hotel","2","1","199","539","1","12","200","551","6.4"
"6","2018","30","Otros","7","27","44","52","0","0","44","52","1"
"6","2018","30","Otros","13","33","26","26","5","5","31","31","5.125"
"6","2018","30","","4","21","179","206","0","0","179","206","1"
"6","2018","30","Hotel","6","10","334","334","2","2","336","336","1"
"6","2018","30","Hotel","11","36","255","593","5","10","260","603","1"
"6","2018","30","Otros","14","31","678","678","0","0","678","678","2.8"
"6","2018","30","Hotel","7","27","272","422","0","0","272","422","1"
"6","2018","30","Otros","6","10","37","253","0","0","37","253","3.8518518518518"
"6","2018","30","Hotel","4","39","34","40","1","1","35","41","2.6"
"6","2018","5","Otros","8","2","7","11","0","0","7","11","6.4285714285714"
"6","2018","30","Otros","11","36","17","35","5","5","22","40","5.1904761904762"
"6","2018","30","Hotel","13","33","231","231","0","0","231","231","1"
"6","2018","30","","3","4","70","89","57","72","127","161","1"
"6","2018","30","Hotel","7","17","329","743","42","98","371","841","4"
"6","2018","30","Hotel","8","2","73","77","0","0","73","77","1"
"6","2018","30","Otros","15","16","148","218","29","43","177","261","2"
"6","2018","30","Hotel","10","11","319","345","4","4","323","349","1"
"6","2018","30","Hotel","16","19","76","139","0","0","76","139","1"
"6","2018","30","Hotel","10","23","110","126","2","2","112","128","4"
"6","2018","30","","7","38","340","404","82","106","422","510","1"
"6","2018","30","Hotel","7","27","304","518","9","10","313","528","1"
"6","2018","30","Hotel","11","36","358","718","20","45","378","763","1"
"6","2018","30","Hotel","16","40","123","196","8","14","131","210","16.333333333333"
"6","2018","30","Hotel","16","19","22","24","0","0","22","24","1"
"6","2018","30","Hotel","16","19","0","0","0","0","0","0","1"
"6","2018","30","Hotel","16","20","0","0","0","0","0","0","1"
"6","2018","30","Hotel","10","11","214","370","7","18","221","388","1"
"6","2018","30","Otros","7","27","58","172","2","2","60","174","4.8333333333333"
"6","2018","30","Otros","7","27","51","176","0","0","51","176","1"
"6","2018","30","Hotel","7","27","35","54","0","0","35","54","4.1666666666667"
"6","2018","30","Otros","13","14","23","27","0","0","23","27","1"
"6","2018","30","Otros","11","15","48","48","0","0","48","48","2.3571428571429"
"6","2018","30","Otros","10","27","33","243","10","75","43","318","4.84"
"6","2018","30","Otros","14","31","2295","2295","125","125","2420","2420","2.8"
"6","2018","20","Otros","11","36","8","8","0","0","8","8","5.1904761904762"
"6","2018","30","Hotel","16","19","21","23","0","0","21","23","1"
"6","2018","30","","14","27","193","299","24","44","217","343","2.6666666666667"
"6","2018","30","Hotel","16","40","72","74","6","6","78","80","5.6666666666667"
"6","2018","30","Hotel","10","27","10","21","0","0","10","21","2.25"
"6","2018","30","Otros","2","29","45","117","117","322","162","439","3.28"
"6","2018","30","Hotel","13","27","5","10","3","9","8","19","1"
"6","2018","30","Otros","9","22","7","8","0","0","7","8","1"
"6","2018","30","Hotel","2","27","86","136","4","4","90","140","1"
"6","2018","30","Hotel","8","34","329","459","59","98","388","557","1"
"6","2018","30","Hotel","7","27","564","756","2","2","566","758","1"
"6","2018","30","Hotel","15","16","202","364","26","64","228","428","4"
"6","2018","30","Hotel","16","20","25","32","1","1","26","33","1"
"6","2018","30","Otros","4","13","73","185","3","3","76","188","1"
"6","2018","30","Hotel","2","1","254","749","2","2","256","751","6.4"
"6","2018","30","Otros","11","32","7","9","0","0","7","9","2.2857142857143"
"6","2018","30","Hotel","2","29","25","53","718","1416","743","1469","1"
"6","2018","30","Hotel","16","27","165","176","56","72","221","248","2.5"
"6","2018","30","Hotel","10","18","16","52","4","4","20","56","3.2"
"6","2018","30","Otros","11","36","268","299","0","0","268","299","1"
"6","2018","30","Otros","13","14","19","23","0","0","19","23","1"
"6","2018","0","Hotel","7","27","0","0","0","0","0","0","1"
"6","2018","30","Otros","7","17","44","57","1","3","45","60","3"
"6","2018","30","Otros","14","31","193","273","49","102","242","375","2.8"
"6","2018","30","Hotel","2","29","347","993","157","668","504","1661","1"
"6","2018","0","Hotel","8","3","0","0","0","0","0","0","1"
"6","2018","30","Hotel","8","34","232","304","24","46","256","350","2.5714285714286"
"6","2018","30","Hotel","8","34","233","291","24","48","257","339","2.5714285714286"
"6","2018","30","Hotel","12","35","147","179","109","140","256","319","1"
"6","2018","0","Hotel","11","32","0","0","0","0","0","0","1"
"6","2018","30","Hotel","13","33","117","180","0","0","117","180","2"
"6","2018","30","Hotel","10","23","127","207","18","36","145","243","2.8"
"6","2018","30","Hotel","12","35","57","97","7","8","64","105","1"
"6","2018","30","","16","40","188","303","4","4","192","307","3.0555555555556"
"6","2018","30","Otros","16","19","2","3","0","0","2","3","1.3333333333333"
"6","2018","30","Otros","16","20","55","220","0","0","55","220","1"
"6","2018","30","Hotel","6","12","138","261","6","10","144","271","5"
"6","2018","30","Hotel","16","19","112","129","0","0","112","129","4"
"6","2018","30","Hotel","12","24","176","313","147","228","323","541","1"
"6","2018","30","Hotel","12","24","162","318","27","34","189","352","3"
"6","2018","30","Hotel","8","3","0","0","0","0","0","0","1"
"6","2018","0","Hotel","5","9","0","0","0","0","0","0","1"
"6","2018","30","Hotel","16","27","137","193","2","2","139","195","2.5"
"6","2018","30","Otros","10","23","51","51","0","0","51","51","7"
"6","2018","30","Otros","13","14","51","62","0","0","51","62","7.3846153846154"
"6","2018","30","Otros","2","6","55","75","6","6","61","81","1"
"6","2018","25","Hotel","15","16","7","9","31","38","38","47","7.8"
"6","2018","30","Hotel","8","3","69","371","0","0","69","371","1"
"6","2018","30","Hotel","8","34","326","461","2","2","328","463","1"
"6","2018","30","Hotel","8","3","25","53","5","5","30","58","1"
"6","2018","30","","2","29","59","145","25","86","84","231","1"
"6","2018","30","Hotel","2","1","140","197","2","3","142","200","6.4"
"6","2018","30","Hotel","7","17","57","91","0","0","57","91","4"
"6","2018","30","Otros","7","17","157","406","0","0","157","406","3"
"6","2018","30","Hotel","16","40","97","130","3","5","100","135","5.6666666666667"
"6","2018","30","Hotel","12","24","144","332","40","90","184","422","1"
"6","2018","30","Hotel","14","31","125","236","269","1203","394","1439","17.4"
"6","2018","0","Hotel","9","26","0","0","0","0","0","0","1"
"6","2018","30","Hotel","6","12","266","439","17","25","283","464","5"
"6","2018","30","Otros","5","9","6","6","0","0","6","6","4.0454545454545"
"6","2018","30","Otros","5","9","2","2","0","0","2","2","4.0454545454545"
"6","2018","30","Otros","15","27","54","76","0","0","54","76","1.4222222222222"
"6","2018","30","Hotel","8","34","13","13","1","1","14","14","2.5714285714286"
"6","2018","30","Hotel","10","18","297","538","51","108","348","646","7.75"
"6","2018","30","Hotel","15","16","298","522","33","92","331","614","7.8"
"6","2018","30","Hotel","2","29","117","314","215","681","332","995","1"
"6","2018","30","Hotel","4","39","69","69","2","2","71","71","2.6"
"6","2018","30","Otros","4","39","80","104","3","3","83","107","2.2222222222222"
"6","2018","30","Hotel","4","13","128","233","17","149","145","382","5.4"
"6","2018","30","Otros","10","23","35","35","0","0","35","35","7"
"6","2018","30","Otros","14","31","133","179","138","338","271","517","20.2"
"6","2018","30","Hotel","3","4","50","51","7","7","57","58","2.6"
"6","2018","30","Hotel","10","23","98","255","10","38","108","293","4"
"6","2018","30","Otros","9","22","162","542","0","0","162","542","1"
"6","2018","30","Hotel","12","24","152","352","27","64","179","416","3"
"6","2018","30","Hotel","13","14","12","28","0","0","12","28","1"
"6","2018","30","Hotel","12","35","58","91","8","10","66","101","1.7272727272727"
"6","2018","30","Hotel","6","28","342","547","0","0","342","547","1"
"6","2018","30","","6","28","107","357","0","0","107","357","1"
"6","2018","30","Hotel","12","24","317","830","147","576","464","1406","3"
"6","2018","30","Otros","5","9","8","11","1","1","9","12","4.0454545454545"
"6","2018","30","Hotel","16","20","36","63","1","2","37","65","1"
"6","2018","30","Hotel","4","21","162","257","11","20","173","277","3"
"6","2018","30","Otros","10","11","26","37","3","4","29","41","11.764705882353"
"6","2018","30","Otros","13","14","10","10","0","0","10","10","7.3846153846154"
"6","2018","30","Otros","16","27","34","52","0","0","34","52","13.818181818182"
"6","2018","12","Hotel","9","26","552","552","0","0","552","552","1"
"6","2018","30","Hotel","16","27","601","613","217","224","818","837","2.5"
"6","2018","30","Hotel","3","4","1134","2127","105","208","1239","2335","3"
"6","2018","30","Otros","16","27","20","40","0","0","20","40","2"
"6","2018","30","Otros","16","19","276","333","0","0","276","333","1.3333333333333"
"6","2018","30","Hotel","6","12","473","683","0","0","473","683","5"
"6","2018","30","Hotel","2","1","317","475","17","18","334","493","6.4"
"6","2018","30","Hotel","10","11","376","556","12","14","388","570","1"
"6","2018","30","Otros","10","23","39","39","0","0","39","39","1"
"6","2018","30","Otros","10","27","462","502","2","3","464","505","4.84"
"6","2018","30","Hotel","16","27","281","431","23","87","304","518","2.5"
"6","2018","30","Hotel","6","28","128","149","3","3","131","152","1"
"6","2018","30","Hotel","4","13","46","120","9","11","55","131","5.4"
"6","2018","30","Hotel","14","27","517","794","12","17","529","811","8.5"
"6","2018","30","Hotel","10","27","105","180","44","53","149","233","1"
"6","2018","30","Hotel","13","27","251","339","37","51","288","390","4.2"
"6","2018","30","Hotel","3","4","525","709","15","33","540","742","3"
"6","2018","30","Otros","4","13","91","153","3","3","94","156","3.4"
"6","2018","30","Otros","11","15","18","28","0","0","18","28","2.3571428571429"
"6","2018","30","Otros","6","10","318","638","0","0","318","638","3.8518518518518"
"6","2018","30","Otros","2","1","45","68","2","4","47","72","1"
"6","2018","30","","6","12","36","135","1","4","37","139","1"
"6","2018","30","Otros","10","23","236","856","4","16","240","872","1"
"6","2018","30","Hotel","16","19","61","79","0","0","61","79","4"
"6","2018","30","Hotel","10","11","3","7","0","0","3","7","5.6666666666667"
"6","2018","30","Hotel","10","23","57","58","1","1","58","59","4"
"6","2018","30","Otros","14","31","13","36","148","382","161","418","2.8"
"6","2018","30","Otros","13","27","1","1","0","0","1","1","12.2"
"6","2018","30","Hotel","2","1","198","790","0","0","198","790","6.4"
"6","2018","8","Hotel","16","19","28","32","0","0","28","32","4"
"6","2018","30","Otros","12","35","4","5","0","0","4","5","3.5"
"6","2018","30","Otros","15","16","76","149","8","12","84","161","2"
"6","2018","30","Otros","9","22","74","148","0","0","74","148","1"
"6","2018","30","Hotel","10","27","271","516","102","110","373","626","1"
"6","2018","30","Hotel","2","27","58","88","2","2","60","90","3.6"
"6","2018","30","Hotel","16","20","34","69","2","4","36","73","1"
"6","2018","30","Hotel","10","18","122","240","18","31","140","271","7.75"
"6","2018","30","Hotel","6","12","223","223","0","0","223","223","5"
"6","2018","30","Hotel","2","27","61","277","2","2","63","279","3.6"
"6","2018","30","Hotel","15","16","115","173","18","47","133","220","7.8"
"6","2018","30","Hotel","10","23","48","48","19","19","67","67","4"
"6","2018","30","Hotel","11","32","15","18","0","0","15","18","1"
"6","2018","30","Hotel","14","27","172","352","12","88","184","440","8.5"
"6","2018","30","Otros","10","11","12","12","0","0","12","12","11.764705882353"
"6","2018","30","Hotel","2","27","42","50","0","0","42","50","3.6"
"6","2018","30","Otros","13","14","125","181","0","0","125","181","7.3846153846154"
"6","2018","30","Hotel","2","1","101","129","4","4","105","133","6.4"
"6","2018","30","Otros","7","17","171","367","0","0","171","367","17.166666666667"
"6","2018","30","Otros","10","23","52","164","0","0","52","164","7"
"6","2018","30","Hotel","13","27","113","113","0","0","113","113","2.75"
"6","2018","30","Otros","10","18","28","124","2","2","30","126","10.25"
"6","2018","30","Otros","5","9","30","94","0","0","30","94","4.0454545454545"
"6","2018","30","Hotel","4","39","69","81","0","0","69","81","2.6"
"6","2018","30","Otros","16","27","42","140","0","0","42","140","13.818181818182"
"6","2018","30","Hotel","14","27","15","54","14","46","29","100","8.5"
"6","2018","30","Hotel","10","11","98","161","13","18","111","179","5.6666666666667"
"6","2018","30","Hotel","10","18","119","241","14","29","133","270","7.75"
"6","2018","30","Otros","14","31","161","239","77","200","238","439","20.2"
"6","2018","30","Otros","11","32","12","24","0","0","12","24","2.2857142857143"
"6","2018","30","Otros","5","5","36","50","0","0","36","50","3.65625"
"6","2018","30","Otros","6","25","19","19","0","0","19","19","2.3846153846154"
"6","2018","30","Hotel","3","4","33","88","4","12","37","100","2.6"
"6","2018","30","Otros","7","27","24","56","0","0","24","56","4.8333333333333"
"6","2018","30","Otros","2","29","70","165","79","145","149","310","3.28"
"6","2018","30","Hotel","2","29","31","52","113","477","144","529","1"
"6","2018","30","Otros","4","21","46","66","0","0","46","66","1"
"6","2018","30","Hotel","7","27","231","252","0","0","231","252","4.1666666666667"
"6","2018","30","Otros","5","5","12","84","0","0","12","84","3.65625"
"6","2018","30","Otros","11","36","26","43","5","7","31","50","5.1904761904762"
"6","2018","30","Hotel","7","27","315","315","0","0","315","315","4.1666666666667"
"6","2018","0","Hotel","16","20","0","0","0","0","0","0","1"
"6","2018","30","Hotel","12","24","224","299","3","7","227","306","3"
"6","2018","30","Hotel","9","26","116","167","2","2","118","169","1.5"
"6","2018","30","Hotel","7","17","192","403","1","2","193","405","10"
"6","2018","30","Hotel","9","37","135","214","31","99","166","313","3.4"
"6","2018","30","Hotel","5","5","255","447","21","39","276","486","2.1428571428571"
"6","2018","30","Otros","6","27","44","88","0","0","44","88","3.960088691796"
"6","2018","30","Hotel","9","37","37","45","2","2","39","47","3.4"
"6","2018","30","Otros","10","27","40","40","20","24","60","64","4.84"
"6","2018","30","Otros","8","3","121","201","2","2","123","203","10"
"6","2018","30","Otros","16","20","20","22","0","0","20","22","3.0769230769231"
"6","2018","30","Otros","9","22","7","9","0","0","7","9","7.6428571428571"
"6","2018","30","Otros","10","27","167","211","2","2","169","213","4.84"
"6","2018","30","Otros","10","23","39","47","0","0","39","47","7"
"6","2018","30","Otros","2","6","459","459","70","70","529","529","1"
"6","2018","30","Otros","4","39","29","44","0","0","29","44","2.2222222222222"
"6","2018","30","Hotel","2","27","58","76","3","3","61","79","1"
"6","2018","30","Hotel","14","31","52","191","82","754","134","945","24"
"6","2018","30","Otros","2","29","167","310","136","200","303","510","3.28"
"6","2018","30","Otros","8","3","264","1320","0","0","264","1320","10"
"6","2018","30","","13","14","7","15","0","0","7","15","1"
"6","2018","30","Hotel","6","10","124","155","4","6","128","161","6.6"
"6","2018","30","Hotel","8","34","47","53","9","14","56","67","2.5714285714286"
"6","2018","30","Hotel","9","22","210","1005","0","0","210","1005","2.5555555555556"
"6","2018","30","Hotel","2","6","72","154","27","31","99","185","2.2"
"6","2018","30","Hotel","10","27","132","299","12","12","144","311","2.25"
"6","2018","30","Otros","14","27","133","133","0","0","133","133","11.833333333333"
"6","2018","30","Otros","6","12","288","473","12","34","300","507","1.8256578947368"
"6","2018","30","Hotel","6","27","112","160","0","0","112","160","3"
"6","2018","30","Hotel","5","5","15","23","1","1","16","24","2.1428571428571"
"6","2018","30","Hotel","5","5","47","119","1","3","48","122","2.1428571428571"
"6","2018","30","Hotel","13","27","307","320","0","0","307","320","4.2"
"6","2018","30","Hotel","2","27","129","179","0","0","129","179","3.6"
"6","2018","30","Hotel","8","3","46","46","34","34","80","80","4.1111111111111"
"6","2018","30","Otros","11","36","38","63","0","0","38","63","5.1904761904762"
"6","2018","30","Otros","9","30","90","136","0","0","90","136","2.3333333333333"
"6","2018","30","Otros","16","19","1","2","0","0","1","2","10.263157894737"
"6","2018","30","Hotel","14","31","99","158","238","709","337","867","17.4"
"6","2018","30","Hotel","2","1","261","287","8","10","269","297","6.4"
"6","2018","30","Hotel","16","40","802","1379","145","180","947","1559","5.6666666666667"
"6","2018","30","Otros","7","17","198","345","0","0","198","345","17.166666666667"
"6","2018","30","Hotel","13","27","228","307","98","163","326","470","2.75"
"6","2018","30","Hotel","14","31","133","218","261","437","394","655","24"
"6","2018","30","Otros","3","4","41","108","4","13","45","121","12.2"
"6","2018","30","Otros","8","34","185","271","35","46","220","317","5.75"
"6","2018","30","Hotel","9","22","49","61","0","0","49","61","2.5555555555556"
"6","2018","30","Hotel","4","21","32","35","1","2","33","37","3"
"6","2018","30","Hotel","6","27","49","79","0","0","49","79","3"
"6","2018","30","Hotel","12","35","207","307","37","74","244","381","1.7272727272727"
"6","2018","30","Hotel","2","29","20","55","31","56","51","111","2"
"6","2018","30","Otros","10","11","41","63","21","21","62","84","11.764705882353"
"6","2018","30","Hotel","6","10","9","21","0","0","9","21","6.6"
"6","2018","30","Hotel","13","14","54","64","0","0","54","64","2"
"6","2018","10","Otros","16","27","112","135","0","0","112","135","13.818181818182"
"6","2018","30","Otros","6","27","19","23","0","0","19","23","3.960088691796"
"6","2018","30","Hotel","16","40","254","503","39","77","293","580","5.6666666666667"
"6","2018","30","Otros","6","10","168","202","0","0","168","202","3.8518518518518"
"6","2018","30","Otros","10","23","18","65","2","3","20","68","7"
"6","2018","30","Hotel","6","28","169","210","11","11","180","221","1"
"6","2018","30","Otros","7","38","280","559","111","164","391","723","2.75"
"6","2018","30","Hotel","6","12","188","239","0","0","188","239","5"
"6","2018","30","Hotel","13","27","285","401","2","2","287","403","4.2"
"6","2018","30","Otros","4","21","2","5","0","0","2","5","4.8333333333333"
"6","2018","30","Hotel","16","27","64","148","5","13","69","161","5.8571428571429"
"6","2018","30","Hotel","5","5","46","112","5","7","51","119","2.1428571428571"
"6","2018","30","Otros","12","24","92","218","25","30","117","248","9.2"
"6","2018","30","Otros","15","16","47","68","5","7","52","75","9"
"6","2018","30","Hotel","8","27","91","91","0","0","91","91","4.5"
"6","2018","30","Hotel","9","22","1","2","0","0","1","2","2.5555555555556"
"6","2018","30","Hotel","10","11","85","144","2","5","87","149","5.6666666666667"
"6","2018","30","Hotel","8","3","6","12","1","1","7","13","4.1111111111111"
"6","2018","30","Hotel","6","10","282","404","0","0","282","404","6.6"
"6","2018","30","Otros","9","26","29","386","2","2","31","388","3.8888888888889"
"6","2018","30","Hotel","4","39","70","180","8","105","78","285","2.6"
"6","2018","30","Otros","6","27","2","3","0","0","2","3","3.960088691796"
"6","2018","30","Otros","6","12","134","195","0","0","134","195","1.8256578947368"
"6","2018","30","Hotel","6","27","140","277","2","3","142","280","3"
"6","2018","30","Otros","5","9","36","36","4","4","40","40","4.0454545454545"
"6","2018","30","Hotel","2","27","103","103","5","5","108","108","3.6"
"6","2018","5","Hotel","2","29","10","35","35","89","45","124","1"
"6","2018","30","Hotel","4","13","159","443","0","0","159","443","5.4"
"6","2018","30","","11","15","22","36","0","0","22","36","1"
"6","2018","30","Hotel","6","10","321","341","11","14","332","355","6.6"
"6","2018","30","Otros","6","12","15","30","0","0","15","30","1.8256578947368"
"6","2018","30","Otros","10","18","45","90","0","0","45","90","10.25"
"6","2018","30","Otros","9","22","108","165","0","0","108","165","7.6428571428571"
"6","2018","30","","14","27","237","487","29","59","266","546","1"
"6","2018","30","Hotel","16","27","65","76","1","1","66","77","5.8571428571429"
"6","2018","7","Otros","2","29","2","4","3","3","5","7","3.28"
"6","2018","30","Otros","13","33","42","44","0","0","42","44","5.125"
"6","2018","30","Otros","13","33","18","24","0","0","18","24","5.125"
"6","2018","30","Otros","6","10","72","701","0","0","72","701","3.8518518518518"
"6","2018","30","Hotel","10","18","67","101","12","21","79","122","7.75"
"6","2018","30","Hotel","14","31","92","139","31","114","123","253","24"
"6","2018","30","Hotel","4","21","59","59","6","6","65","65","3"
"6","2018","30","Hotel","3","4","52","207","0","0","52","207","2.6"
"6","2018","0","Otros","8","27","0","0","0","0","0","0","1"
"6","2018","30","Otros","6","27","13","37","0","0","13","37","3.960088691796"
"6","2018","30","Hotel","6","25","164","291","3","5","167","296","1"
"6","2018","30","Otros","6","12","169","399","1","5","170","404","1.8256578947368"
"6","2018","30","Hotel","6","27","7","7","0","0","7","7","3"
"6","2018","30","Otros","6","27","28","46","0","0","28","46","3.960088691796"
"6","2018","30","Otros","6","10","64","129","0","0","64","129","3.8518518518518"
"6","2018","30","Otros","6","12","28","40","0","0","28","40","1.8256578947368"
"6","2018","30","Otros","5","5","4","4","0","0","4","4","3.65625"
"6","2018","30","Hotel","12","24","55","290","5","49","60","339","3"
"6","2018","30","Hotel","15","16","69","132","0","0","69","132","7.8"
"6","2018","30","Otros","4","13","67","89","0","0","67","89","3.4"
"6","2018","30","Hotel","2","29","103","345","17","83","120","428","1"
"6","2018","30","Hotel","4","21","32","67","0","0","32","67","3"
"6","2018","30","Hotel","10","27","100","141","15","35","115","176","2.25"
"6","2018","30","Hotel","8","3","141","186","16","74","157","260","4.1111111111111"
"6","2018","30","Hotel","12","27","62","92","2","2","64","94","1"
"6","2018","30","Otros","5","5","69","138","31","62","100","200","3.65625"
"6","2018","30","Otros","13","14","5","5","0","0","5","5","7.3846153846154"
"6","2018","30","Otros","10","11","136","323","23","23","159","346","11.764705882353"
"6","2018","30","Otros","16","40","66","86","1","4","67","90","28.142857142857"
"6","2018","30","Hotel","11","36","119","244","8","12","127","256","1"
"6","2018","30","Otros","8","34","47","66","12","22","59","88","5.75"
"6","2018","30","Hotel","7","17","52","72","0","0","52","72","10"
"6","2018","30","Otros","12","35","148","332","5","7","153","339","3.5"
"6","2018","30","Otros","5","9","14","19","0","0","14","19","4.0454545454545"
"6","2018","23","Hotel","9","22","32","37","2","2","34","39","2.5555555555556"
"6","2018","30","Otros","2","29","25","50","35","56","60","106","3.28"
"6","2018","30","Otros","2","29","60","60","39","39","99","99","3.28"
"6","2018","30","Hotel","10","27","68","124","6","6","74","130","2.25"
"6","2018","30","Hotel","16","19","68","85","2","5","70","90","4"
"6","2018","30","Hotel","16","40","83","108","0","0","83","108","16.333333333333"
"6","2018","30","Hotel","8","27","177","276","25","27","202","303","4.5"
"6","2018","30","Otros","13","14","7","12","0","0","7","12","7.3846153846154"
"6","2018","30","Hotel","7","27","24","29","0","0","24","29","4.1666666666667"
"6","2018","30","Otros","2","6","26","346","0","0","26","346","5"
"6","2018","30","Hotel","7","17","276","465","0","0","276","465","10"
"6","2018","30","Hotel","3","4","99","210","10","20","109","230","2.6"
"6","2018","30","Otros","6","12","6","42","0","0","6","42","1.8256578947368"
"6","2018","30","Otros","6","10","2","2","0","0","2","2","3.8518518518518"
"6","2018","30","Hotel","16","40","21","33","4","7","25","40","16.333333333333"
"6","2018","30","Otros","4","39","29","62","2","2","31","64","2.2222222222222"
"6","2018","30","Otros","13","14","5","5","0","0","5","5","7.3846153846154"
"6","2018","30","Otros","7","38","29","50","3","3","32","53","2.75"
"6","2018","30","Hotel","11","32","102","178","6","10","108","188","1"
"6","2018","30","Otros","11","36","85","197","2","2","87","199","5.1904761904762"
"6","2018","30","Hotel","4","21","25","46","0","0","25","46","3"
"6","2018","30","Otros","3","4","14","31","0","0","14","31","12.2"
"6","2018","30","Otros","5","9","35","55","23","46","58","101","4.0454545454545"
"6","2018","30","Hotel","8","27","80","198","0","0","80","198","4.5"
"6","2018","30","","7","17","56","82","0","0","56","82","1"
"6","2018","30","Otros","16","20","10","29","0","0","10","29","3.0769230769231"
"6","2018","30","Otros","4","21","23","41","0","0","23","41","4.8333333333333"
"6","2018","30","Otros","13","33","45","53","11","14","56","67","5.125"
"6","2018","0","","12","35","0","0","0","0","0","0","1"
"6","2018","30","Hotel","13","33","0","0","1","2","1","2","2"
"6","2018","30","Otros","4","39","12","16","0","0","12","16","2.2222222222222"
"6","2018","30","Otros","10","18","7","15","1","2","8","17","10.25"
"6","2018","30","Otros","6","27","73","113","0","0","73","113","3.960088691796"
"6","2018","30","Hotel","4","39","62","217","0","0","62","217","2.6"
"6","2018","30","Otros","14","31","154","258","68","248","222","506","20.2"
"6","2018","30","Hotel","2","29","40","86","42","89","82","175","2"
"6","2018","30","Hotel","9","26","75","122","4","9","79","131","1.5"
"6","2018","30","Otros","12","35","2","2","2","2","4","4","3.5"
"6","2018","30","Hotel","14","27","96","119","15","24","111","143","8.5"
"6","2018","30","Otros","11","36","16","34","0","0","16","34","5.1904761904762"
"6","2018","30","Otros","16","20","122","226","6","6","128","232","3.0769230769231"
"6","2018","30","Otros","4","39","9","9","0","0","9","9","2.2222222222222"
"6","2018","30","Otros","7","27","95","99","1","1","96","100","4.8333333333333"
"6","2018","30","Otros","6","27","63","75","0","0","63","75","3.960088691796"
"6","2018","30","Otros","5","8","15","300","0","0","15","300","5"
"6","2018","30","Otros","9","37","104","130","8","16","112","146","4.5"
"6","2018","30","Hotel","2","6","59","218","0","0","59","218","5.5"
"6","2018","30","Hotel","10","27","116","131","13","13","129","144","2.25"
"6","2018","30","Hotel","9","30","137","272","9","18","146","290","1"
"6","2018","30","Otros","4","13","73","73","0","0","73","73","3.4"
"6","2018","30","Hotel","5","5","262","262","0","0","262","262","1"
"6","2018","30","Otros","7","38","115","250","5","16","120","266","2.75"
"6","2018","30","Hotel","13","14","20","27","11","11","31","38","1"
"6","2018","30","Otros","5","9","52","74","0","0","52","74","4.0454545454545"
"6","2018","30","Otros","5","8","1","1","0","0","1","1","5"
"6","2018","30","Otros","10","27","16","480","0","0","16","480","4.84"
"6","2018","30","Hotel","13","14","6","10","0","0","6","10","1"
"6","2018","30","Otros","11","15","0","0","3","17","3","17","2.3571428571429"
"6","2018","30","Hotel","9","22","185","328","0","0","185","328","2.5555555555556"
"6","2018","30","Otros","11","36","94","143","6","6","100","149","5.1904761904762"
"6","2018","30","Hotel","10","18","2241","3882","591","1326","2832","5208","1"
"6","2018","30","Hotel","6","12","330","394","0","0","330","394","5"
"6","2018","30","","2","29","372","922","138","361","510","1283","1"
"6","2018","30","Hotel","16","27","1966","3934","32","70","1998","4004","1"
"6","2018","30","","14","31","369","774","161","923","530","1697","1"
"6","2018","30","Hotel","8","3","1","2","0","0","1","2","4.1111111111111"
"6","2018","30","Otros","13","33","180","180","0","0","180","180","5.125"
"6","2018","30","","14","27","68","111","4","4","72","115","2.6666666666667"
"6","2018","30","Otros","9","22","40","240","0","0","40","240","7.6428571428571"
"6","2018","30","Hotel","10","11","12","12","4","4","16","16","5.6666666666667"
"6","2018","30","Otros","6","12","12","15","0","0","12","15","1.8256578947368"
"6","2018","30","Hotel","8","3","73","73","10","19","83","92","4.1111111111111"
"6","2018","30","Otros","6","12","127","172","0","0","127","172","1.8256578947368"
"6","2018","30","Hotel","8","27","196","196","0","0","196","196","4.5"
"6","2018","30","Hotel","6","28","189","246","11","12","200","258","2.4"
"6","2018","30","Otros","6","25","8","32","0","0","8","32","2.3846153846154"
"6","2018","30","Otros","6","25","18","24","0","0","18","24","2.3846153846154"
"6","2018","30","Hotel","11","36","511","1445","0","0","511","1445","1"
"6","2018","30","Otros","2","6","24","70","159","451","183","521","5"
"6","2018","30","Hotel","14","31","59","68","47","187","106","255","24"
"6","2018","30","Otros","4","21","51","57","0","0","51","57","4.8333333333333"
"6","2018","15","Otros","7","38","11","18","0","0","11","18","2.75"
"6","2018","30","Otros","13","14","19","26","0","0","19","26","7.3846153846154"
"6","2018","30","Otros","2","29","10","12","2","2","12","14","3.28"
"6","2018","30","Otros","3","4","101","101","17","17","118","118","12.2"
"6","2018","30","Hotel","3","4","306","709","26","59","332","768","3"
"6","2018","30","Otros","7","27","128","129","7","7","135","136","1"
"6","2018","30","Otros","7","17","45","45","0","0","45","45","3"
"6","2018","30","Hotel","12","27","189","289","2","3","191","292","1"
"6","2018","30","Otros","5","5","22","26","0","0","22","26","3.65625"
"6","2018","30","Hotel","6","10","171","211","0","0","171","211","6.6"
"6","2018","30","Otros","10","18","2","2","7","15","9","17","10.25"
"6","2018","30","Otros","8","27","46","75","0","0","46","75","9.4"
"6","2018","30","Otros","8","3","5","7","0","0","5","7","10"
"6","2018","30","Hotel","16","27","87","165","0","0","87","165","5.8571428571429"
"6","2018","30","Otros","6","10","32","76","0","0","32","76","3.8518518518518"
"6","2018","30","Hotel","2","6","13","19","0","0","13","19","5.5"
"6","2018","30","Hotel","8","3","2","4","0","0","2","4","4.1111111111111"
"6","2018","30","Otros","10","11","17","17","0","0","17","17","11.764705882353"
"6","2018","30","Otros","6","27","2","3","0","0","2","3","3.960088691796"
"6","2018","29","Otros","15","16","6","12","0","0","6","12","9"
"6","2018","30","Otros","5","5","16","18","16","16","32","34","3.65625"
"6","2018","30","Otros","10","27","25","32","1","1","26","33","4.84"
"6","2018","30","Hotel","7","38","44","82","0","0","44","82","1"
"6","2018","30","Hotel","13","27","8","128","0","0","8","128","4.2"
"6","2018","30","Hotel","16","20","22","22","0","0","22","22","1"
"6","2018","30","Otros","10","27","68","91","14","16","82","107","4.84"
"6","2018","30","Hotel","3","7","31","62","4","6","35","68","1"
"6","2018","10","Otros","2","29","9","16","2","4","11","20","3.28"
"6","2018","30","Otros","10","18","7","13","0","0","7","13","10.25"
"6","2018","30","Otros","9","22","112","254","0","0","112","254","7.6428571428571"
"6","2018","30","Otros","15","27","34","34","6","6","40","40","1.4222222222222"
"6","2018","30","Otros","11","36","4","6","0","0","4","6","5.1904761904762"
"6","2018","30","Otros","5","5","15","26","1","2","16","28","3.65625"
"6","2018","30","Otros","2","29","12","34","18","66","30","100","3.28"
"6","2018","30","Hotel","9","22","144","144","2","2","146","146","2.5555555555556"
"6","2018","30","Otros","11","32","6","13","0","0","6","13","2.2857142857143"
"6","2018","30","Hotel","10","27","213","375","42","54","255","429","1"
"6","2018","30","Otros","16","27","65","92","0","0","65","92","2"
"6","2018","30","Hotel","16","20","18","32","0","0","18","32","1"
"6","2018","30","Otros","11","15","23","45","0","0","23","45","2.3571428571429"
"6","2018","30","Otros","7","17","138","681","0","0","138","681","3"
"6","2018","30","Otros","5","8","1","30","0","0","1","30","5"
"6","2018","30","Hotel","13","33","55","70","0","0","55","70","2"
"6","2018","30","Otros","5","9","21","29","6","6","27","35","4.0454545454545"
"6","2018","30","Otros","10","27","94","125","17","17","111","142","4.84"
"6","2018","30","Otros","9","22","6","6","0","0","6","6","7.6428571428571"
"6","2018","30","Otros","16","40","80","164","1","2","81","166","28.142857142857"
"6","2018","30","Hotel","16","40","45","47","24","24","69","71","1"
"6","2018","30","Otros","15","16","32","94","0","0","32","94","9"
"6","2018","30","Hotel","8","2","19","23","1","1","20","24","3"
"6","2018","30","Otros","8","3","12","20","0","0","12","20","10"
"6","2018","30","Otros","7","17","51","60","0","0","51","60","17.166666666667"
"6","2018","30","Otros","16","20","32","54","0","0","32","54","3.0769230769231"
"6","2018","30","Otros","6","27","11","18","0","0","11","18","3.960088691796"
"6","2018","30","Otros","12","35","17","38","8","11","25","49","3.5"
"6","2018","30","Otros","6","28","95","324","4","6","99","330","4.65"
"6","2018","30","Otros","6","28","150","359","7","12","157","371","4.65"
"6","2018","30","Hotel","8","34","108","151","17","56","125","207","2.5714285714286"
"6","2018","30","Hotel","16","20","399","877","5","9","404","886","1"
"6","2018","30","Hotel","2","6","350","755","0","0","350","755","2.2"
"6","2018","30","Hotel","7","27","50","750","0","0","50","750","4.1666666666667"
"6","2018","30","Hotel","10","23","133","170","0","0","133","170","4"
"6","2018","30","Hotel","9","26","46","52","4","4","50","56","1.5"
"6","2018","30","Otros","8","27","14","26","0","0","14","26","9.4"
"6","2018","30","Otros","10","27","5","7","0","0","5","7","4.84"
"6","2018","30","Otros","11","15","5","5","0","0","5","5","2.3571428571429"
"6","2018","30","Otros","16","20","20","30","0","0","20","30","3.0769230769231"
"6","2018","30","Otros","11","32","67","131","0","0","67","131","1"
"6","2018","30","Otros","16","27","69","69","0","0","69","69","13.818181818182"
"6","2018","30","Otros","9","37","94","94","0","0","94","94","4.5"
"6","2018","30","Hotel","2","29","10","26","19","65","29","91","2"
"6","2018","30","Hotel","2","1","339","730","0","0","339","730","6.4"
"6","2018","30","Otros","5","8","10","27","1","1","11","28","5"
"6","2018","30","Otros","9","37","53","64","2","2","55","66","4.5"
"6","2018","30","Otros","7","38","118","196","0","0","118","196","2.75"
"6","2018","30","Otros","11","32","13","13","0","0","13","13","1"
"6","2018","30","Otros","4","39","46","48","0","0","46","48","2.2222222222222"
"6","2018","30","Hotel","11","36","27","60","19","48","46","108","2.375"
"6","2018","30","Otros","10","23","11","15","0","0","11","15","7"
"6","2018","30","Hotel","15","16","656","1106","45","141","701","1247","2"
"6","2018","30","Otros","2","29","8","16","0","0","8","16","3.28"
"6","2018","30","Hotel","6","12","922","1222","56","73","978","1295","1"
"6","2018","30","Hotel","11","15","2","6","0","0","2","6","1"
"6","2018","30","Otros","4","21","88","117","0","0","88","117","1"
"6","2018","30","Otros","16","19","40","86","0","0","40","86","10.263157894737"
"6","2018","30","","9","37","243","279","0","0","243","279","1"
"6","2018","30","Otros","10","27","12","20","10","15","22","35","4.84"
"6","2018","30","Otros","11","15","46","65","0","0","46","65","2.3571428571429"
"6","2018","30","Hotel","2","29","112","230","54","108","166","338","2"
"6","2018","30","Hotel","10","27","187","229","139","217","326","446","1"
"6","2018","30","Hotel","11","36","11","22","4","8","15","30","2.375"
"6","2018","30","Hotel","9","37","62","87","3","4","65","91","3.4"
"6","2018","30","Otros","14","27","19","32","0","0","19","32","11.833333333333"
"6","2018","30","Otros","7","38","33","52","0","0","33","52","1"
"6","2018","30","Hotel","2","1","10","150","0","0","10","150","6.4"
"6","2018","30","Otros","2","29","20","34","85","223","105","257","3.28"
"6","2018","30","Hotel","6","27","7","7","0","0","7","7","3"
"6","2018","30","Otros","5","9","25","27","3","3","28","30","4.0454545454545"
"6","2018","30","Hotel","2","1","13","30","0","0","13","30","6.4"
"6","2018","30","Hotel","3","7","1","1","13","15","14","16","1"
"6","2018","30","Otros","7","38","15","22","11","14","26","36","2.75"
"6","2018","30","Otros","7","17","17","187","0","0","17","187","17.166666666667"
"6","2018","30","Otros","7","38","19","21","0","0","19","21","2.75"
"6","2018","30","Otros","4","21","5","5","0","0","5","5","4.8333333333333"
"6","2018","30","Otros","2","1","41","41","12","12","53","53","5.5"
"6","2018","30","Otros","12","35","14","22","3","25","17","47","3.5"
"6","2018","30","Otros","12","35","8","13","2","2","10","15","3.5"
"6","2018","30","Otros","4","21","58","68","2","4","60","72","4.8333333333333"
"6","2018","30","Otros","12","24","7","21","10","30","17","51","9.2"
"6","2018","30","Otros","16","19","2","2","0","0","2","2","10.263157894737"
"6","2018","30","Otros","10","11","33","137","0","0","33","137","11.764705882353"
"6","2018","30","Otros","16","19","15","27","0","0","15","27","10.263157894737"
"6","2018","30","Hotel","2","27","42","53","10","14","52","67","1"
"6","2018","30","Otros","6","28","13","19","0","0","13","19","4.65"
"6","2018","30","Otros","10","18","144","352","6","30","150","382","10.25"
"6","2018","30","Otros","14","27","65","261","0","0","65","261","11.833333333333"
"6","2018","30","Hotel","11","32","3","7","0","0","3","7","1"
"6","2018","30","Otros","8","27","1","2","0","0","1","2","9.4"
"6","2018","30","Hotel","12","35","7","11","1","1","8","12","1.7272727272727"
"6","2018","30","Otros","13","14","2","4","0","0","2","4","7.3846153846154"
"6","2018","30","Otros","11","36","16","23","0","0","16","23","5.1904761904762"
"6","2018","30","Otros","16","20","25","27","4","4","29","31","3.0769230769231"
"6","2018","30","Hotel","14","31","111","145","782","903","893","1048","7.8"
"6","2018","30","Otros","2","27","114","152","2","2","116","154","3.2"
"6","2018","30","","16","40","207","365","0","0","207","365","3.0555555555556"
"6","2018","30","Hotel","11","36","72","149","2","2","74","151","2.375"
"6","2018","30","Hotel","9","22","4","4","2","2","6","6","2.5555555555556"
"6","2018","30","Otros","2","29","9","12","5","5","14","17","3.28"
"6","2018","30","Hotel","10","27","12","19","21","23","33","42","2.25"
"6","2018","30","Otros","10","27","23","77","0","0","23","77","4.84"
"6","2018","30","Hotel","16","19","3","3","0","0","3","3","4"
"6","2018","26","Otros","2","6","11","35","0","0","11","35","5"
"6","2018","30","Otros","7","27","51","62","0","0","51","62","4.8333333333333"
"6","2018","30","Hotel","2","6","107","811","0","0","107","811","5.5"
"6","2018","30","Hotel","6","28","4","4","2","2","6","6","2.4"
"6","2018","30","Otros","6","10","57","286","0","0","57","286","3.8518518518518"
"6","2018","30","Hotel","6","27","24","30","0","0","24","30","3"
"6","2018","30","Otros","5","5","15","26","1","2","16","28","3.65625"
"6","2018","30","Otros","12","24","45","245","9","21","54","266","9.2"
"6","2018","30","Hotel","8","2","125","261","0","0","125","261","3"
"6","2018","30","Hotel","11","32","61","90","0","0","61","90","1"
"6","2018","30","Otros","10","18","22","58","3","6","25","64","10.25"
"6","2018","30","Hotel","9","37","17","23","1","1","18","24","3.4"
"6","2018","30","Otros","5","9","7","10","1","1","8","11","4.0454545454545"
"6","2018","30","Otros","12","24","0","0","6","8","6","8","9.2"
"6","2018","30","Otros","9","22","1","1","0","0","1","1","7.6428571428571"
"6","2018","30","Otros","2","29","6","16","2","5","8","21","3.28"
"6","2018","30","Otros","10","23","4","84","0","0","4","84","7"
"6","2018","30","Otros","10","27","11","31","8","25","19","56","4.84"
"6","2018","30","Otros","10","11","32","32","0","0","32","32","11.764705882353"
"6","2018","30","Otros","8","3","0","0","2","6","2","6","10"
"6","2018","30","Otros","14","31","105","159","286","390","391","549","20.2"
"6","2018","30","Otros","2","29","166","422","92","274","258","696","3.28"
"6","2018","0","Otros","6","25","0","0","0","0","0","0","1"
"6","2018","30","Hotel","15","16","32","98","0","0","32","98","7.8"
"6","2018","30","Hotel","15","27","67","80","1","1","68","81","1"
"6","2018","30","Otros","10","27","1","30","2","2","3","32","4.84"
"6","2018","30","Otros","10","23","19","19","0","0","19","19","7"
"6","2018","30","Otros","6","27","6","6","0","0","6","6","3.960088691796"
"6","2018","30","Otros","16","40","89","140","0","0","89","140","28.142857142857"
"6","2018","30","Otros","11","36","77","156","0","0","77","156","5.1904761904762"
"6","2018","30","Otros","8","34","17","43","1","4","18","47","5.75"
"6","2018","30","Otros","6","12","9","234","0","0","9","234","1.8256578947368"
"6","2018","30","Otros","6","10","165","284","0","0","165","284","3.8518518518518"
"6","2018","30","Hotel","4","21","103","190","4","6","107","196","3"
"6","2018","30","Hotel","11","36","65","86","5","5","70","91","2.375"
"6","2018","30","Otros","5","8","51","71","15","15","66","86","5"
"6","2018","30","Hotel","7","17","73","140","1","9","74","149","10"
"6","2018","26","Hotel","11","36","288","355","7","7","295","362","1"
"6","2018","30","Otros","9","30","56","170","0","0","56","170","2.3333333333333"
"6","2018","30","Hotel","12","35","57","84","22","37","79","121","1.7272727272727"
"6","2018","30","Otros","2","1","63","280","6","9","69","289","5.5"
"6","2018","30","Hotel","6","25","119","121","0","0","119","121","1"
"6","2018","30","Otros","5","5","4","120","0","0","4","120","3.65625"
"6","2018","30","Otros","2","29","55","179","114","285","169","464","3.28"
"6","2018","30","Hotel","2","6","16","27","14","25","30","52","5.5"
"6","2018","30","Otros","7","17","17","121","2","5","19","126","17.166666666667"
"6","2018","30","Hotel","8","2","7","7","2","2","9","9","3"
"6","2018","30","Hotel","13","14","2","2","0","0","2","2","1"
"6","2018","30","Otros","7","38","37","76","7","19","44","95","2.75"
"6","2018","30","Hotel","14","31","16","21","36","98","52","119","24"
"6","2018","30","Hotel","5","5","47","49","4","4","51","53","2.1428571428571"
"6","2018","30","Otros","2","27","7","7","5","5","12","12","3.2"
"6","2018","30","Otros","5","8","9","15","0","0","9","15","5"
"6","2018","30","Otros","3","4","25","84","0","0","25","84","12.2"
"6","2018","30","Otros","13","14","3","3","0","0","3","3","7.3846153846154"
"6","2018","30","Otros","9","37","43","308","0","0","43","308","4.5"
"6","2018","30","Hotel","10","23","546","719","46","64","592","783","1"
"6","2018","3","Otros","11","32","3","9","0","0","3","9","2.2857142857143"
"6","2018","30","Otros","11","15","1","4","0","0","1","4","2.3571428571429"
"6","2018","30","Otros","8","3","27","118","0","0","27","118","10"
"6","2018","30","Otros","16","20","38","62","0","0","38","62","3.0769230769231"
"6","2018","30","Otros","8","3","10","27","0","0","10","27","10"
"6","2018","30","Otros","16","27","2","2","0","0","2","2","2"
"6","2018","30","Hotel","16","19","7","8","0","0","7","8","4"
"6","2018","30","Hotel","16","27","39","121","0","0","39","121","5.8571428571429"
"6","2018","30","Otros","9","26","24","51","0","0","24","51","3.8888888888889"
"6","2018","30","Otros","5","5","10","10","0","0","10","10","3.65625"
"6","2018","30","Otros","14","27","3","3","0","0","3","3","11.833333333333"
"6","2018","30","Hotel","5","5","1","1","0","0","1","1","2.1428571428571"
"6","2018","30","Hotel","12","24","98","289","32","84","130","373","3"
"6","2018","30","Otros","16","27","5","10","0","0","5","10","13.818181818182"
"6","2018","30","Otros","8","3","11","21","0","0","11","21","1"
"6","2018","30","Otros","13","27","119","232","3","3","122","235","12.2"
"6","2018","6","Hotel","16","40","8","9","0","0","8","9","16.333333333333"
"6","2018","30","Otros","11","36","36","183","0","0","36","183","1"
"6","2018","30","Otros","10","27","8","97","0","0","8","97","4.84"
"6","2018","30","Otros","9","22","11","20","0","0","11","20","7.6428571428571"
"6","2018","30","Hotel","5","5","30","57","4","6","34","63","2.1428571428571"
"6","2018","30","Otros","2","29","95","204","57","144","152","348","3.28"
"6","2018","30","Otros","2","29","0","0","5","5","5","5","3.28"
"6","2018","30","Hotel","13","14","0","0","0","0","0","0","1"
"6","2018","30","Otros","6","25","1","2","0","0","1","2","2.3846153846154"
"6","2018","30","Otros","2","1","19","21","3","3","22","24","5.5"
"6","2018","30","Hotel","12","27","34","56","0","0","34","56","1"
"6","2018","30","Hotel","13","27","6","6","0","0","6","6","4.2"
"6","2018","30","Otros","6","12","70","238","0","0","70","238","1.8256578947368"
"6","2018","30","Otros","6","27","2","3","0","0","2","3","3.960088691796"
"6","2018","30","Otros","6","25","3","3","5","5","8","8","2.3846153846154"
"6","2018","30","Hotel","6","28","20","52","0","0","20","52","2.5833333333333"
"6","2018","30","Otros","5","5","15","27","1","2","16","29","3.65625"
"6","2018","30","Otros","5","9","9","11","0","0","9","11","4.0454545454545"
"6","2018","30","Otros","5","8","3","4","0","0","3","4","5"
"6","2018","30","Hotel","2","29","57","132","26","83","83","215","1"
"6","2018","30","Otros","5","5","64","96","2","2","66","98","3.65625"
"6","2018","30","Hotel","9","26","10","12","6","8","16","20","1.5"
"6","2018","30","Otros","9","30","6","6","0","0","6","6","2.3333333333333"
"6","2018","30","Otros","11","15","4","8","0","0","4","8","2.3571428571429"
"6","2018","30","Hotel","16","27","1","1","0","0","1","1","5.8571428571429"
"6","2018","30","Otros","9","30","1","1","0","0","1","1","2.3333333333333"
"6","2018","30","Otros","2","29","16","27","11","20","27","47","3.28"
"6","2018","30","Otros","7","38","27","55","11","18","38","73","2.75"
"6","2018","30","Otros","4","21","29","70","4","12","33","82","4.8333333333333"
"6","2018","30","Otros","9","22","8","12","0","0","8","12","7.6428571428571"
"6","2018","30","Otros","9","22","35","51","0","0","35","51","7.6428571428571"
"6","2018","30","Otros","13","27","3","5","0","0","3","5","12.2"
"6","2018","30","Hotel","11","36","1182","1233","16","24","1198","1257","1"
"6","2018","30","Otros","13","33","10","15","0","0","10","15","5.125"
"6","2018","30","Otros","11","36","40","93","31","68","71","161","5.1904761904762"
"6","2018","30","Otros","12","35","1","1","0","0","1","1","3.5"
"6","2018","30","Otros","12","35","8","13","2","2","10","15","3.5"
"6","2018","30","Otros","10","11","10","13","12","16","22","29","11.764705882353"
"6","2018","30","Otros","12","24","23","46","0","0","23","46","9.2"
"6","2018","30","Otros","16","20","17","37","0","0","17","37","3.0769230769231"
"6","2018","30","Hotel","7","27","115","133","0","0","115","133","1"
"6","2018","30","Otros","6","12","12","12","3","3","15","15","1.8256578947368"
"6","2018","30","Otros","11","32","8","21","4","6","12","27","2.2857142857143"
"6","2018","30","Otros","6","28","28","28","3","3","31","31","4.65"
"6","2018","30","Otros","8","34","1","1","0","0","1","1","5.75"
"6","2018","30","Otros","16","27","2","7","0","0","2","7","13.818181818182"
"6","2018","30","Otros","10","11","1","2","0","0","1","2","11.764705882353"
"6","2018","30","Otros","6","10","50","102","0","0","50","102","3.8518518518518"
"6","2018","30","Otros","8","3","43","109","1","1","44","110","10"
"6","2018","30","Hotel","16","20","72","72","2","4","74","76","1"
"6","2018","30","Hotel","11","32","19","30","0","0","19","30","1"
"6","2018","30","Otros","8","27","16","63","0","0","16","63","9.4"
"6","2018","30","Otros","12","27","26","113","0","0","26","113","3.4285714285714"
"6","2018","30","Otros","6","10","54","147","0","0","54","147","3.8518518518518"
"6","2018","30","Otros","6","10","16","50","0","0","16","50","3.8518518518518"
"6","2018","30","Otros","5","8","17","22","1","2","18","24","5"
"6","2018","30","Otros","5","8","9","12","1","1","10","13","5"
"6","2018","30","Hotel","9","26","33","114","5","49","38","163","1.5"
"6","2018","30","Hotel","13","14","5","5","0","0","5","5","1"
"6","2018","30","Otros","10","18","32","60","10","13","42","73","10.25"
"6","2018","30","Otros","8","2","39","42","2","3","41","45","6.4285714285714"
"6","2018","30","Otros","7","27","7","16","0","0","7","16","4.8333333333333"
"6","2018","30","Otros","2","29","37","90","24","58","61","148","3.28"
"6","2018","20","Otros","11","32","11","31","2","6","13","37","2.2857142857143"
"6","2018","30","Otros","9","30","14","26","0","0","14","26","2.3333333333333"
"6","2018","30","Otros","2","29","8","24","2","4","10","28","3.28"
"6","2018","30","Otros","5","5","2","4","0","0","2","4","3.65625"
"6","2018","30","Otros","11","15","11","11","0","0","11","11","2.3571428571429"
"6","2018","30","Otros","10","23","2","2","0","0","2","2","7"
"6","2018","30","Otros","11","36","69","114","6","13","75","127","5.1904761904762"
"6","2018","30","Hotel","3","7","24","36","48","92","72","128","1"
"6","2018","30","Otros","10","27","0","0","4","4","4","4","4.84"
"6","2018","30","Otros","2","27","5","5","0","0","5","5","3.2"
"6","2018","30","Otros","12","35","1","1","0","0","1","1","3.5"
"6","2018","30","Otros","10","27","2","2","0","0","2","2","4.84"
"6","2018","30","Otros","16","40","12","28","61","148","73","176","28.142857142857"
"6","2018","30","Hotel","8","3","267","493","30","40","297","533","4.1111111111111"
"6","2018","30","Otros","9","22","14","16","0","0","14","16","7.6428571428571"
"6","2018","30","Otros","13","14","29","67","0","0","29","67","7.3846153846154"
"6","2018","30","Otros","5","9","7","10","1","1","8","11","4.0454545454545"
"6","2018","30","Otros","10","18","6","12","5","13","11","25","10.25"
"6","2018","30","Otros","6","25","39","39","11","11","50","50","2.3846153846154"
"6","2018","30","Otros","9","22","4","8","0","0","4","8","7.6428571428571"
"6","2018","30","Otros","10","27","24","73","0","0","24","73","4.84"
"6","2018","30","Otros","16","20","17","32","8","16","25","48","3.0769230769231"
"6","2018","30","Hotel","7","17","210","391","0","0","210","391","10"
"6","2018","30","Otros","15","27","12","12","0","0","12","12","1.4222222222222"
"6","2018","30","Otros","12","35","1","1","0","0","1","1","3.5"
"6","2018","30","Otros","12","35","11","15","23","35","34","50","3.5"
"6","2018","30","Otros","3","7","9","21","0","0","9","21","2"
"6","2018","30","Otros","10","11","4","4","0","0","4","4","11.764705882353"
"6","2018","30","Otros","12","24","6","8","0","0","6","8","9.2"
"6","2018","30","Otros","10","23","11","18","0","0","11","18","7"
"6","2018","30","Otros","7","27","16","40","2","7","18","47","4.8333333333333"
"6","2018","30","","10","18","2","4","0","0","2","4","1"
"6","2018","30","Otros","16","27","0","0","3","3","3","3","13.818181818182"
"6","2018","16","Hotel","2","29","12","22","6","10","18","32","1"
"6","2018","30","Otros","14","27","40","40","0","0","40","40","11.833333333333"
"6","2018","30","Otros","11","32","58","62","0","0","58","62","2.2857142857143"
"6","2018","30","Otros","16","19","48","190","0","0","48","190","1"
"6","2018","30","Otros","16","27","5","5","0","0","5","5","13.818181818182"
"6","2018","30","Otros","8","3","16","48","0","0","16","48","10"
"6","2018","30","Otros","16","27","15","15","0","0","15","15","13.818181818182"
"6","2018","30","Otros","16","20","19","25","0","0","19","25","3.0769230769231"
"6","2018","30","Otros","16","40","112","171","8","12","120","183","28.142857142857"
"6","2018","30","Hotel","11","36","45","88","4","4","49","92","2.375"
"6","2018","30","Otros","6","10","71","155","0","0","71","155","3.8518518518518"
"6","2018","12","Otros","7","38","55","162","2","4","57","166","2.75"
"6","2018","30","Otros","13","14","7","10","0","0","7","10","7.3846153846154"
"6","2018","30","Otros","9","30","13","21","0","0","13","21","2.3333333333333"
"6","2018","30","Otros","13","27","72","179","0","0","72","179","12.2"
"6","2018","30","Otros","10","27","27","27","12","12","39","39","4.84"
"6","2018","30","Otros","6","25","7","10","1","1","8","11","2.3846153846154"
"6","2018","30","Otros","9","26","48","547","0","0","48","547","3.8888888888889"
"6","2018","30","Otros","10","18","2","2","0","0","2","2","10.25"
"6","2018","30","Otros","2","29","25","63","9","30","34","93","3.28"
"6","2018","30","Otros","6","25","2","2","0","0","2","2","2.3846153846154"
"6","2018","30","Otros","5","9","1","1","1","1","2","2","4.0454545454545"
"6","2018","30","Otros","5","9","2","2","0","0","2","2","4.0454545454545"
"6","2018","30","Hotel","9","37","32","109","6","34","38","143","3.4"
"6","2018","30","Hotel","7","38","49","96","10","21","59","117","1"
"6","2018","30","Otros","7","27","81","90","0","0","81","90","4.8333333333333"
"6","2018","30","Otros","5","9","7","10","1","1","8","11","4.0454545454545"
"6","2018","30","Otros","10","27","2","2","1","1","3","3","4.84"
"6","2018","30","Otros","7","27","42","42","0","0","42","42","4.8333333333333"
"6","2018","30","Otros","16","40","42","68","0","0","42","68","28.142857142857"
"6","2018","30","Otros","10","23","26","26","0","0","26","26","7"
"6","2018","30","Otros","15","16","32","302","8","66","40","368","9"
"6","2018","20","Otros","3","7","14","28","22","46","36","74","2"
"6","2018","30","Otros","7","17","21","41","0","0","21","41","17.166666666667"
"6","2018","30","Otros","8","27","34","224","0","0","34","224","9.4"
"6","2018","30","Otros","9","22","35","76","0","0","35","76","7.6428571428571"
"6","2018","30","Otros","16","19","9","12","0","0","9","12","10.263157894737"
"6","2018","0","","15","27","0","0","0","0","0","0","1"
"6","2018","30","Hotel","10","11","14","14","4","4","18","18","5.6666666666667"
"6","2018","30","Otros","2","27","5","5","5","5","10","10","3.2"
"6","2018","30","Otros","8","2","45","88","7","11","52","99","6.4285714285714"
"6","2018","30","Otros","5","5","15","26","1","2","16","28","3.65625"
"6","2018","30","Otros","12","35","1","1","0","0","1","1","3.5"
"6","2018","30","Otros","8","3","3","6","2","6","5","12","10"
"6","2018","30","Otros","12","24","24","54","9","11","33","65","9.2"
"6","2018","30","Otros","11","32","12","142","0","0","12","142","2.2857142857143"
"6","2018","30","Otros","10","27","10","17","0","0","10","17","4.84"
"6","2018","30","Otros","11","15","11","11","0","0","11","11","2.3571428571429"
"6","2018","30","Otros","5","8","2","4","0","0","2","4","5"
"6","2018","30","Otros","14","27","21","26","0","0","21","26","11.833333333333"
"6","2018","30","Otros","13","27","51","80","0","0","51","80","12.2"
"6","2018","30","Hotel","10","18","66","66","69","69","135","135","3.2"
"6","2018","30","Otros","10","27","19","22","3","3","22","25","4.84"
"6","2018","30","Otros","11","32","26","31","0","0","26","31","1"
"6","2018","30","Otros","9","37","10","64","0","0","10","64","4.5"
"6","2018","30","Otros","12","35","5","6","16","21","21","27","3.5"
"6","2018","30","Otros","8","34","108","178","9","12","117","190","5.75"
"6","2018","30","Hotel","16","40","19","29","14","26","33","55","16.333333333333"
"6","2018","30","Hotel","10","11","26","82","3","7","29","89","5.6666666666667"
"6","2018","30","Otros","7","27","14","24","0","0","14","24","4.8333333333333"
"6","2018","30","Hotel","7","38","0","0","0","0","0","0","1"
"6","2018","30","Otros","6","27","3","11","0","0","3","11","3.960088691796"
"6","2018","30","Otros","6","10","39","75","0","0","39","75","3.8518518518518"
"6","2018","15","Otros","6","25","46","50","0","0","46","50","1"
"6","2018","30","Otros","6","25","1","1","0","0","1","1","2.3846153846154"
"6","2018","30","Otros","6","27","5","150","0","0","5","150","3.960088691796"
"6","2018","30","Otros","6","27","47","143","0","0","47","143","3.960088691796"
"6","2018","30","Otros","5","5","2","4","1","3","3","7","3.65625"
"6","2018","30","Otros","5","5","1","1","0","0","1","1","3.65625"
"6","2018","30","Otros","3","4","14","16","0","0","14","16","12.2"
"6","2018","30","Otros","10","23","5","5","0","0","5","5","7"
"6","2018","30","Otros","8","3","1","1","0","0","1","1","10"
"6","2018","30","Otros","5","5","3","10","0","0","3","10","3.65625"
"6","2018","30","Otros","5","8","3","3","0","0","3","3","5"
"6","2018","30","Otros","6","10","23","65","0","0","23","65","3.8518518518518"
"6","2018","30","Otros","16","19","13","30","0","0","13","30","10.263157894737"
"6","2018","30","Otros","11","15","29","66","11","33","40","99","2.3571428571429"
"6","2018","30","Otros","7","38","33","40","0","0","33","40","2.75"
"6","2018","30","Otros","11","32","68","126","0","0","68","126","2.2857142857143"
"6","2018","30","Otros","8","2","19","29","0","0","19","29","6.4285714285714"
"6","2018","30","Otros","10","27","24","36","1","2","25","38","4.84"
"6","2018","30","Otros","6","27","13","20","0","0","13","20","3.960088691796"
"6","2018","30","Otros","11","32","30","61","1","1","31","62","2.2857142857143"
"6","2018","30","Otros","8","34","13","25","1","1","14","26","5.75"
"6","2018","30","Otros","11","32","14","26","0","0","14","26","2.2857142857143"
"6","2018","30","Otros","10","11","9","15","0","0","9","15","11.764705882353"
"6","2018","30","Otros","11","32","6","6","2","4","8","10","2.2857142857143"
"6","2018","30","Otros","14","31","3","3","4","9","7","12","20.2"
"6","2018","30","Hotel","14","31","130","220","497","2142","627","2362","17.4"
"6","2018","30","Otros","11","36","108","164","0","0","108","164","5.1904761904762"
"6","2018","30","Hotel","15","16","827","1692","171","346","998","2038","2"
"6","2018","30","Otros","15","27","9","15","0","0","9","15","1.4222222222222"
"6","2018","30","Otros","5","5","1","2","0","0","1","2","3.65625"
"6","2018","30","Otros","8","34","3","3","7","7","10","10","5.75"
"6","2018","30","Otros","7","27","6","8","0","0","6","8","4.8333333333333"
"6","2018","30","Otros","12","35","8","13","2","2","10","15","3.5"
"6","2018","30","Otros","5","5","26","72","0","0","26","72","3.65625"
"6","2018","30","Otros","10","11","1","1","0","0","1","1","11.764705882353"
"6","2018","30","Otros","10","11","2","2","0","0","2","2","11.764705882353"
"6","2018","30","Otros","9","30","5","50","0","0","5","50","2.3333333333333"
"6","2018","30","Otros","8","2","18","40","1","3","19","43","6.4285714285714"
"6","2018","30","Otros","10","27","42","92","2","2","44","94","4.84"
"6","2018","30","Otros","5","9","7","10","1","1","8","11","4.0454545454545"
"6","2018","30","Otros","6","27","3","7","0","0","3","7","3.960088691796"
"6","2018","30","Otros","6","10","117","185","2","2","119","187","3.8518518518518"
"6","2018","30","Otros","6","10","36","44","0","0","36","44","3.8518518518518"
"6","2018","30","Otros","6","27","10","12","0","0","10","12","3.960088691796"
"6","2018","30","Otros","6","12","4","34","0","0","4","34","1.8256578947368"
"6","2018","30","Otros","6","10","66","128","0","0","66","128","3.8518518518518"
"6","2018","30","Otros","6","10","16","28","0","0","16","28","3.8518518518518"
"6","2018","30","Otros","6","27","2","3","0","0","2","3","3.960088691796"
"6","2018","30","Otros","6","12","86","125","0","0","86","125","1.8256578947368"
"6","2018","30","Otros","6","10","3","6","0","0","3","6","3.8518518518518"
"6","2018","30","Hotel","6","25","25","31","0","0","25","31","1"
"6","2018","30","Otros","6","27","2","3","0","0","2","3","3.960088691796"
"6","2018","30","Otros","5","9","12","22","4","8","16","30","4.0454545454545"
"6","2018","30","Otros","5","5","9","22","8","14","17","36","3.65625"
"6","2018","30","Otros","5","5","5","6","0","0","5","6","3.65625"
"6","2018","30","Otros","5","5","10","16","0","0","10","16","3.65625"
"6","2018","30","Otros","11","36","53","83","6","12","59","95","5.1904761904762"
"6","2018","30","Hotel","6","10","1022","1938","44","87","1066","2025","1"
"6","2018","30","Otros","5","9","7","10","1","1","8","11","4.0454545454545"
"6","2018","30","Otros","5","8","2","4","0","0","2","4","5"
"6","2018","0","Hotel","15","27","0","0","0","0","0","0","1"
"6","2018","30","Hotel","3","4","145","826","20","102","165","928","3"
"6","2018","30","Otros","3","7","21","21","6","6","27","27","1"
"6","2018","30","Otros","7","38","97","151","0","0","97","151","2.75"
"6","2018","30","Hotel","10","27","9","21","20","20","29","41","1"
"6","2018","30","Hotel","12","35","1","1","3","3","4","4","1.7272727272727"
"6","2018","30","Hotel","10","27","5","32","0","0","5","32","2.25"
"6","2018","30","Hotel","7","17","519","875","38","53","557","928","4"
"6","2018","30","Hotel","16","19","2","2","0","0","2","2","4"
"6","2018","30","Hotel","2","6","505","1041","0","0","505","1041","2.2"
"6","2018","30","Otros","5","5","34","75","0","0","34","75","3.65625"
"6","2018","30","Otros","12","24","90","109","32","36","122","145","9.2"
"6","2018","30","Otros","5","8","17","17","1","2","18","19","5"
"6","2018","30","Otros","4","13","134","147","5","5","139","152","1"
"6","2018","30","Otros","10","11","73","73","0","0","73","73","11.764705882353"
"6","2018","30","Otros","12","35","18","28","28","40","46","68","3.5"
"6","2018","30","Otros","10","23","43","43","4","4","47","47","7"
"6","2018","30","Otros","11","36","177","460","57","91","234","551","5.1904761904762"
"6","2018","30","Otros","12","35","8","13","2","2","10","15","3.5"
"6","2018","30","Otros","11","36","37","113","4","8","41","121","5.1904761904762"
"6","2018","30","Otros","8","2","39","149","0","0","39","149","6.4285714285714"
"6","2018","30","Otros","9","30","79","112","0","0","79","112","2.3333333333333"
"6","2018","30","Otros","11","36","41","59","0","0","41","59","5.1904761904762"
"6","2018","30","Otros","6","10","6","6","0","0","6","6","3.8518518518518"
"6","2018","30","Otros","10","18","6","12","0","0","6","12","10.25"
"6","2018","30","Otros","7","27","4","4","2","2","6","6","4.8333333333333"
"6","2018","30","Otros","16","20","5","25","0","0","5","25","1"
"6","2018","30","Otros","9","22","7","11","0","0","7","11","7.6428571428571"
"6","2018","30","Otros","5","5","200","346","8","16","208","362","3.65625"
"6","2018","30","Otros","12","35","8","13","2","2","10","15","3.5"
"6","2018","30","Otros","10","11","1","1","0","0","1","1","11.764705882353"
"6","2018","30","Otros","10","11","16","37","0","0","16","37","11.764705882353"
"6","2018","26","Otros","5","9","29","58","4","4","33","62","4.0454545454545"
"6","2018","30","Otros","5","5","3","8","1","2","4","10","3.65625"
"6","2018","30","Otros","12","35","17","28","22","43","39","71","3.5"
"6","2018","23","Otros","7","38","73","144","3","4","76","148","2.75"
"6","2018","30","Hotel","12","35","1","1","0","0","1","1","1.7272727272727"
"6","2018","30","Otros","13","14","11","11","0","0","11","11","1"
"6","2018","30","Otros","5","5","2","3","0","0","2","3","3.65625"
"6","2018","30","Hotel","9","26","8","27","0","0","8","27","1.5"
"6","2018","30","Hotel","16","19","8","28","0","0","8","28","1"
"6","2018","30","Otros","16","19","48","149","0","0","48","149","10.263157894737"
"6","2018","30","Otros","9","30","21","21","1","1","22","22","2.3333333333333"
"6","2018","30","Otros","16","19","27","45","0","0","27","45","10.263157894737"
"6","2018","30","Otros","16","19","35","56","0","0","35","56","10.263157894737"
"6","2018","30","Otros","9","26","40","102","0","0","40","102","3.8888888888889"
"6","2018","30","Otros","16","40","1","1","0","0","1","1","28.142857142857"
"6","2018","30","Hotel","16","27","5","8","3","16","8","24","5.8571428571429"
"6","2018","30","Otros","16","19","9","11","0","0","9","11","10.263157894737"
"6","2018","30","Otros","16","19","5","6","0","0","5","6","10.263157894737"
"6","2018","30","","9","30","81","97","0","0","81","97","1"
"6","2018","30","Otros","16","19","12","16","0","0","12","16","10.263157894737"
"6","2018","30","Otros","10","11","1","1","0","0","1","1","11.764705882353"
"6","2018","30","Otros","11","36","15","15","0","0","15","15","5.1904761904762"
"6","2018","30","Otros","16","19","14","48","0","0","14","48","10.263157894737"
"6","2018","30","Otros","16","19","72","93","0","0","72","93","1.3333333333333"
"6","2018","30","Otros","16","19","20","28","0","0","20","28","10.263157894737"
"6","2018","30","Otros","10","18","25","53","10","22","35","75","10.25"
"6","2018","30","Otros","16","19","10","20","0","0","10","20","10.263157894737"
"6","2018","30","Otros","16","19","1","1","0","0","1","1","1.3333333333333"
"6","2018","30","","9","26","520","2380","0","0","520","2380","1"
"6","2018","30","Otros","16","19","12","12","0","0","12","12","10.263157894737"
"6","2018","2","Otros","16","19","6","8","0","0","6","8","10.263157894737"
"6","2018","30","Hotel","8","2","665","1285","105","462","770","1747","1"
"6","2018","30","Otros","6","10","30","54","0","0","30","54","3.8518518518518"
"6","2018","30","Otros","6","12","22","22","0","0","22","22","1.8256578947368"
"6","2018","30","Hotel","16","19","49","79","10","17","59","96","1"
"6","2018","30","Otros","3","7","54","54","12","12","66","66","2"
"6","2018","30","Hotel","2","6","827","2898","35","133","862","3031","1"
"6","2018","30","Hotel","3","4","422","817","45","90","467","907","2.6"
"6","2018","30","Hotel","16","40","1504","2186","367","533","1871","2719","1"
"6","2018","30","Otros","16","27","46","48","0","0","46","48","13.818181818182"
"6","2018","30","Hotel","6","28","158","234","18","18","176","252","2.4"
"6","2018","30","Hotel","8","34","2442","3681","113","185","2555","3866","1"
"6","2018","30","Otros","9","30","4","4","0","0","4","4","2.3333333333333"
"6","2018","30","Hotel","10","18","38","38","114","114","152","152","1"
"6","2018","30","Hotel","9","30","53","212","2","2","55","214","1"
"6","2018","30","Hotel","15","27","8","8","0","0","8","8","1"
"6","2018","30","Hotel","9","22","40","240","0","0","40","240","2.5555555555556"
"6","2018","0","","11","15","0","0","0","0","0","0","1"
"6","2018","30","Otros","6","12","23","25","0","0","23","25","1.8256578947368"
"6","2018","30","Hotel","15","27","30","900","0","0","30","900","1"
"6","2018","30","Otros","15","27","62","88","0","0","62","88","1.4222222222222"
"6","2018","30","Otros","15","27","1","1","0","0","1","1","1.4222222222222"
"6","2018","30","Otros","2","1","16","16","12","12","28","28","1"
"6","2018","30","Otros","12","24","4","6","0","0","4","6","9.2"
"6","2018","30","Otros","5","5","10","29","4","8","14","37","3.65625"
"6","2018","30","Hotel","7","27","170","240","1","4","171","244","1"
"6","2018","30","Otros","16","20","11","20","0","0","11","20","3.0769230769231"
"6","2018","30","","10","11","48","100","3","5","51","105","1"
"6","2018","30","Hotel","16","40","19","49","0","0","19","49","16.333333333333"
"6","2018","30","Otros","12","35","5","12","0","0","5","12","3.5"
"6","2018","30","Hotel","6","27","21","21","2","2","23","23","3"
"6","2018","30","Otros","5","5","14","18","0","0","14","18","3.65625"
"6","2018","30","Hotel","6","27","29","29","0","0","29","29","3"
"6","2018","30","Otros","6","25","27","31","0","0","27","31","2.3846153846154"
"6","2018","0","Hotel","15","27","0","0","0","0","0","0","1"
"6","2018","30","Otros","5","9","7","7","9","11","16","18","4.0454545454545"
"6","2018","30","Hotel","15","27","120","220","0","0","120","220","1"
"6","2018","30","Hotel","5","9","7","10","0","0","7","10","1"
"6","2018","30","Hotel","8","34","37","91","2","2","39","93","2.5714285714286"
"6","2018","0","Hotel","15","27","0","0","0","0","0","0","1"
"6","2018","30","Hotel","6","27","125","207","0","0","125","207","3"
"6","2018","30","Otros","6","27","52","130","0","0","52","130","1"
"6","2018","30","Otros","12","27","0","0","13","13","13","13","3.4285714285714"
"6","2018","30","Hotel","2","27","665","686","169","170","834","856","1"
"6","2018","30","Hotel","2","6","371","371","0","0","371","371","1"
"6","2018","30","Otros","2","6","32","54","0","0","32","54","1"
"6","2018","30","Hotel","4","39","158","158","0","0","158","158","1"
"6","2018","30","Hotel","6","10","337","418","4","4","341","422","1"
"6","2018","30","Otros","5","8","0","0","3","3","3","3","5"
"6","2018","0","Hotel","13","33","0","0","0","0","0","0","1"
"6","2018","30","Hotel","13","33","147","294","59","120","206","414","1"
"6","2018","30","Otros","11","32","145","506","8","12","153","518","2.2857142857143"
"6","2018","30","Hotel","9","26","206","429","42","92","248","521","1"
"6","2018","30","Hotel","16","20","28","35","0","0","28","35","1"
"6","2018","30","Otros","16","20","6","10","0","0","6","10","3.0769230769231"
"6","2018","30","","16","40","502","735","0","0","502","735","1"
"6","2018","30","Hotel","15","16","1307","2230","126","229","1433","2459","1"
"6","2018","30","Hotel","5","9","2","4","2","2","4","6","1"
"6","2018","30","Otros","7","38","23","39","0","0","23","39","2.75"
"6","2018","30","Otros","2","6","215","2751","0","0","215","2751","1"
"6","2018","30","Otros","2","6","144","968","0","0","144","968","1"
"6","2018","30","Hotel","15","27","250","938","2","2","252","940","1"
"6","2018","30","Otros","7","38","50","69","0","0","50","69","2.75"
"6","2018","30","Otros","2","1","17","42","14","44","31","86","1"
"6","2018","30","Otros","8","3","40","104","1","1","41","105","10"
"6","2018","30","Otros","11","36","43","61","0","0","43","61","5.1904761904762"
"6","2018","30","Otros","16","20","21","37","0","0","21","37","3.0769230769231"
"6","2018","30","Otros","8","3","218","310","0","0","218","310","1"
"6","2018","30","Otros","4","39","32","119","0","0","32","119","2.2222222222222"
"6","2018","30","Otros","5","5","20","40","0","0","20","40","3.65625"
"6","2018","30","Otros","12","27","7","18","0","0","7","18","3.4285714285714"
"6","2018","30","Otros","7","27","6","10","1","3","7","13","1"
"6","2018","30","Hotel","2","6","419","717","77","103","496","820","1"
"6","2018","30","Hotel","14","27","249","646","59","91","308","737","1"
"6","2018","30","Hotel","16","19","203","477","0","0","203","477","1"
"6","2018","30","","2","1","21","297","0","0","21","297","1"
"6","2018","30","Hotel","2","27","31","56","3","20","34","76","1"
"6","2018","30","Otros","16","20","12","12","0","0","12","12","1"
"6","2018","0","Otros","13","14","0","0","0","0","0","0","1"
"6","2018","30","Hotel","11","36","108","163","1","2","109","165","2.375"
"6","2018","30","Otros","13","14","3","16","0","0","3","16","7.3846153846154"
"6","2018","30","Otros","12","27","19","66","0","0","19","66","3.4285714285714"
"6","2018","30","Hotel","2","6","245","301","10","14","255","315","2.2"
"6","2018","30","Otros","2","6","607","1622","0","0","607","1622","1"
"6","2018","30","Otros","10","27","1","30","0","0","1","30","4.84"
"6","2018","30","Otros","12","27","2","2","3","3","5","5","3.4285714285714"
"6","2018","30","Otros","13","14","39","39","0","0","39","39","7.3846153846154"
"6","2018","30","Otros","6","12","114","161","27","41","141","202","1.8256578947368"
"6","2018","30","Otros","2","6","781","1877","0","0","781","1877","1"
"6","2018","30","Hotel","12","35","31","42","0","0","31","42","1.7272727272727"
"6","2018","30","Otros","5","5","6","13","0","0","6","13","3.65625"
"6","2018","30","Otros","9","30","1","30","2","60","3","90","2.3333333333333"
"6","2018","0","Hotel","8","2","0","0","0","0","0","0","1"
"6","2018","30","Otros","9","30","10","12","0","0","10","12","2.3333333333333"
"6","2018","30","Hotel","15","27","38","45","2","2","40","47","1"
"6","2018","30","Hotel","3","7","21","21","5","5","26","26","1"
"6","2018","30","Otros","6","12","368","582","0","0","368","582","1.8256578947368"
"6","2018","30","Otros","12","27","23","56","2","2","25","58","3.4285714285714"
"6","2018","30","Otros","2","6","10","44","0","0","10","44","5"
"6","2018","30","Otros","6","27","2","3","0","0","2","3","3.960088691796"
"6","2018","0","Hotel","10","11","0","0","0","0","0","0","1"
"6","2018","30","Otros","2","1","38","720","0","0","38","720","1"
"6","2018","30","Otros","11","36","17","75","0","0","17","75","5.1904761904762"
"6","2018","30","Hotel","11","32","0","0","0","0","0","0","1"
"6","2018","30","Otros","2","27","13","20","0","0","13","20","1"
"6","2018","30","Otros","12","27","5","7","0","0","5","7","3.4285714285714"
"6","2018","30","Hotel","8","2","6","6","0","0","6","6","3"
"6","2018","30","Hotel","16","20","21","21","0","0","21","21","1"
"6","2018","30","Otros","12","35","8","17","14","24","22","41","3.5"
"6","2018","30","Otros","13","14","12","20","0","0","12","20","1"
"6","2018","30","Otros","2","27","4","4","0","0","4","4","3.2"
"6","2018","30","Hotel","6","27","10","10","0","0","10","10","3"
"6","2018","30","Hotel","8","3","24","26","5","7","29","33","4.1111111111111"
"6","2018","30","Hotel","15","27","23","82","0","0","23","82","1"
"6","2018","30","Otros","8","3","40","103","1","1","41","104","10"
"6","2018","0","Hotel","16","20","0","0","0","0","0","0","1"
"6","2018","30","Hotel","6","28","32","56","0","0","32","56","2.4"
"6","2018","30","Otros","2","1","62","181","5","14","67","195","5.5"
"6","2018","30","Hotel","11","36","83","151","66","121","149","272","2.375"
"6","2018","0","Otros","4","13","0","0","0","0","0","0","1"
"6","2018","30","Otros","2","6","188","1316","0","0","188","1316","1"
"6","2018","30","Otros","8","34","73","96","10","24","83","120","5.75"
"6","2018","0","Hotel","11","15","0","0","0","0","0","0","1"
"6","2018","30","Otros","15","27","1","1","0","0","1","1","1.4222222222222"
"6","2018","30","Hotel","13","14","45","47","0","0","45","47","1"
"6","2018","30","Hotel","13","14","100","140","18","18","118","158","1"
"6","2018","0","Hotel","9","30","0","0","0","0","0","0","1"
"6","2018","30","Hotel","4","13","236","481","5","12","241","493","5.4"
"6","2018","30","Otros","6","27","10","33","0","0","10","33","3.960088691796"
"6","2018","0","Hotel","15","27","0","0","0","0","0","0","1"
"6","2018","30","Hotel","2","29","4","14","52","223","56","237","2"
"6","2018","30","Hotel","13","33","24","30","0","0","24","30","2"
"6","2018","30","Hotel","12","35","57","84","22","37","79","121","1.7272727272727"
"6","2018","30","Hotel","13","14","282","308","5","9","287","317","1"
"6","2018","30","Otros","6","25","14","28","0","0","14","28","2.3846153846154"
"6","2018","30","Hotel","8","2","11","17","2","2","13","19","3"
"6","2018","30","Otros","4","39","15","15","0","0","15","15","2.2222222222222"
"6","2018","30","Otros","6","12","129","193","4","4","133","197","1.8256578947368"
"6","2018","30","Otros","13","33","28","50","4","8","32","58","5.125"
"6","2018","30","Hotel","4","13","175","336","7","23","182","359","5.4"
"6","2018","30","Hotel","7","27","130","169","2","3","132","172","4.1666666666667"
"6","2018","30","Hotel","4","13","732","2156","124","298","856","2454","1"
"6","2018","0","","5","8","0","0","0","0","0","0","1"
"6","2018","30","Otros","8","2","87","162","2","3","89","165","6.4285714285714"
"6","2018","30","Otros","2","6","10","10","7","7","17","17","1"
"6","2018","30","","6","10","26","78","0","0","26","78","1"
"6","2018","30","Hotel","2","29","84","105","78","87","162","192","2"
"6","2018","30","","14","31","202","537","383","1506","585","2043","1"
"6","2018","30","Hotel","16","27","2750","8250","0","0","2750","8250","1"
"6","2018","30","Hotel","12","35","42","74","15","17","57","91","1.7272727272727"
"6","2018","30","","12","35","6","10","21","40","27","50","1"
"6","2018","30","","9","26","101","161","10","12","111","173","1"
"6","2018","30","Otros","11","32","46","77","0","0","46","77","2.2857142857143"
"6","2018","30","Otros","12","24","31","95","3","6","34","101","9.2"
"6","2018","30","Hotel","6","25","53","55","0","0","53","55","1"
"6","2018","30","Otros","11","32","2","2","0","0","2","2","2.2857142857143"
"6","2018","30","Hotel","16","19","58","108","0","0","58","108","4"
"6","2018","30","Otros","13","33","21","25","1","1","22","26","5.125"
"6","2018","30","Otros","16","27","31","80","0","0","31","80","13.818181818182"
"6","2018","30","Otros","6","12","89","151","1","6","90","157","1.8256578947368"
"6","2018","30","Otros","2","29","6","26","0","0","6","26","3.28"
"6","2018","30","Hotel","14","27","302","398","52","84","354","482","1"
"6","2018","30","Otros","2","1","100","1400","0","0","100","1400","1"
"6","2018","30","Otros","11","32","8","8","0","0","8","8","2.2857142857143"
"6","2018","30","Otros","2","27","45","45","0","0","45","45","1"
"6","2018","30","Hotel","2","29","40","168","0","0","40","168","1"
"6","2018","30","Hotel","4","13","55","371","0","0","55","371","3.2"
"6","2018","30","Hotel","4","21","15","45","2","2","17","47","3"
"6","2018","30","Otros","7","27","92","118","6","8","98","126","4.8333333333333"
"6","2018","25","","3","4","17","37","2","2","19","39","1"
"6","2018","30","Hotel","6","27","19","23","0","0","19","23","3"
"6","2018","30","Otros","16","19","1","2","0","0","1","2","10.263157894737"
"6","2018","30","Otros","11","32","4","4","0","0","4","4","2.2857142857143"
"6","2018","30","Otros","3","7","17","20","11","19","28","39","2"
"6","2018","30","Otros","5","5","12","21","5","10","17","31","3.65625"
"6","2018","24","Otros","15","27","594","900","0","0","594","900","1.4222222222222"
"6","2018","30","Otros","6","25","16","24","0","0","16","24","2.3846153846154"
"6","2018","30","","10","27","0","0","3","3","3","3","1"
"6","2018","30","Otros","2","29","19","46","62","160","81","206","3.28"
"6","2018","30","Otros","12","35","8","13","2","2","10","15","3.5"
"6","2018","30","Otros","16","19","23","48","0","0","23","48","10.263157894737"
"6","2018","30","Otros","9","26","39","52","1","1","40","53","3.8888888888889"
"6","2018","30","Hotel","13","33","31","31","0","0","31","31","2"
"6","2018","30","Otros","11","32","22","28","0","0","22","28","2.2857142857143"
"6","2018","30","Otros","9","22","33","73","0","0","33","73","7.6428571428571"
"6","2018","30","Otros","6","27","9","189","0","0","9","189","3.960088691796"
"6","2018","30","Otros","15","27","11","16","0","0","11","16","1.4222222222222"
"6","2018","30","Otros","11","32","69","69","1","1","70","70","2.2857142857143"
"6","2018","30","Otros","11","15","18","18","9","16","27","34","2.3571428571429"
"6","2018","30","Otros","9","37","6","120","0","0","6","120","4.5"
"6","2018","30","Otros","5","9","25","27","0","0","25","27","4.0454545454545"
"6","2018","30","Hotel","10","27","10","18","0","0","10","18","2.25"
"6","2018","30","Otros","6","28","17","400","0","0","17","400","4.65"
"6","2018","30","Otros","4","13","20","27","0","0","20","27","3.4"
"6","2018","0","Otros","2","1","0","0","0","0","0","0","1"
"6","2018","30","Otros","2","29","24","41","50","74","74","115","3.28"
"6","2018","30","Hotel","8","3","7","13","0","0","7","13","4.1111111111111"
"6","2018","30","Otros","16","19","19","47","0","0","19","47","1.3333333333333"
"6","2018","30","Otros","12","35","5","8","0","0","5","8","3.5"
"6","2018","30","Hotel","12","35","3","4","0","0","3","4","1.7272727272727"
"6","2018","30","Otros","12","35","0","0","4","10","4","10","3.5"
"6","2018","30","Otros","2","29","27","42","43","85","70","127","3.28"
"6","2018","30","Hotel","7","27","45","54","6","6","51","60","1"
"6","2018","30","Hotel","9","22","26","31","0","0","26","31","2.5555555555556"
"6","2018","30","Hotel","12","35","21","34","2","2","23","36","1.7272727272727"
"6","2018","30","Otros","15","16","105","168","10","82","115","250","2"
"6","2018","30","Hotel","15","27","1","1","0","0","1","1","1"
"6","2018","30","Otros","4","13","60","74","16","21","76","95","3.4"
"6","2018","30","Hotel","8","34","54","82","2","6","56","88","2.5714285714286"
"6","2018","30","Hotel","16","20","25","50","0","0","25","50","1"
"6","2018","30","Hotel","6","28","126","184","12","23","138","207","2.4"
"6","2018","30","Hotel","15","27","82","255","7","10","89","265","1"
"6","2018","30","Otros","12","35","67","92","4","4","71","96","3.5"
"6","2018","30","Otros","11","15","22","54","0","0","22","54","2.3571428571429"
"6","2018","30","Otros","11","15","30","71","0","0","30","71","2.3571428571429"
"6","2018","30","Otros","11","36","33","57","19","39","52","96","5.1904761904762"
"6","2018","30","Hotel","11","36","60","110","4","4","64","114","2.375"
"6","2018","30","Hotel","6","12","89","140","0","0","89","140","5"
"6","2018","30","Otros","8","3","25","25","3","3","28","28","10"
"6","2018","30","Otros","10","27","22","24","2","2","24","26","4.84"
"6","2018","30","Otros","8","3","2","4","0","0","2","4","10"
"6","2018","30","Otros","6","25","20","24","0","0","20","24","2.3846153846154"
"6","2018","30","Hotel","2","27","88","222","0","0","88","222","1"
"6","2018","30","Hotel","10","18","0","0","54","131","54","131","3.2"
"6","2018","30","Otros","11","32","22","57","0","0","22","57","1"
"6","2018","30","Hotel","6","10","1607","2128","109","172","1716","2300","1"
"6","2018","30","Otros","11","32","53","68","0","0","53","68","2.2857142857143"
"6","2018","0","Otros","2","27","0","0","0","0","0","0","1"
"6","2018","0","","12","24","0","0","0","0","0","0","1"
"6","2018","30","Hotel","16","27","328","452","0","0","328","452","5.8571428571429"
"6","2018","30","Hotel","7","38","24","35","7","10","31","45","1"
"6","2018","30","Hotel","6","12","1720","1740","21","21","1741","1761","1"
"7","2018","31","Hotel","14","31","1706","2829","9856","12583","11562","15412","1"
"7","2018","31","Hotel","14","31","777","1454","2644","8112","3421","9566","1"
"7","2018","31","Hotel","14","31","454","743","1103","3846","1557","4589","1"
"7","2018","0","Hotel","11","32","0","0","0","0","0","0","1"
"7","2018","31","Hotel","14","27","3477","5135","713","1051","4190","6186","1"
"7","2018","31","Otros","11","32","101","373","6","21","107","394","2.2857142857143"
"7","2018","31","Hotel","14","31","685","946","3273","4701","3958","5647","5.4"
"7","2018","31","Hotel","15","16","1205","2218","78","150","1283","2368","1"
"7","2018","31","Hotel","14","31","1139","2022","1505","6405","2644","8427","5.4"
"7","2018","31","Hotel","12","24","2814","3917","297","438","3111","4355","1"
"7","2018","31","Hotel","16","40","1714","2560","225","419","1939","2979","1"
"7","2018","31","Hotel","6","12","1943","2502","61","95","2004","2597","1"
"7","2018","31","Hotel","10","23","980","1338","60","83","1040","1421","1"
"7","2018","31","Hotel","14","31","1797","3882","368","794","2165","4676","5.4"
"7","2018","31","Hotel","3","4","1218","2289","136","227","1354","2516","1"
"7","2018","31","","11","32","573","779","37","103","610","882","1"
"7","2018","31","Hotel","6","12","154","329","8","18","162","347","1"
"7","2018","31","Hotel","6","12","2255","3183","539","759","2794","3942","1"
"7","2018","31","Hotel","9","26","3925","7611","51","96","3976","7707","1"
"7","2018","31","Hotel","2","1","715","2474","33","180","748","2654","1"
"7","2018","31","Hotel","9","26","1167","1837","112","374","1279","2211","1"
"7","2018","31","Hotel","6","12","1508","1857","86","135","1594","1992","1"
"7","2018","31","Hotel","14","31","97","137","4352","8120","4449","8257","5.4"
"7","2018","31","Hotel","11","32","342","803","9","21","351","824","1"
"7","2018","31","Hotel","2","6","1054","1507","82","157","1136","1664","1"
"7","2018","31","Hotel","16","40","1657","3804","462","782","2119","4586","1"
"7","2018","31","Hotel","14","27","647","833","2548","4146","3195","4979","1"
"7","2018","31","Otros","11","36","60","140","0","0","60","140","1"
"7","2018","31","Hotel","10","23","2052","2826","287","409","2339","3235","1"
"7","2018","31","Hotel","14","31","378","942","667","4457","1045","5399","7.8"
"7","2018","31","Hotel","7","17","289","571","37","133","326","704","1"
"7","2018","31","Hotel","2","1","2531","4303","0","0","2531","4303","2"
"7","2018","31","Hotel","2","1","1958","3096","205","415","2163","3511","2"
"7","2018","31","Hotel","4","13","957","1718","52","91","1009","1809","1"
"7","2018","31","Hotel","2","1","1132","2481","137","445","1269","2926","2"
"7","2018","31","Hotel","10","27","2178","6148","258","814","2436","6962","1"
"7","2018","31","Hotel","14","27","713","880","1038","1263","1751","2143","1"
"7","2018","31","Hotel","14","27","2224","3073","942","2394","3166","5467","1"
"7","2018","31","Hotel","6","12","2633","3688","69","152","2702","3840","1"
"7","2018","31","Hotel","6","12","1673","2385","473","633","2146","3018","1"
"7","2018","31","Hotel","13","27","3520","7201","3","3","3523","7204","1"
"7","2018","31","Hotel","14","31","108","201","1102","3283","1210","3484","7.8"
"7","2018","31","Hotel","6","12","1563","4050","321","830","1884","4880","1"
"7","2018","31","Hotel","16","27","2268","4319","144","262","2412","4581","1"
"7","2018","31","","10","27","60","87","0","0","60","87","1"
"7","2018","31","Hotel","10","18","857","1806","217","510","1074","2316","1"
"7","2018","31","Hotel","9","37","1880","3854","189","383","2069","4237","1"
"7","2018","31","Hotel","16","27","1638","6557","0","0","1638","6557","1"
"7","2018","31","Hotel","15","16","1406","3067","84","187","1490","3254","2"
"7","2018","31","Hotel","2","1","1440","2340","298","481","1738","2821","2"
"7","2018","31","Hotel","3","4","581","1609","150","183","731","1792","1"
"7","2018","31","Hotel","16","40","1578","2796","597","984","2175","3780","1"
"7","2018","31","Hotel","7","17","2221","2556","104","117","2325","2673","1"
"7","2018","31","Hotel","12","24","790","1640","188","395","978","2035","1"
"7","2018","31","Hotel","12","35","390","702","109","271","499","973","1"
"7","2018","31","Hotel","2","6","364","988","5","43","369","1031","1"
"7","2018","31","Hotel","13","33","1112","1540","48","72","1160","1612","1"
"7","2018","31","Hotel","10","27","1340","1791","400","538","1740","2329","1"
"7","2018","31","Hotel","10","23","1213","2161","247","442","1460","2603","1"
"7","2018","31","Hotel","11","36","1773","2995","140","288","1913","3283","1"
"7","2018","31","Hotel","8","34","1410","2010","118","192","1528","2202","1"
"7","2018","31","Hotel","2","6","415","1246","25","73","440","1319","1"
"7","2018","31","Hotel","14","31","780","1188","1286","1915","2066","3103","7.8"
"7","2018","31","Hotel","11","36","2203","3905","104","183","2307","4088","1"
"7","2018","31","","10","27","1019","3608","102","314","1121","3922","1"
"7","2018","31","Hotel","14","31","1633","2732","2494","8881","4127","11613","5.4"
"7","2018","31","Hotel","4","13","2745","2755","2","4","2747","2759","1"
"7","2018","31","Hotel","6","28","1508","1857","86","135","1594","1992","1"
"7","2018","31","Otros","14","31","18","44","9","26","27","70","2.8"
"7","2018","31","Otros","16","27","79","119","0","0","79","119","2"
"7","2018","31","Hotel","2","1","986","1659","74","126","1060","1785","2"
"7","2018","31","Hotel","10","18","920","1393","259","393","1179","1786","1"
"7","2018","31","Hotel","7","17","1138","1393","66","85","1204","1478","1"
"7","2018","31","Hotel","12","24","537","1628","136","463","673","2091","1"
"7","2018","31","Hotel","10","18","1498","3095","134","242","1632","3337","1"
"7","2018","31","Hotel","2","1","2863","3412","21","40","2884","3452","1"
"7","2018","31","Hotel","10","18","640","1286","159","324","799","1610","1"
"7","2018","31","Hotel","6","28","1712","2485","278","322","1990","2807","1"
"7","2018","31","Hotel","5","5","825","1344","116","171","941","1515","1"
"7","2018","31","Hotel","4","13","368","651","15","30","383","681","1"
"7","2018","31","Hotel","10","18","290","415","152","268","442","683","1"
"7","2018","31","Hotel","16","40","938","1583","19","30","957","1613","1"
"7","2018","31","Hotel","8","3","2593","6364","353","879","2946","7243","1"
"7","2018","31","Hotel","15","16","1092","1627","191","231","1283","1858","2"
"7","2018","31","Hotel","14","31","91","239","417","1805","508","2044","7.8"
"7","2018","31","Hotel","13","33","470","720","67","197","537","917","1"
"7","2018","31","Hotel","15","16","980","1413","133","302","1113","1715","2"
"7","2018","31","Otros","4","21","462","583","0","0","462","583","1"
"7","2018","31","Hotel","6","10","1173","1986","125","456","1298","2442","1"
"7","2018","31","Hotel","16","19","144","210","3","3","147","213","1"
"7","2018","31","Hotel","16","27","1246","3262","3","6","1249","3268","1"
"7","2018","31","Hotel","10","11","1516","2898","119","133","1635","3031","1"
"7","2018","31","Otros","10","23","446","992","4","13","450","1005","1"
"7","2018","0","Hotel","12","35","0","0","0","0","0","0","1"
"7","2018","31","Hotel","11","36","440","892","24","62","464","954","1"
"7","2018","31","Hotel","14","31","25","44","278","1953","303","1997","17.4"
"7","2018","31","Hotel","10","18","718","2526","335","876","1053","3402","3.2"
"7","2018","31","Hotel","4","13","254","379","3","3","257","382","1"
"7","2018","31","Hotel","6","12","206","325","33","42","239","367","5"
"7","2018","31","Hotel","6","10","596","959","64","109","660","1068","1"
"7","2018","31","Otros","5","5","171","322","42","72","213","394","3.65625"
"7","2018","31","Hotel","12","24","1045","1250","627","771","1672","2021","1"
"7","2018","31","Hotel","8","3","1389","3057","246","523","1635","3580","1"
"7","2018","31","Hotel","13","27","1100","2119","0","0","1100","2119","2.75"
"7","2018","31","Hotel","15","16","75","340","17","53","92","393","4"
"7","2018","31","Otros","15","16","398","1295","57","236","455","1531","2"
"7","2018","31","Otros","16","20","326","576","0","0","326","576","1"
"7","2018","31","Hotel","3","4","1000","1169","40","40","1040","1209","1"
"7","2018","31","Hotel","11","36","75","90","0","0","75","90","1"
"7","2018","31","Hotel","2","6","289","686","30","255","319","941","1"
"7","2018","31","Hotel","8","34","731","1245","150","255","881","1500","1"
"7","2018","31","Hotel","4","13","26","47","0","0","26","47","3.2"
"7","2018","31","Hotel","13","27","1233","3115","0","0","1233","3115","2.75"
"7","2018","31","Hotel","2","29","851","1320","1660","2176","2511","3496","1"
"7","2018","31","Otros","11","36","72","126","4","6","76","132","1"
"7","2018","0","","10","11","0","0","0","0","0","0","1"
"7","2018","31","Hotel","4","13","904","1089","73","207","977","1296","1"
"7","2018","31","Hotel","16","40","2840","4244","186","281","3026","4525","5.6666666666667"
"7","2018","31","Hotel","10","23","869","1676","190","437","1059","2113","2.8"
"7","2018","31","Hotel","8","34","489","600","79","118","568","718","1"
"7","2018","31","Hotel","5","5","579","911","63","99","642","1010","1"
"7","2018","31","Hotel","3","4","55","143","52","103","107","246","3"
"7","2018","31","Hotel","9","26","55","926","0","0","55","926","1"
"7","2018","31","Hotel","8","34","260","320","71","235","331","555","1"
"7","2018","31","Hotel","7","17","292","623","30","61","322","684","4"
"7","2018","31","Hotel","4","13","253","553","18","40","271","593","3.2"
"7","2018","31","Hotel","12","35","4","25","108","390","112","415","1"
"7","2018","31","Hotel","16","40","1050","2327","126","253","1176","2580","1"
"7","2018","31","Hotel","9","26","370","642","42","266","412","908","1"
"7","2018","31","","6","27","180","312","19","35","199","347","1"
"7","2018","31","Hotel","9","26","471","831","0","0","471","831","1"
"7","2018","31","Hotel","4","13","95","156","13","20","108","176","3.2"
"7","2018","31","Hotel","6","28","630","824","23","23","653","847","1"
"7","2018","31","","2","29","168","545","423","1474","591","2019","1"
"7","2018","22","Hotel","14","31","100","240","146","519","246","759","1"
"7","2018","31","Hotel","13","33","1251","1547","78","119","1329","1666","1"
"7","2018","31","Hotel","8","3","553","1356","234","538","787","1894","1"
"7","2018","31","Hotel","14","27","934","1893","417","510","1351","2403","1"
"7","2018","31","Hotel","16","40","273","552","104","208","377","760","5.6666666666667"
"7","2018","31","Hotel","12","24","186","320","119","242","305","562","1"
"7","2018","31","Hotel","10","18","1613","2235","51","105","1664","2340","3.2"
"7","2018","31","Otros","15","16","103","103","2","2","105","105","9"
"7","2018","31","Hotel","6","10","820","881","0","0","820","881","1"
"7","2018","31","Hotel","10","11","548","919","45","634","593","1553","1"
"7","2018","31","Otros","6","10","225","695","9","50","234","745","3.8518518518518"
"7","2018","31","Otros","10","23","80","320","0","0","80","320","1"
"7","2018","31","Hotel","10","23","563","964","107","193","670","1157","2.8"
"7","2018","31","Hotel","6","12","310","692","2","5","312","697","5"
"7","2018","31","Hotel","6","27","110","188","7","14","117","202","3"
"7","2018","31","Hotel","10","23","678","1057","119","249","797","1306","2.8"
"7","2018","31","","4","39","116","197","0","0","116","197","1"
"7","2018","31","Hotel","8","34","249","440","122","296","371","736","1"
"7","2018","31","Hotel","8","34","330","545","20","27","350","572","1"
"7","2018","31","Otros","4","39","9","18","0","0","9","18","2.2222222222222"
"7","2018","31","Otros","13","14","324","648","0","0","324","648","1"
"7","2018","31","Hotel","10","23","211","257","7","9","218","266","2.8"
"7","2018","31","Otros","13","14","262","1173","0","0","262","1173","1"
"7","2018","31","Hotel","12","24","75","162","174","324","249","486","1"
"7","2018","31","","6","25","421","421","0","0","421","421","1"
"7","2018","31","Hotel","15","27","602","1022","12","22","614","1044","1"
"7","2018","0","Hotel","12","35","0","0","0","0","0","0","1"
"7","2018","31","Hotel","16","40","67","98","83","130","150","228","1"
"7","2018","31","Hotel","16","27","571","1902","1584","6994","2155","8896","1"
"7","2018","31","Hotel","9","30","94","243","0","0","94","243","1"
"7","2018","31","Hotel","4","13","374","723","38","77","412","800","3.2"
"7","2018","31","Hotel","2","29","182","550","271","798","453","1348","1"
"7","2018","31","Hotel","16","20","364","631","21","31","385","662","1"
"7","2018","31","Hotel","5","5","672","1147","32","41","704","1188","1"
"7","2018","31","Hotel","13","33","583","920","62","126","645","1046","1"
"7","2018","31","Otros","16","19","144","253","0","0","144","253","1.3333333333333"
"7","2018","31","Hotel","12","24","141","262","190","371","331","633","1"
"7","2018","31","","8","2","688","1916","11","19","699","1935","1"
"7","2018","0","Hotel","12","35","0","0","0","0","0","0","1"
"7","2018","31","Hotel","16","27","46","65","161","254","207","319","2.5"
"7","2018","29","Otros","16","27","456","1001","7","12","463","1013","2"
"7","2018","31","Hotel","8","34","319","483","44","83","363","566","1"
"7","2018","31","Otros","8","3","92","309","0","0","92","309","1"
"7","2018","31","Hotel","7","27","260","393","75","172","335","565","1"
"7","2018","31","Hotel","4","39","165","364","6","10","171","374","1"
"7","2018","31","Hotel","15","16","267","482","11","29","278","511","4"
"7","2018","31","Hotel","4","39","6","12","2","9","8","21","1"
"7","2018","31","Hotel","4","39","211","291","7","8","218","299","1"
"7","2018","31","Hotel","15","16","234","790","12","16","246","806","4"
"7","2018","31","Hotel","14","31","99","221","274","1080","373","1301","17.4"
"7","2018","31","Hotel","8","34","364","537","61","88","425","625","1"
"7","2018","31","Hotel","6","28","238","325","12","15","250","340","1"
"7","2018","31","Hotel","7","17","1044","1554","46","58","1090","1612","4"
"7","2018","31","Otros","7","27","1","1","0","0","1","1","1"
"7","2018","31","Hotel","11","36","1041","1181","33","55","1074","1236","1"
"7","2018","31","Otros","4","21","371","815","46","102","417","917","1"
"7","2018","31","Otros","15","16","85","115","31","42","116","157","2"
"7","2018","31","Otros","7","17","156","317","0","0","156","317","3"
"7","2018","31","Hotel","7","38","90","126","0","0","90","126","1"
"7","2018","31","Hotel","16","27","567","1138","21","217","588","1355","2.5"
"7","2018","31","Hotel","2","6","38","53","3","3","41","56","2.2"
"7","2018","31","Hotel","11","36","359","607","24","45","383","652","1"
"7","2018","31","Hotel","6","28","13","24","0","0","13","24","1"
"7","2018","31","Hotel","6","12","201","381","0","0","201","381","5"
"7","2018","31","Otros","9","22","152","329","0","0","152","329","1"
"7","2018","31","","13","14","169","229","0","0","169","229","2"
"7","2018","31","Hotel","2","29","74","186","570","1092","644","1278","1"
"7","2018","31","Hotel","2","29","47","202","78","323","125","525","1"
"7","2018","31","Otros","4","13","315","327","17","17","332","344","1"
"7","2018","31","Hotel","15","16","87","225","35","93","122","318","4"
"7","2018","31","Hotel","2","1","161","473","7","34","168","507","6.4"
"7","2018","31","Otros","7","27","111","241","0","0","111","241","1"
"7","2018","31","Otros","13","33","105","116","0","0","105","116","5.125"
"7","2018","31","","4","21","185","288","4","4","189","292","1"
"7","2018","31","Hotel","6","10","344","344","0","0","344","344","1"
"7","2018","31","Hotel","11","36","261","605","5","12","266","617","1"
"7","2018","31","Otros","14","31","1000","1000","0","0","1000","1000","2.8"
"7","2018","31","Hotel","7","27","242","328","1","4","243","332","1"
"7","2018","31","Otros","6","10","44","403","0","0","44","403","3.8518518518518"
"7","2018","31","Hotel","4","39","42","51","1","2","43","53","2.6"
"7","2018","31","Otros","8","2","95","391","5","12","100","403","6.4285714285714"
"7","2018","31","Otros","11","36","49","109","6","16","55","125","5.1904761904762"
"7","2018","31","Hotel","13","33","367","367","0","0","367","367","1"
"7","2018","31","","3","4","103","225","51","72","154","297","1"
"7","2018","31","Hotel","7","17","332","798","20","54","352","852","4"
"7","2018","31","Hotel","8","2","577","1006","8","8","585","1014","1"
"7","2018","31","Otros","15","16","238","301","52","65","290","366","2"
"7","2018","31","Hotel","10","11","382","438","16","16","398","454","1"
"7","2018","31","Hotel","16","19","327","436","0","0","327","436","1"
"7","2018","31","Hotel","10","23","143","197","3","4","146","201","4"
"7","2018","31","","7","38","412","495","44","50","456","545","1"
"7","2018","31","Hotel","7","27","415","656","9","9","424","665","1"
"7","2018","31","Hotel","11","36","367","753","27","68","394","821","1"
"7","2018","31","Hotel","16","40","168","259","11","27","179","286","16.333333333333"
"7","2018","31","Hotel","16","19","47","52","1","3","48","55","1"
"7","2018","31","Hotel","16","19","4","10","0","0","4","10","1"
"7","2018","31","Hotel","16","20","0","0","0","0","0","0","1"
"7","2018","31","Hotel","10","11","247","350","10","20","257","370","1"
"7","2018","31","Otros","7","27","66","128","3","3","69","131","4.8333333333333"
"7","2018","31","Otros","7","27","22","46","0","0","22","46","1"
"7","2018","31","Hotel","7","27","48","64","0","0","48","64","4.1666666666667"
"7","2018","31","Otros","13","14","115","137","0","0","115","137","1"
"7","2018","31","Otros","11","15","40","40","0","0","40","40","2.3571428571429"
"7","2018","31","Otros","10","27","32","56","7","10","39","66","4.84"
"7","2018","31","Otros","14","31","1897","1897","1234","1234","3131","3131","2.8"
"7","2018","31","Otros","11","36","15","15","0","0","15","15","5.1904761904762"
"7","2018","31","Hotel","16","19","76","76","0","0","76","76","1"
"7","2018","31","","14","27","216","376","26","52","242","428","2.6666666666667"
"7","2018","31","Hotel","16","40","116","136","6","6","122","142","5.6666666666667"
"7","2018","31","Hotel","10","27","8","24","0","0","8","24","2.25"
"7","2018","31","Otros","2","29","97","300","169","505","266","805","3.28"
"7","2018","31","Hotel","13","27","2","4","3","7","5","11","1"
"7","2018","31","Otros","9","22","35","52","1","1","36","53","1"
"7","2018","31","Hotel","2","27","139","180","15","15","154","195","1"
"7","2018","31","Hotel","8","34","361","518","74","135","435","653","1"
"7","2018","31","Hotel","7","27","337","360","0","0","337","360","1"
"7","2018","31","Hotel","15","16","323","683","31","72","354","755","4"
"7","2018","31","Hotel","16","20","51","94","7","16","58","110","1"
"7","2018","31","Otros","4","13","85","359","1","1","86","360","1"
"7","2018","31","Hotel","2","1","230","730","5","9","235","739","6.4"
"7","2018","31","Otros","11","32","30","76","0","0","30","76","2.2857142857143"
"7","2018","31","Hotel","2","29","8","66","75","974","83","1040","1"
"7","2018","31","Hotel","16","27","171","182","76","86","247","268","2.5"
"7","2018","31","Hotel","10","18","105","419","0","0","105","419","3.2"
"7","2018","31","Otros","11","36","412","525","9","15","421","540","1"
"7","2018","31","Otros","13","14","68","104","0","0","68","104","1"
"7","2018","0","Hotel","7","27","0","0","0","0","0","0","1"
"7","2018","31","Otros","7","17","210","505","1","2","211","507","3"
"7","2018","31","Otros","14","31","267","447","172","461","439","908","2.8"
"7","2018","31","Hotel","2","29","378","1210","175","544","553","1754","1"
"7","2018","31","Hotel","8","3","119","212","14","38","133","250","1"
"7","2018","31","Hotel","8","34","258","342","49","67","307","409","2.5714285714286"
"7","2018","31","Hotel","8","34","220","296","41","112","261","408","2.5714285714286"
"7","2018","31","Hotel","12","35","120","147","48","66","168","213","1"
"7","2018","31","Hotel","11","32","60","166","7","19","67","185","1"
"7","2018","31","Hotel","13","33","115","161","5","30","120","191","2"
"7","2018","31","Hotel","10","23","135","242","21","31","156","273","2.8"
"7","2018","31","Hotel","12","35","67","129","5","5","72","134","1"
"7","2018","31","","16","40","293","443","36","84","329","527","3.0555555555556"
"7","2018","31","Otros","16","19","5","8","0","0","5","8","1.3333333333333"
"7","2018","31","Otros","16","20","17","68","0","0","17","68","1"
"7","2018","31","Hotel","6","12","172","306","6","14","178","320","5"
"7","2018","31","Hotel","16","19","196","236","0","0","196","236","4"
"7","2018","31","Hotel","12","24","159","209","150","182","309","391","1"
"7","2018","31","Hotel","12","24","185","384","35","76","220","460","3"
"7","2018","31","Hotel","8","3","0","0","0","0","0","0","1"
"7","2018","0","Hotel","5","9","0","0","0","0","0","0","1"
"7","2018","31","Hotel","16","27","293","501","5","10","298","511","2.5"
"7","2018","31","Otros","10","23","40","40","0","0","40","40","7"
"7","2018","31","Otros","13","14","196","246","0","0","196","246","7.3846153846154"
"7","2018","31","Otros","2","6","51","75","6","6","57","81","1"
"7","2018","24","Hotel","15","16","9","10","77","93","86","103","7.8"
"7","2018","31","Hotel","8","3","159","452","4","8","163","460","1"
"7","2018","31","Hotel","8","34","383","589","48","75","431","664","1"
"7","2018","31","Hotel","8","3","100","209","17","23","117","232","1"
"7","2018","31","","2","29","157","536","47","137","204","673","1"
"7","2018","31","Hotel","2","1","373","484","23","32","396","516","6.4"
"7","2018","31","Hotel","7","17","46","85","0","0","46","85","4"
"7","2018","31","Otros","7","17","259","963","4","16","263","979","3"
"7","2018","31","Hotel","16","40","89","164","5","7","94","171","5.6666666666667"
"7","2018","31","Hotel","12","24","231","529","38","62","269","591","1"
"7","2018","31","Hotel","14","31","104","305","322","1544","426","1849","17.4"
"7","2018","0","Hotel","9","26","0","0","0","0","0","0","1"
"7","2018","31","Hotel","6","12","28","28","0","0","28","28","5"
"7","2018","31","Otros","5","9","14","14","0","0","14","14","4.0454545454545"
"7","2018","31","Otros","5","9","1","1","0","0","1","1","4.0454545454545"
"7","2018","31","Otros","15","27","162","248","0","0","162","248","1.4222222222222"
"7","2018","31","Hotel","8","34","13","14","2","2","15","16","2.5714285714286"
"7","2018","31","Hotel","10","18","379","834","75","142","454","976","7.75"
"7","2018","31","Hotel","15","16","351","465","31","68","382","533","7.8"
"7","2018","31","Hotel","2","29","122","395","248","876","370","1271","1"
"7","2018","31","Hotel","4","39","42","91","0","0","42","91","2.6"
"7","2018","31","Otros","4","39","118","170","0","0","118","170","2.2222222222222"
"7","2018","31","Hotel","4","13","186","296","10","12","196","308","5.4"
"7","2018","31","Otros","10","23","49","49","1","1","50","50","7"
"7","2018","31","Otros","14","31","141","266","276","1039","417","1305","20.2"
"7","2018","31","Hotel","3","4","32","44","13","16","45","60","2.6"
"7","2018","31","Hotel","10","23","97","302","8","15","105","317","4"
"7","2018","31","Otros","9","22","252","566","0","0","252","566","1"
"7","2018","31","Hotel","12","24","230","380","67","110","297","490","3"
"7","2018","31","Hotel","13","14","39","55","0","0","39","55","1"
"7","2018","31","Hotel","12","35","173","245","32","45","205","290","1.7272727272727"
"7","2018","31","Hotel","6","28","303","508","0","0","303","508","1"
"7","2018","31","","6","28","70","669","0","0","70","669","1"
"7","2018","31","Hotel","12","24","333","765","95","267","428","1032","3"
"7","2018","31","Otros","5","9","0","0","1","1","1","1","4.0454545454545"
"7","2018","31","Hotel","16","20","26","51","2","2","28","53","1"
"7","2018","31","Hotel","4","21","238","375","10","12","248","387","3"
"7","2018","31","Otros","10","11","27","34","0","0","27","34","11.764705882353"
"7","2018","31","Otros","13","14","20","32","0","0","20","32","7.3846153846154"
"7","2018","31","Otros","16","27","14","26","0","0","14","26","13.818181818182"
"7","2018","31","Hotel","9","26","546","546","0","0","546","546","1"
"7","2018","31","Hotel","16","27","704","775","303","368","1007","1143","2.5"
"7","2018","31","Hotel","3","4","830","1508","130","230","960","1738","3"
"7","2018","31","Otros","16","27","75","150","0","0","75","150","2"
"7","2018","31","Otros","16","19","654","1140","0","0","654","1140","1.3333333333333"
"7","2018","31","Hotel","6","12","508","709","0","0","508","709","5"
"7","2018","31","Hotel","2","1","376","640","17","25","393","665","6.4"
"7","2018","31","Hotel","10","11","463","757","4","7","467","764","1"
"7","2018","31","Otros","10","23","48","48","2","2","50","50","1"
"7","2018","31","Otros","10","27","596","893","104","331","700","1224","4.84"
"7","2018","31","Hotel","16","27","345","530","18","98","363","628","2.5"
"7","2018","31","Hotel","6","28","134","169","13","13","147","182","1"
"7","2018","31","Hotel","4","13","93","184","0","0","93","184","5.4"
"7","2018","31","Hotel","14","27","683","805","44","47","727","852","8.5"
"7","2018","31","Hotel","10","27","154","207","93","129","247","336","1"
"7","2018","31","Hotel","13","27","211","301","39","43","250","344","4.2"
"7","2018","31","Hotel","3","4","749","836","24","42","773","878","3"
"7","2018","31","Otros","4","13","73","105","0","0","73","105","3.4"
"7","2018","31","Otros","11","15","23","43","0","0","23","43","2.3571428571429"
"7","2018","31","Otros","6","10","348","1014","0","0","348","1014","3.8518518518518"
"7","2018","31","Otros","2","1","94","167","1","3","95","170","1"
"7","2018","31","","6","12","35","170","0","0","35","170","1"
"7","2018","31","Otros","10","23","309","840","1","3","310","843","1"
"7","2018","31","Hotel","16","19","120","128","0","0","120","128","4"
"7","2018","31","Hotel","10","11","20","120","0","0","20","120","5.6666666666667"
"7","2018","31","Hotel","10","23","9","9","0","0","9","9","4"
"7","2018","31","Otros","14","31","31","82","210","493","241","575","2.8"
"7","2018","31","Otros","13","27","1","1","0","0","1","1","12.2"
"7","2018","31","Hotel","2","1","172","660","0","0","172","660","6.4"
"7","2018","8","Hotel","16","19","31","40","0","0","31","40","4"
"7","2018","31","Otros","12","35","11","14","0","0","11","14","3.5"
"7","2018","31","Otros","15","16","151","385","33","51","184","436","2"
"7","2018","31","Otros","9","22","256","512","41","82","297","594","1"
"7","2018","31","Hotel","10","27","344","571","165","194","509","765","1"
"7","2018","31","Hotel","2","27","74","96","2","2","76","98","3.6"
"7","2018","31","Hotel","16","20","28","149","1","2","29","151","1"
"7","2018","31","Hotel","10","18","147","261","29","52","176","313","7.75"
"7","2018","31","Hotel","6","12","201","206","0","0","201","206","5"
"7","2018","31","Hotel","2","27","56","144","0","0","56","144","3.6"
"7","2018","31","Hotel","15","16","240","472","3","3","243","475","7.8"
"7","2018","31","Hotel","10","23","62","62","15","15","77","77","4"
"7","2018","31","Hotel","11","32","58","82","4","4","62","86","1"
"7","2018","31","Hotel","14","27","95","214","17","98","112","312","8.5"
"7","2018","31","Otros","10","11","38","59","3","3","41","62","11.764705882353"
"7","2018","31","Hotel","2","27","80","101","5","10","85","111","3.6"
"7","2018","31","Otros","13","14","163","343","8","12","171","355","7.3846153846154"
"7","2018","31","Hotel","2","1","167","174","13","45","180","219","6.4"
"7","2018","31","Otros","7","17","294","1148","0","0","294","1148","17.166666666667"
"7","2018","31","Otros","10","23","28","209","0","0","28","209","7"
"7","2018","31","Hotel","13","27","225","225","2","2","227","227","2.75"
"7","2018","31","Otros","10","18","25","64","16","24","41","88","10.25"
"7","2018","31","Otros","5","9","12","13","0","0","12","13","4.0454545454545"
"7","2018","31","Hotel","4","39","55","97","0","0","55","97","2.6"
"7","2018","31","Otros","16","27","103","357","0","0","103","357","13.818181818182"
"7","2018","31","Hotel","14","27","49","79","139","288","188","367","8.5"
"7","2018","31","Hotel","10","11","211","393","14","18","225","411","5.6666666666667"
"7","2018","31","Hotel","10","18","203","446","21","50","224","496","7.75"
"7","2018","31","Otros","14","31","106","162","115","232","221","394","20.2"
"7","2018","31","Otros","11","32","11","21","0","0","11","21","2.2857142857143"
"7","2018","31","Otros","5","5","50","100","0","0","50","100","3.65625"
"7","2018","31","Otros","6","25","70","113","0","0","70","113","2.3846153846154"
"7","2018","31","Hotel","3","4","53","184","3","15","56","199","2.6"
"7","2018","31","Otros","7","27","111","189","0","0","111","189","4.8333333333333"
"7","2018","31","Otros","2","29","78","202","91","203","169","405","3.28"
"7","2018","31","Hotel","2","29","40","140","138","552","178","692","1"
"7","2018","31","Otros","4","21","94","299","0","0","94","299","1"
"7","2018","31","Hotel","7","27","312","333","0","0","312","333","4.1666666666667"
"7","2018","31","Otros","5","5","8","103","0","0","8","103","3.65625"
"7","2018","31","Otros","11","36","57","92","17","35","74","127","5.1904761904762"
"7","2018","31","Hotel","7","27","340","340","0","0","340","340","4.1666666666667"
"7","2018","0","Hotel","16","20","0","0","0","0","0","0","1"
"7","2018","31","Hotel","12","24","194","247","22","62","216","309","3"
"7","2018","31","Hotel","9","26","109","132","8","9","117","141","1.5"
"7","2018","31","Hotel","7","17","328","845","4","8","332","853","10"
"7","2018","31","Hotel","9","37","141","221","20","77","161","298","3.4"
"7","2018","31","Hotel","5","5","256","479","17","25","273","504","2.1428571428571"
"7","2018","31","Otros","6","27","133","266","0","0","133","266","3.960088691796"
"7","2018","31","Hotel","9","37","49","76","2","6","51","82","3.4"
"7","2018","31","Otros","10","27","59","59","39","39","98","98","4.84"
"7","2018","31","Otros","8","3","235","395","0","0","235","395","10"
"7","2018","31","Otros","16","20","16","16","1","1","17","17","3.0769230769231"
"7","2018","31","Otros","9","22","7","11","0","0","7","11","7.6428571428571"
"7","2018","31","Otros","10","27","120","216","3","3","123","219","4.84"
"7","2018","31","Otros","10","23","28","42","0","0","28","42","7"
"7","2018","31","Otros","2","6","501","501","69","69","570","570","1"
"7","2018","31","Otros","4","39","11","19","0","0","11","19","2.2222222222222"
"7","2018","31","Hotel","2","27","62","95","9","9","71","104","1"
"7","2018","31","Hotel","14","31","71","245","86","828","157","1073","24"
"7","2018","31","Otros","2","29","210","475","88","175","298","650","3.28"
"7","2018","31","Otros","8","3","286","1430","0","0","286","1430","10"
"7","2018","31","","13","14","10","22","2","2","12","24","1"
"7","2018","31","Hotel","6","10","206","294","25","43","231","337","6.6"
"7","2018","31","Hotel","8","34","62","73","28","39","90","112","2.5714285714286"
"7","2018","31","Hotel","9","22","49","154","10","50","59","204","2.5555555555556"
"7","2018","31","Hotel","2","6","119","229","52","58","171","287","2.2"
"7","2018","31","Hotel","10","27","131","301","33","46","164","347","2.25"
"7","2018","31","Otros","14","27","159","159","0","0","159","159","11.833333333333"
"7","2018","31","Otros","6","12","313","468","3","3","316","471","1.8256578947368"
"7","2018","31","Hotel","6","27","124","180","0","0","124","180","3"
"7","2018","31","Hotel","5","5","2","2","2","4","4","6","2.1428571428571"
"7","2018","23","Hotel","5","5","26","40","0","0","26","40","2.1428571428571"
"7","2018","31","Hotel","13","27","293","293","0","0","293","293","4.2"
"7","2018","31","Hotel","2","27","151","220","6","6","157","226","3.6"
"7","2018","31","Hotel","8","3","98","98","77","77","175","175","4.1111111111111"
"7","2018","31","Otros","11","36","40","80","0","0","40","80","5.1904761904762"
"7","2018","31","Otros","9","30","106","230","0","0","106","230","2.3333333333333"
"7","2018","31","Otros","16","19","32","34","0","0","32","34","10.263157894737"
"7","2018","31","Hotel","14","31","121","188","281","1114","402","1302","17.4"
"7","2018","31","Hotel","2","1","283","308","9","11","292","319","6.4"
"7","2018","31","Hotel","16","40","994","1939","186","247","1180","2186","5.6666666666667"
"7","2018","31","Otros","7","17","274","528","4","4","278","532","17.166666666667"
"7","2018","31","Hotel","13","27","209","239","69","83","278","322","2.75"
"7","2018","31","Hotel","14","31","206","265","254","788","460","1053","24"
"7","2018","31","Otros","3","4","54","134","7","17","61","151","12.2"
"7","2018","31","Otros","8","34","202","314","74","112","276","426","5.75"
"7","2018","31","Hotel","9","22","144","186","0","0","144","186","2.5555555555556"
"7","2018","31","Hotel","4","21","59","61","2","2","61","63","3"
"7","2018","31","Hotel","6","27","94","153","0","0","94","153","3"
"7","2018","31","Hotel","12","35","204","377","63","140","267","517","1.7272727272727"
"7","2018","31","Hotel","2","29","103","269","84","205","187","474","2"
"7","2018","31","Otros","10","11","45","68","7","14","52","82","11.764705882353"
"7","2018","31","Hotel","6","10","3","3","0","0","3","3","6.6"
"7","2018","31","Hotel","13","14","23","52","0","0","23","52","2"
"7","2018","22","Otros","16","27","227","416","0","0","227","416","13.818181818182"
"7","2018","31","Otros","6","27","24","24","0","0","24","24","3.960088691796"
"7","2018","31","Hotel","16","40","406","870","42","88","448","958","5.6666666666667"
"7","2018","31","Otros","6","10","462","1018","8","24","470","1042","3.8518518518518"
"7","2018","31","Otros","10","23","64","96","10","12","74","108","7"
"7","2018","31","Hotel","6","28","163","208","3","3","166","211","1"
"7","2018","31","Otros","7","38","406","712","88","143","494","855","2.75"
"7","2018","31","Hotel","6","12","181","377","0","0","181","377","5"
"7","2018","31","Hotel","13","27","430","719","3","9","433","728","4.2"
"7","2018","31","Otros","4","21","2","10","0","0","2","10","4.8333333333333"
"7","2018","31","Hotel","16","27","99","174","9","14","108","188","5.8571428571429"
"7","2018","31","Hotel","5","5","95","285","9","23","104","308","2.1428571428571"
"7","2018","31","Otros","12","24","87","253","54","82","141","335","9.2"
"7","2018","31","Otros","15","16","89","156","15","18","104","174","9"
"7","2018","31","Hotel","8","27","210","210","0","0","210","210","4.5"
"7","2018","31","Hotel","9","22","1","2","0","0","1","2","2.5555555555556"
"7","2018","31","Hotel","10","11","173","297","6","11","179","308","5.6666666666667"
"7","2018","31","Hotel","8","3","121","286","8","16","129","302","4.1111111111111"
"7","2018","31","Hotel","6","10","317","475","0","0","317","475","6.6"
"7","2018","31","Otros","9","26","52","621","0","0","52","621","3.8888888888889"
"7","2018","31","Hotel","4","39","61","161","11","110","72","271","2.6"
"7","2018","31","Otros","6","27","2","3","0","0","2","3","3.960088691796"
"7","2018","31","Otros","6","12","145","195","0","0","145","195","1.8256578947368"
"7","2018","31","Hotel","6","27","132","263","0","0","132","263","3"
"7","2018","31","Otros","5","9","13","18","0","0","13","18","4.0454545454545"
"7","2018","31","Hotel","2","27","130","130","8","8","138","138","3.6"
"7","2018","31","Hotel","2","29","72","233","140","428","212","661","1"
"7","2018","31","Hotel","4","13","168","421","2","2","170","423","5.4"
"7","2018","31","","11","15","0","0","0","0","0","0","1"
"7","2018","31","Hotel","6","10","395","455","27","40","422","495","6.6"
"7","2018","31","Otros","6","12","18","40","0","0","18","40","1.8256578947368"
"7","2018","31","Otros","10","18","36","40","0","0","36","40","10.25"
"7","2018","31","Otros","9","22","213","379","0","0","213","379","7.6428571428571"
"7","2018","31","","14","27","373","584","4","6","377","590","1"
"7","2018","31","Hotel","16","27","72","159","10","13","82","172","5.8571428571429"
"7","2018","31","Otros","2","29","14","32","5","15","19","47","3.28"
"7","2018","31","Otros","13","33","36","42","0","0","36","42","5.125"
"7","2018","31","Otros","13","33","15","23","5","5","20","28","5.125"
"7","2018","31","Otros","6","10","100","761","0","0","100","761","3.8518518518518"
"7","2018","31","Hotel","10","18","57","115","0","0","57","115","7.75"
"7","2018","31","Hotel","14","31","145","227","39","88","184","315","24"
"7","2018","31","Hotel","4","21","76","76","6","6","82","82","3"
"7","2018","31","Hotel","3","4","12","26","0","0","12","26","2.6"
"7","2018","31","Otros","8","27","6","12","0","0","6","12","1"
"7","2018","31","Otros","6","27","10","19","0","0","10","19","3.960088691796"
"7","2018","31","Hotel","6","25","187","287","0","0","187","287","1"
"7","2018","31","Otros","6","12","179","345","1","1","180","346","1.8256578947368"
"7","2018","31","Hotel","6","27","15","16","0","0","15","16","3"
"7","2018","31","Otros","6","27","46","112","0","0","46","112","3.960088691796"
"7","2018","31","Otros","6","10","226","582","5","20","231","602","3.8518518518518"
"7","2018","31","Otros","6","12","87","215","0","0","87","215","1.8256578947368"
"7","2018","31","Otros","5","5","6","9","0","0","6","9","3.65625"
"7","2018","31","Hotel","12","24","62","432","4","28","66","460","3"
"7","2018","31","Hotel","15","16","97","140","1","1","98","141","7.8"
"7","2018","31","Otros","4","13","76","79","0","0","76","79","3.4"
"7","2018","31","Hotel","2","29","251","919","26","112","277","1031","1"
"7","2018","31","Hotel","4","21","23","37","10","15","33","52","3"
"7","2018","31","Hotel","10","27","24","92","0","0","24","92","2.25"
"7","2018","31","Hotel","8","3","180","334","26","41","206","375","4.1111111111111"
"7","2018","31","Hotel","12","27","97","140","17","21","114","161","1"
"7","2018","31","Otros","5","5","58","114","5","10","63","124","3.65625"
"7","2018","31","Otros","13","14","40","49","0","0","40","49","7.3846153846154"
"7","2018","31","Otros","10","11","286","423","0","0","286","423","11.764705882353"
"7","2018","31","Otros","16","40","144","226","7","7","151","233","28.142857142857"
"7","2018","31","Hotel","11","36","200","501","9","12","209","513","1"
"7","2018","31","Otros","8","34","50","97","9","11","59","108","5.75"
"7","2018","31","Hotel","7","17","78","108","0","0","78","108","10"
"7","2018","31","Otros","12","35","198","270","5","5","203","275","3.5"
"7","2018","31","Otros","5","9","11","12","2","3","13","15","4.0454545454545"
"7","2018","31","Hotel","9","22","95","142","2","4","97","146","2.5555555555556"
"7","2018","31","Otros","2","29","24","45","63","86","87","131","3.28"
"7","2018","31","Otros","2","29","61","61","48","48","109","109","3.28"
"7","2018","31","Hotel","10","27","74","145","30","31","104","176","2.25"
"7","2018","31","Hotel","16","19","24","150","5","9","29","159","4"
"7","2018","31","Hotel","16","40","118","204","0","0","118","204","16.333333333333"
"7","2018","31","Hotel","8","27","274","406","18","28","292","434","4.5"
"7","2018","31","Otros","13","14","10","16","1","2","11","18","7.3846153846154"
"7","2018","31","Hotel","7","27","72","92","0","0","72","92","4.1666666666667"
"7","2018","31","Otros","2","6","42","792","0","0","42","792","5"
"7","2018","31","Hotel","7","17","367","819","7","15","374","834","10"
"7","2018","31","Hotel","3","4","117","208","30","54","147","262","2.6"
"7","2018","31","Otros","6","12","10","88","0","0","10","88","1.8256578947368"
"7","2018","31","Otros","6","10","37","37","0","0","37","37","3.8518518518518"
"7","2018","31","Hotel","16","40","73","118","13","22","86","140","16.333333333333"
"7","2018","31","Otros","4","39","33","51","0","0","33","51","2.2222222222222"
"7","2018","31","Otros","13","14","17","34","0","0","17","34","7.3846153846154"
"7","2018","31","Otros","7","38","83","152","1","2","84","154","2.75"
"7","2018","31","Hotel","11","32","403","621","0","0","403","621","1"
"7","2018","31","Otros","11","36","117","248","1","3","118","251","5.1904761904762"
"7","2018","31","Hotel","4","21","36","43","0","0","36","43","3"
"7","2018","31","Otros","3","4","12","50","0","0","12","50","12.2"
"7","2018","31","Otros","5","9","28","36","16","19","44","55","4.0454545454545"
"7","2018","31","Hotel","8","27","100","168","15","15","115","183","4.5"
"7","2018","31","","7","17","210","463","10","30","220","493","1"
"7","2018","31","Otros","16","20","29","91","1","12","30","103","3.0769230769231"
"7","2018","31","Otros","4","21","77","144","6","6","83","150","4.8333333333333"
"7","2018","31","Otros","13","33","50","68","1","1","51","69","5.125"
"7","2018","0","","12","35","0","0","0","0","0","0","1"
"7","2018","31","Hotel","13","33","0","0","1","1","1","1","2"
"7","2018","31","Otros","4","39","9","12","0","0","9","12","2.2222222222222"
"7","2018","31","Otros","10","18","19","69","0","0","19","69","10.25"
"7","2018","31","Otros","6","27","94","132","0","0","94","132","3.960088691796"
"7","2018","31","Hotel","4","39","57","157","0","0","57","157","2.6"
"7","2018","31","Otros","14","31","187","256","295","463","482","719","20.2"
"7","2018","31","Hotel","2","29","51","134","252","565","303","699","2"
"7","2018","31","Hotel","9","26","119","173","14","173","133","346","1.5"
"7","2018","31","Otros","12","35","1","1","2","2","3","3","3.5"
"7","2018","31","Hotel","14","27","129","153","18","28","147","181","8.5"
"7","2018","31","Otros","11","36","42","116","0","0","42","116","5.1904761904762"
"7","2018","31","Otros","16","20","173","461","0","0","173","461","3.0769230769231"
"7","2018","31","Otros","4","39","1","7","0","0","1","7","2.2222222222222"
"7","2018","31","Otros","7","27","73","79","2","6","75","85","4.8333333333333"
"7","2018","31","Otros","6","27","91","123","0","0","91","123","3.960088691796"
"7","2018","31","Otros","5","8","10","200","0","0","10","200","5"
"7","2018","31","Otros","9","37","100","133","4","16","104","149","4.5"
"7","2018","31","Hotel","2","6","47","217","0","0","47","217","5.5"
"7","2018","31","Hotel","10","27","71","84","76","80","147","164","2.25"
"7","2018","31","Hotel","9","30","167","323","7","11","174","334","1"
"7","2018","31","Otros","4","13","120","120","0","0","120","120","3.4"
"7","2018","31","Hotel","5","5","177","177","0","0","177","177","1"
"7","2018","31","Otros","7","38","221","527","8","26","229","553","2.75"
"7","2018","31","Hotel","13","14","29","58","0","0","29","58","1"
"7","2018","31","Otros","5","9","3","3","0","0","3","3","4.0454545454545"
"7","2018","31","Otros","5","8","3","4","0","0","3","4","5"
"7","2018","31","Otros","10","27","16","480","0","0","16","480","4.84"
"7","2018","31","Hotel","13","14","6","12","5","10","11","22","1"
"7","2018","31","Otros","11","15","28","47","0","0","28","47","2.3571428571429"
"7","2018","31","Hotel","9","22","213","362","0","0","213","362","2.5555555555556"
"7","2018","31","Otros","11","36","147","283","5","15","152","298","5.1904761904762"
"7","2018","31","Hotel","10","18","1576","4170","736","1801","2312","5971","1"
"7","2018","31","Hotel","6","12","212","324","0","0","212","324","5"
"7","2018","31","","2","29","733","2186","359","932","1092","3118","1"
"7","2018","31","Hotel","16","27","1193","3035","127","366","1320","3401","1"
"7","2018","31","","14","31","301","745","281","1798","582","2543","1"
"7","2018","31","Hotel","8","3","27","111","6","12","33","123","4.1111111111111"
"7","2018","31","Otros","13","33","32","36","1","1","33","37","5.125"
"7","2018","31","","14","27","115","150","0","0","115","150","2.6666666666667"
"7","2018","31","Otros","9","22","22","34","0","0","22","34","7.6428571428571"
"7","2018","31","Hotel","10","11","20","26","0","0","20","26","5.6666666666667"
"7","2018","31","Otros","6","12","15","39","0","0","15","39","1.8256578947368"
"7","2018","31","Hotel","8","3","149","224","8","10","157","234","4.1111111111111"
"7","2018","31","Otros","6","12","411","841","0","0","411","841","1.8256578947368"
"7","2018","31","Hotel","8","27","175","175","0","0","175","175","4.5"
"7","2018","31","Hotel","6","28","183","231","3","3","186","234","2.4"
"7","2018","31","Otros","6","25","22","127","0","0","22","127","2.3846153846154"
"7","2018","31","Otros","6","25","18","28","0","0","18","28","2.3846153846154"
"7","2018","31","Hotel","11","36","792","1239","0","0","792","1239","1"
"7","2018","31","Otros","2","6","40","142","145","441","185","583","5"
"7","2018","31","Hotel","14","31","53","108","79","387","132","495","24"
"7","2018","31","Otros","4","21","24","60","0","0","24","60","4.8333333333333"
"7","2018","31","Otros","7","38","39","84","0","0","39","84","2.75"
"7","2018","31","Otros","13","14","27","31","0","0","27","31","7.3846153846154"
"7","2018","31","Otros","2","29","14","18","6","6","20","24","3.28"
"7","2018","31","Otros","3","4","112","112","24","24","136","136","12.2"
"7","2018","31","Hotel","3","4","413","1022","20","34","433","1056","3"
"7","2018","31","Otros","7","27","322","514","9","9","331","523","1"
"7","2018","31","Otros","7","17","185","192","0","0","185","192","3"
"7","2018","31","Hotel","12","27","201","321","30","43","231","364","1"
"7","2018","31","Otros","5","5","8","16","5","5","13","21","3.65625"
"7","2018","31","Hotel","6","10","250","307","0","0","250","307","6.6"
"7","2018","31","Otros","10","18","6","6","6","24","12","30","10.25"
"7","2018","31","Otros","8","27","51","89","0","0","51","89","9.4"
"7","2018","31","Otros","8","3","37","62","0","0","37","62","10"
"7","2018","31","Hotel","16","27","60","129","3","3","63","132","5.8571428571429"
"7","2018","31","Otros","6","10","45","96","0","0","45","96","3.8518518518518"
"7","2018","31","Hotel","2","6","17","32","0","0","17","32","5.5"
"7","2018","31","Hotel","8","3","41","150","2","10","43","160","4.1111111111111"
"7","2018","31","Otros","10","11","23","23","0","0","23","23","11.764705882353"
"7","2018","31","Otros","6","27","62","241","0","0","62","241","3.960088691796"
"7","2018","31","Otros","15","16","3","3","0","0","3","3","9"
"7","2018","31","Otros","5","5","7","7","0","0","7","7","3.65625"
"7","2018","31","Otros","10","27","161","251","13","16","174","267","4.84"
"7","2018","31","Hotel","7","38","90","107","2","2","92","109","1"
"7","2018","31","Hotel","13","27","5","65","0","0","5","65","4.2"
"7","2018","31","Hotel","16","20","80","128","0","0","80","128","1"
"7","2018","31","Otros","10","27","43","111","32","32","75","143","4.84"
"7","2018","31","Hotel","3","7","106","126","38","49","144","175","1"
"7","2018","31","Otros","2","29","76","202","18","37","94","239","3.28"
"7","2018","31","Otros","10","18","4","4","0","0","4","4","10.25"
"7","2018","31","Otros","9","22","278","802","0","0","278","802","7.6428571428571"
"7","2018","31","Otros","15","27","72","72","0","0","72","72","1.4222222222222"
"7","2018","31","Otros","11","36","2","4","0","0","2","4","5.1904761904762"
"7","2018","31","Otros","5","5","14","23","1","1","15","24","3.65625"
"7","2018","31","Otros","2","29","17","36","16","45","33","81","3.28"
"7","2018","31","Hotel","9","22","183","183","0","0","183","183","2.5555555555556"
"7","2018","31","Otros","11","32","15","30","0","0","15","30","2.2857142857143"
"7","2018","31","Hotel","10","27","198","280","22","27","220","307","1"
"7","2018","31","Otros","16","27","206","424","3","3","209","427","2"
"7","2018","31","Hotel","16","20","20","54","0","0","20","54","1"
"7","2018","31","Otros","11","15","25","80","0","0","25","80","2.3571428571429"
"7","2018","31","Otros","7","17","45","225","0","0","45","225","3"
"7","2018","31","Otros","5","8","10","12","4","4","14","16","5"
"7","2018","31","Hotel","13","33","44","79","9","46","53","125","2"
"7","2018","31","Otros","5","9","17","23","4","4","21","27","4.0454545454545"
"7","2018","31","Otros","10","27","93","151","10","21","103","172","4.84"
"7","2018","31","Otros","9","22","69","125","0","0","69","125","7.6428571428571"
"7","2018","31","Otros","16","40","53","82","0","0","53","82","28.142857142857"
"7","2018","31","Hotel","16","40","95","115","4","4","99","119","1"
"7","2018","31","Otros","15","16","18","57","8","14","26","71","9"
"7","2018","31","Hotel","8","2","26","26","10","12","36","38","3"
"7","2018","31","Otros","8","3","201","420","0","0","201","420","10"
"7","2018","31","Otros","7","17","55","67","0","0","55","67","17.166666666667"
"7","2018","31","Otros","16","20","160","210","0","0","160","210","3.0769230769231"
"7","2018","31","Otros","6","27","18","21","0","0","18","21","3.960088691796"
"7","2018","31","Otros","12","35","16","22","0","0","16","22","3.5"
"7","2018","31","Otros","6","28","110","369","16","37","126","406","4.65"
"7","2018","31","Otros","6","28","246","486","5","8","251","494","4.65"
"7","2018","31","Hotel","8","34","103","165","35","55","138","220","2.5714285714286"
"7","2018","31","Hotel","16","20","2323","2387","15","31","2338","2418","1"
"7","2018","31","Hotel","2","6","277","566","0","0","277","566","2.2"
"7","2018","31","Hotel","7","27","50","775","0","0","50","775","4.1666666666667"
"7","2018","31","Hotel","10","23","23","23","0","0","23","23","4"
"7","2018","31","Hotel","9","26","21","23","2","2","23","25","1.5"
"7","2018","31","Otros","8","27","33","57","0","0","33","57","9.4"
"7","2018","31","Otros","10","27","14","20","4","4","18","24","4.84"
"7","2018","31","Otros","11","15","11","13","0","0","11","13","2.3571428571429"
"7","2018","31","Otros","16","20","32","44","0","0","32","44","3.0769230769231"
"7","2018","31","Otros","11","32","97","211","0","0","97","211","1"
"7","2018","31","Otros","16","27","32","32","7","18","39","50","13.818181818182"
"7","2018","31","Otros","9","37","69","69","0","0","69","69","4.5"
"7","2018","31","Hotel","2","29","30","82","48","118","78","200","2"
"7","2018","31","Hotel","2","1","55","216","4","10","59","226","6.4"
"7","2018","31","Otros","5","8","5","7","0","0","5","7","5"
"7","2018","31","Otros","9","37","46","94","2","4","48","98","4.5"
"7","2018","31","Otros","7","38","237","547","0","0","237","547","2.75"
"7","2018","31","Otros","11","32","64","108","0","0","64","108","1"
"7","2018","31","Otros","4","39","49","53","0","0","49","53","2.2222222222222"
"7","2018","31","Hotel","11","36","54","110","10","20","64","130","2.375"
"7","2018","31","Otros","10","23","34","88","9","29","43","117","7"
"7","2018","31","Hotel","15","16","1327","3411","9","18","1336","3429","2"
"7","2018","31","Otros","2","29","29","29","9","9","38","38","3.28"
"7","2018","31","Hotel","6","12","998","1297","91","107","1089","1404","1"
"7","2018","31","Hotel","11","15","56","314","0","0","56","314","1"
"7","2018","31","Otros","4","21","194","366","0","0","194","366","1"
"7","2018","31","Otros","16","19","54","133","0","0","54","133","10.263157894737"
"7","2018","31","","9","37","266","304","0","0","266","304","1"
"7","2018","31","Otros","10","27","80","142","32","66","112","208","4.84"
"7","2018","31","Otros","11","15","83","83","0","0","83","83","2.3571428571429"
"7","2018","31","Hotel","2","29","56","168","36","108","92","276","2"
"7","2018","31","Hotel","10","27","154","181","43","77","197","258","1"
"7","2018","31","Hotel","11","36","116","182","0","0","116","182","2.375"
"7","2018","31","Hotel","9","37","70","82","12","12","82","94","3.4"
"7","2018","31","Otros","14","27","6","24","2","4","8","28","11.833333333333"
"7","2018","31","Otros","7","38","194","374","0","0","194","374","1"
"7","2018","31","Hotel","2","1","15","150","0","0","15","150","6.4"
"7","2018","31","Otros","2","29","10","24","50","160","60","184","3.28"
"7","2018","31","Hotel","6","27","17","24","0","0","17","24","3"
"7","2018","31","Otros","5","9","14","14","0","0","14","14","4.0454545454545"
"7","2018","31","Hotel","2","1","16","28","0","0","16","28","6.4"
"7","2018","31","Hotel","3","7","23","48","61","95","84","143","1"
"7","2018","31","Otros","7","38","150","388","72","122","222","510","2.75"
"7","2018","31","Otros","7","17","3","3","0","0","3","3","17.166666666667"
"7","2018","31","Otros","7","38","18","36","0","0","18","36","2.75"
"7","2018","31","Otros","4","21","11","11","0","0","11","11","4.8333333333333"
"7","2018","31","Otros","2","1","50","50","5","5","55","55","5.5"
"7","2018","31","Otros","12","35","28","40","0","0","28","40","3.5"
"7","2018","31","Otros","12","35","9","14","2","2","11","16","3.5"
"7","2018","31","Otros","4","21","53","75","3","3","56","78","4.8333333333333"
"7","2018","31","Otros","12","24","6","18","1","4","7","22","9.2"
"7","2018","31","Otros","16","19","5","7","0","0","5","7","10.263157894737"
"7","2018","31","Otros","10","11","41","156","1","2","42","158","11.764705882353"
"7","2018","31","Otros","16","19","31","46","0","0","31","46","10.263157894737"
"7","2018","31","Hotel","2","27","62","168","7","13","69","181","1"
"7","2018","31","Otros","6","28","31","31","0","0","31","31","4.65"
"7","2018","31","Otros","10","18","208","530","18","72","226","602","10.25"
"7","2018","31","Otros","14","27","16","37","0","0","16","37","11.833333333333"
"7","2018","31","Hotel","11","32","15","84","4","8","19","92","1"
"7","2018","31","Otros","8","27","1","1","0","0","1","1","9.4"
"7","2018","31","Hotel","12","35","16","22","28","86","44","108","1.7272727272727"
"7","2018","31","Otros","13","14","24","24","0","0","24","24","7.3846153846154"
"7","2018","31","Otros","11","36","38","84","0","0","38","84","5.1904761904762"
"7","2018","31","Otros","16","20","53","65","6","6","59","71","3.0769230769231"
"7","2018","31","Hotel","14","31","25","44","278","1953","303","1997","7.8"
"7","2018","31","Otros","2","27","178","225","6","12","184","237","3.2"
"7","2018","31","","16","40","275","958","0","0","275","958","3.0555555555556"
"7","2018","31","Hotel","11","36","120","205","2","4","122","209","2.375"
"7","2018","31","Hotel","9","22","24","44","0","0","24","44","2.5555555555556"
"7","2018","31","Otros","2","29","27","74","19","57","46","131","3.28"
"7","2018","31","Hotel","10","27","44","55","18","18","62","73","2.25"
"7","2018","31","Otros","10","27","1","3","0","0","1","3","4.84"
"7","2018","31","Hotel","16","19","23","38","0","0","23","38","4"
"7","2018","25","Otros","2","6","10","39","0","0","10","39","5"
"7","2018","31","Otros","7","27","174","217","0","0","174","217","4.8333333333333"
"7","2018","31","Hotel","2","6","97","768","0","0","97","768","5.5"
"7","2018","31","Hotel","6","28","6","6","3","5","9","11","2.4"
"7","2018","31","Otros","6","10","129","321","43","146","172","467","3.8518518518518"
"7","2018","31","Hotel","6","27","33","38","0","0","33","38","3"
"7","2018","31","Otros","5","5","14","26","1","1","15","27","3.65625"
"7","2018","31","Otros","12","24","41","68","12","22","53","90","9.2"
"7","2018","31","Hotel","8","2","114","468","17","63","131","531","3"
"7","2018","31","Hotel","11","32","70","99","2","9","72","108","1"
"7","2018","31","Otros","10","18","6","11","2","4","8","15","10.25"
"7","2018","31","Hotel","9","37","5","20","7","20","12","40","3.4"
"7","2018","31","Otros","5","9","3","4","0","0","3","4","4.0454545454545"
"7","2018","31","Otros","12","24","0","0","3","3","3","3","9.2"
"7","2018","31","Otros","9","22","1","1","0","0","1","1","7.6428571428571"
"7","2018","31","Otros","2","29","17","58","14","47","31","105","3.28"
"7","2018","31","Otros","10","23","5","155","0","0","5","155","7"
"7","2018","31","Otros","10","27","24","62","3","6","27","68","4.84"
"7","2018","31","Otros","10","11","37","37","0","0","37","37","11.764705882353"
"7","2018","21","Otros","8","3","54","168","0","0","54","168","10"
"7","2018","31","Otros","14","31","121","192","339","503","460","695","20.2"
"7","2018","31","Otros","2","29","232","526","151","441","383","967","3.28"
"7","2018","0","Otros","6","25","0","0","0","0","0","0","1"
"7","2018","31","Hotel","15","16","33","82","0","0","33","82","7.8"
"7","2018","31","Hotel","15","27","169","298","0","0","169","298","1"
"7","2018","31","Otros","10","27","6","186","0","0","6","186","4.84"
"7","2018","31","Otros","10","23","26","26","0","0","26","26","7"
"7","2018","31","Otros","6","27","17","80","0","0","17","80","3.960088691796"
"7","2018","31","Otros","16","40","82","139","0","0","82","139","28.142857142857"
"7","2018","31","Otros","11","36","183","252","0","0","183","252","5.1904761904762"
"7","2018","31","Otros","8","34","32","35","0","0","32","35","5.75"
"7","2018","31","Otros","6","12","14","172","0","0","14","172","1.8256578947368"
"7","2018","31","Otros","6","10","215","725","54","198","269","923","3.8518518518518"
"7","2018","31","Hotel","4","21","189","330","0","0","189","330","3"
"7","2018","31","Hotel","11","36","90","266","12","16","102","282","2.375"
"7","2018","31","Otros","5","8","30","44","2","2","32","46","5"
"7","2018","31","Hotel","7","17","103","168","0","0","103","168","10"
"7","2018","25","Hotel","11","36","315","377","14","17","329","394","1"
"7","2018","31","Otros","9","30","44","102","0","0","44","102","2.3333333333333"
"7","2018","31","Hotel","12","35","51","79","25","46","76","125","1.7272727272727"
"7","2018","31","Otros","2","1","99","215","9","14","108","229","5.5"
"7","2018","31","Hotel","6","25","82","91","0","0","82","91","1"
"7","2018","31","Otros","5","5","4","124","0","0","4","124","3.65625"
"7","2018","31","Otros","2","29","38","103","149","419","187","522","3.28"
"7","2018","31","Hotel","2","6","22","38","2","8","24","46","5.5"
"7","2018","31","Otros","7","17","12","171","0","0","12","171","17.166666666667"
"7","2018","31","Hotel","8","2","35","35","15","15","50","50","3"
"7","2018","31","Hotel","13","14","12","26","1","1","13","27","1"
"7","2018","31","Otros","7","38","91","194","1","1","92","195","2.75"
"7","2018","31","Hotel","14","31","12","20","58","258","70","278","24"
"7","2018","31","Hotel","5","5","33","42","4","8","37","50","2.1428571428571"
"7","2018","31","Otros","2","27","3","12","0","0","3","12","3.2"
"7","2018","31","Otros","5","8","1","1","0","0","1","1","5"
"7","2018","31","Otros","3","4","37","179","0","0","37","179","12.2"
"7","2018","31","Otros","13","14","2","4","0","0","2","4","7.3846153846154"
"7","2018","31","Otros","9","37","25","41","0","0","25","41","4.5"
"7","2018","31","Hotel","10","23","669","874","18","29","687","903","1"
"7","2018","31","Otros","11","32","18","18","0","0","18","18","2.2857142857143"
"7","2018","31","Otros","11","15","9","22","0","0","9","22","2.3571428571429"
"7","2018","31","Otros","8","3","83","249","0","0","83","249","10"
"7","2018","31","Otros","16","20","81","214","0","0","81","214","3.0769230769231"
"7","2018","31","Otros","8","3","11","39","0","0","11","39","10"
"7","2018","31","Otros","16","27","8","10","0","0","8","10","2"
"7","2018","31","Hotel","16","19","8","14","0","0","8","14","4"
"7","2018","31","Hotel","16","27","30","66","0","0","30","66","5.8571428571429"
"7","2018","31","Otros","9","26","27","110","0","0","27","110","3.8888888888889"
"7","2018","31","Otros","5","5","3","5","0","0","3","5","3.65625"
"7","2018","31","Otros","14","27","16","35","0","0","16","35","11.833333333333"
"7","2018","31","Hotel","5","5","1","1","0","0","1","1","2.1428571428571"
"7","2018","31","Hotel","12","24","108","371","36","78","144","449","3"
"7","2018","31","Otros","16","27","26","61","0","0","26","61","13.818181818182"
"7","2018","31","Hotel","14","31","5","20","305","800","310","820","1"
"7","2018","31","Otros","8","3","53","158","4","4","57","162","1"
"7","2018","31","Otros","13","27","121","208","0","0","121","208","12.2"
"7","2018","31","Hotel","16","40","39","63","0","0","39","63","16.333333333333"
"7","2018","31","Otros","11","36","39","179","0","0","39","179","1"
"7","2018","31","Otros","10","27","40","40","0","0","40","40","4.84"
"7","2018","31","Otros","9","22","32","56","0","0","32","56","7.6428571428571"
"7","2018","31","Hotel","5","5","15","23","5","5","20","28","2.1428571428571"
"7","2018","31","Otros","2","29","60","169","63","204","123","373","3.28"
"7","2018","26","Otros","2","29","4","8","0","0","4","8","3.28"
"7","2018","31","Hotel","13","14","2","2","0","0","2","2","1"
"7","2018","31","Otros","6","25","2","4","0","0","2","4","2.3846153846154"
"7","2018","31","Otros","2","1","32","32","2","2","34","34","5.5"
"7","2018","31","Hotel","12","27","12","16","6","6","18","22","1"
"7","2018","31","Hotel","13","27","10","10","0","0","10","10","4.2"
"7","2018","31","Otros","6","12","93","204","0","0","93","204","1.8256578947368"
"7","2018","9","Otros","6","27","3","3","0","0","3","3","3.960088691796"
"7","2018","31","Otros","6","25","4","4","0","0","4","4","2.3846153846154"
"7","2018","31","Hotel","6","28","16","58","0","0","16","58","2.5833333333333"
"7","2018","31","Otros","5","5","16","32","5","8","21","40","3.65625"
"7","2018","31","Otros","5","9","1","2","0","0","1","2","4.0454545454545"
"7","2018","31","Otros","5","8","6","8","0","0","6","8","5"
"7","2018","31","Hotel","2","29","175","646","37","187","212","833","1"
"7","2018","31","Otros","5","5","37","62","0","0","37","62","3.65625"
"7","2018","31","Hotel","9","26","11","12","6","6","17","18","1.5"
"7","2018","31","Otros","9","30","9","13","0","0","9","13","2.3333333333333"
"7","2018","31","Otros","11","15","9","11","0","0","9","11","2.3571428571429"
"7","2018","31","Hotel","16","27","2","4","0","0","2","4","5.8571428571429"
"7","2018","31","Otros","9","30","9","21","0","0","9","21","2.3333333333333"
"7","2018","31","Otros","2","29","36","78","23","46","59","124","3.28"
"7","2018","31","Otros","7","38","57","137","1","1","58","138","2.75"
"7","2018","31","Otros","4","21","24","99","0","0","24","99","4.8333333333333"
"7","2018","31","Otros","9","22","38","67","0","0","38","67","7.6428571428571"
"7","2018","31","Otros","9","22","59","92","0","0","59","92","7.6428571428571"
"7","2018","1","Otros","13","27","2","2","0","0","2","2","12.2"
"7","2018","31","Hotel","11","36","1803","1842","27","45","1830","1887","1"
"7","2018","31","Otros","13","33","22","30","2","2","24","32","5.125"
"7","2018","31","Otros","11","36","56","120","53","117","109","237","5.1904761904762"
"7","2018","31","Otros","12","35","1","1","0","0","1","1","3.5"
"7","2018","31","Otros","12","35","8","12","1","1","9","13","3.5"
"7","2018","31","Otros","10","11","19","55","0","0","19","55","11.764705882353"
"7","2018","31","Otros","12","24","40","90","0","0","40","90","9.2"
"7","2018","31","Otros","16","20","26","100","0","0","26","100","3.0769230769231"
"7","2018","31","Hotel","7","27","174","241","2","2","176","243","1"
"7","2018","31","Otros","6","12","22","26","2","2","24","28","1.8256578947368"
"7","2018","31","Otros","11","32","41","95","7","17","48","112","2.2857142857143"
"7","2018","31","Otros","6","28","65","65","0","0","65","65","4.65"
"7","2018","31","Otros","8","34","1","1","0","0","1","1","5.75"
"7","2018","31","Otros","16","27","20","21","0","0","20","21","13.818181818182"
"7","2018","31","Otros","10","11","5","6","0","0","5","6","11.764705882353"
"7","2018","31","Otros","6","10","58","197","13","66","71","263","3.8518518518518"
"7","2018","31","Otros","8","3","4","10","0","0","4","10","10"
"7","2018","31","Hotel","16","20","134","202","16","26","150","228","1"
"7","2018","31","Hotel","11","32","23","40","0","0","23","40","1"
"7","2018","31","Otros","8","27","21","121","0","0","21","121","9.4"
"7","2018","31","Otros","12","27","24","231","3","3","27","234","3.4285714285714"
"7","2018","31","Otros","6","10","167","456","6","20","173","476","3.8518518518518"
"7","2018","31","Otros","6","10","8","82","1","14","9","96","3.8518518518518"
"7","2018","31","Otros","5","8","10","13","2","2","12","15","5"
"7","2018","31","Otros","5","8","7","11","0","0","7","11","5"
"7","2018","31","Hotel","9","26","43","70","3","13","46","83","1.5"
"7","2018","31","Hotel","13","14","9","18","0","0","9","18","1"
"7","2018","31","Otros","10","18","80","199","18","100","98","299","10.25"
"7","2018","31","Otros","8","2","61","64","24","24","85","88","6.4285714285714"
"7","2018","31","Otros","7","27","4","4","0","0","4","4","4.8333333333333"
"7","2018","31","Otros","2","29","54","124","50","76","104","200","3.28"
"7","2018","20","Otros","11","32","17","32","2","2","19","34","2.2857142857143"
"7","2018","31","Otros","9","30","5","7","8","8","13","15","2.3333333333333"
"7","2018","31","Otros","2","29","23","113","2","6","25","119","3.28"
"7","2018","31","Otros","5","5","6","9","1","3","7","12","3.65625"
"7","2018","31","Otros","11","15","13","18","0","0","13","18","2.3571428571429"
"7","2018","31","Otros","10","23","8","20","0","0","8","20","7"
"7","2018","31","Otros","11","36","70","130","15","25","85","155","5.1904761904762"
"7","2018","31","Hotel","3","7","35","91","51","84","86","175","1"
"7","2018","31","Otros","10","27","7","13","0","0","7","13","4.84"
"7","2018","31","Otros","2","27","6","6","1","1","7","7","3.2"
"7","2018","31","Otros","12","35","1","1","0","0","1","1","3.5"
"7","2018","31","Otros","10","27","4","4","0","0","4","4","4.84"
"7","2018","31","Otros","16","40","44","70","95","231","139","301","28.142857142857"
"7","2018","31","Hotel","8","3","420","812","79","186","499","998","4.1111111111111"
"7","2018","31","Otros","9","22","100","124","4","4","104","128","7.6428571428571"
"7","2018","31","Otros","13","14","69","142","0","0","69","142","7.3846153846154"
"7","2018","31","Otros","5","9","3","4","0","0","3","4","4.0454545454545"
"7","2018","31","Otros","10","18","50","88","0","0","50","88","10.25"
"7","2018","31","Otros","6","25","174","308","0","0","174","308","2.3846153846154"
"7","2018","31","Otros","9","22","33","46","0","0","33","46","7.6428571428571"
"7","2018","31","Otros","10","27","28","55","5","5","33","60","4.84"
"7","2018","31","Otros","16","20","41","62","0","0","41","62","3.0769230769231"
"7","2018","31","Hotel","7","17","141","233","1","1","142","234","10"
"7","2018","31","Otros","15","27","35","97","0","0","35","97","1.4222222222222"
"7","2018","31","Otros","12","35","1","1","0","0","1","1","3.5"
"7","2018","31","Otros","12","35","23","51","16","30","39","81","3.5"
"7","2018","31","Otros","3","7","17","36","0","0","17","36","2"
"7","2018","31","Otros","10","11","3","3","1","2","4","5","11.764705882353"
"7","2018","31","Otros","12","24","4","4","0","0","4","4","9.2"
"7","2018","31","Otros","10","23","15","29","0","0","15","29","7"
"7","2018","31","Otros","7","27","1","1","0","0","1","1","4.8333333333333"
"7","2018","31","","10","18","5","9","0","0","5","9","1"
"7","2018","31","Otros","16","27","5","10","4","4","9","14","13.818181818182"
"7","2018","31","Hotel","2","29","39","75","23","31","62","106","1"
"7","2018","31","Otros","14","27","43","43","0","0","43","43","11.833333333333"
"7","2018","31","Otros","11","32","417","631","0","0","417","631","2.2857142857143"
"7","2018","31","Otros","16","19","34","84","0","0","34","84","1"
"7","2018","31","Otros","16","27","9","9","0","0","9","9","13.818181818182"
"7","2018","31","Otros","8","3","61","328","5","20","66","348","10"
"7","2018","31","Otros","16","27","14","34","0","0","14","34","13.818181818182"
"7","2018","31","Otros","16","20","33","94","0","0","33","94","3.0769230769231"
"7","2018","31","Otros","16","40","208","499","15","27","223","526","28.142857142857"
"7","2018","31","Hotel","11","36","59","106","0","0","59","106","2.375"
"7","2018","31","Otros","6","10","15","16","0","0","15","16","3.8518518518518"
"7","2018","31","Otros","7","38","197","454","19","60","216","514","2.75"
"7","2018","31","Otros","13","14","14","32","0","0","14","32","7.3846153846154"
"7","2018","31","Otros","9","30","34","62","0","0","34","62","2.3333333333333"
"7","2018","31","Otros","13","27","61","151","0","0","61","151","12.2"
"7","2018","31","Otros","10","27","17","17","9","9","26","26","4.84"
"7","2018","31","Otros","6","25","4","11","0","0","4","11","2.3846153846154"
"7","2018","31","Otros","9","26","83","770","0","0","83","770","3.8888888888889"
"7","2018","31","Otros","10","18","23","62","0","0","23","62","10.25"
"7","2018","31","Otros","2","29","39","86","27","71","66","157","3.28"
"7","2018","31","Otros","6","25","24","39","0","0","24","39","2.3846153846154"
"7","2018","31","Otros","5","9","2","2","0","0","2","2","4.0454545454545"
"7","2018","31","Otros","5","9","3","4","0","0","3","4","4.0454545454545"
"7","2018","31","Hotel","9","37","42","71","6","53","48","124","3.4"
"7","2018","31","Hotel","7","38","45","99","5","11","50","110","1"
"7","2018","31","Otros","7","27","59","79","0","0","59","79","4.8333333333333"
"7","2018","31","Otros","5","9","3","4","0","0","3","4","4.0454545454545"
"7","2018","31","Otros","10","27","7","7","8","8","15","15","4.84"
"7","2018","31","Otros","7","27","56","138","0","0","56","138","4.8333333333333"
"7","2018","31","Otros","16","40","62","109","3","4","65","113","28.142857142857"
"7","2018","31","Otros","10","23","23","23","1","1","24","24","7"
"7","2018","31","Otros","15","16","49","299","3","3","52","302","9"
"7","2018","31","Otros","3","7","25","44","50","108","75","152","2"
"7","2018","31","Otros","7","17","32","91","0","0","32","91","17.166666666667"
"7","2018","31","Otros","8","27","56","257","1","3","57","260","9.4"
"7","2018","31","Otros","9","22","77","145","5","5","82","150","7.6428571428571"
"7","2018","31","Otros","16","19","20","25","0","0","20","25","10.263157894737"
"7","2018","0","","15","27","0","0","0","0","0","0","1"
"7","2018","31","Hotel","10","11","23","23","8","8","31","31","5.6666666666667"
"7","2018","31","Otros","2","27","10","240","3","3","13","243","3.2"
"7","2018","31","Otros","8","2","115","217","17","52","132","269","6.4285714285714"
"7","2018","31","Otros","5","5","14","26","1","1","15","27","3.65625"
"7","2018","31","Otros","12","35","1","1","0","0","1","1","3.5"
"7","2018","31","Otros","8","3","18","43","5","10","23","53","10"
"7","2018","31","Otros","12","24","28","53","18","28","46","81","9.2"
"7","2018","31","Otros","11","32","58","259","0","0","58","259","2.2857142857143"
"7","2018","31","Otros","10","27","122","213","27","63","149","276","4.84"
"7","2018","31","Otros","11","15","36","102","0","0","36","102","2.3571428571429"
"7","2018","31","Otros","5","8","5","7","0","0","5","7","5"
"7","2018","31","Otros","14","27","26","26","3","3","29","29","11.833333333333"
"7","2018","31","Otros","13","27","50","86","3","6","53","92","12.2"
"7","2018","31","Hotel","10","18","34","34","78","79","112","113","3.2"
"7","2018","31","Otros","10","27","14","16","5","5","19","21","4.84"
"7","2018","31","Otros","11","32","28","36","0","0","28","36","1"
"7","2018","31","Otros","9","37","28","99","0","0","28","99","4.5"
"7","2018","31","Otros","12","35","10","10","26","26","36","36","3.5"
"7","2018","31","Otros","8","34","178","290","38","66","216","356","5.75"
"7","2018","31","Hotel","16","40","26","28","35","70","61","98","16.333333333333"
"7","2018","31","Hotel","10","11","14","38","4","8","18","46","5.6666666666667"
"7","2018","31","Otros","7","27","2","4","0","0","2","4","4.8333333333333"
"7","2018","31","Hotel","7","38","16","20","0","0","16","20","1"
"7","2018","31","Otros","6","27","3","7","0","0","3","7","3.960088691796"
"7","2018","31","Otros","6","10","126","456","0","0","126","456","3.8518518518518"
"7","2018","31","Otros","6","25","67","103","0","0","67","103","1"
"7","2018","31","Otros","6","25","1","2","0","0","1","2","2.3846153846154"
"7","2018","31","Otros","6","27","9","163","0","0","9","163","3.960088691796"
"7","2018","31","Otros","6","27","96","271","0","0","96","271","3.960088691796"
"7","2018","31","Otros","5","5","15","25","0","0","15","25","3.65625"
"7","2018","31","Otros","5","5","1","1","0","0","1","1","3.65625"
"7","2018","31","Otros","3","4","18","18","6","10","24","28","12.2"
"7","2018","31","Otros","10","23","2","2","0","0","2","2","7"
"7","2018","31","Otros","8","3","6","14","0","0","6","14","10"
"7","2018","11","Otros","5","5","3","11","0","0","3","11","3.65625"
"7","2018","31","Otros","5","8","4","4","0","0","4","4","5"
"7","2018","31","Otros","6","10","145","304","0","0","145","304","3.8518518518518"
"7","2018","31","Otros","16","19","20","61","0","0","20","61","10.263157894737"
"7","2018","31","Otros","11","15","35","75","1","2","36","77","2.3571428571429"
"7","2018","31","Otros","7","38","106","144","0","0","106","144","2.75"
"7","2018","31","Otros","11","32","152","270","20","51","172","321","2.2857142857143"
"7","2018","31","Otros","8","2","73","182","0","0","73","182","6.4285714285714"
"7","2018","31","Otros","10","27","36","57","7","12","43","69","4.84"
"7","2018","31","Otros","6","27","26","46","0","0","26","46","3.960088691796"
"7","2018","31","Otros","11","32","55","110","1","2","56","112","2.2857142857143"
"7","2018","31","Otros","8","34","9","10","4","12","13","22","5.75"
"7","2018","31","Otros","11","32","29","48","0","0","29","48","2.2857142857143"
"7","2018","31","Otros","10","11","7","28","0","0","7","28","11.764705882353"
"7","2018","31","Otros","11","32","31","57","2","4","33","61","2.2857142857143"
"7","2018","31","Otros","14","31","3","3","6","12","9","15","20.2"
"7","2018","31","Hotel","14","31","107","197","538","2571","645","2768","17.4"
"7","2018","31","Otros","11","36","115","365","0","0","115","365","5.1904761904762"
"7","2018","31","Hotel","15","16","884","1857","184","381","1068","2238","2"
"7","2018","31","Otros","15","27","12","60","1","2","13","62","1.4222222222222"
"7","2018","31","Otros","5","5","6","10","0","0","6","10","3.65625"
"7","2018","31","Otros","8","34","3","3","4","6","7","9","5.75"
"7","2018","31","Otros","7","27","19","27","0","0","19","27","4.8333333333333"
"7","2018","31","Otros","12","35","8","12","1","1","9","13","3.5"
"7","2018","31","Otros","5","5","29","58","0","0","29","58","3.65625"
"7","2018","31","Otros","10","11","1","1","0","0","1","1","11.764705882353"
"7","2018","31","Otros","10","11","1","1","0","0","1","1","11.764705882353"
"7","2018","31","Otros","9","30","9","180","0","0","9","180","2.3333333333333"
"7","2018","31","Otros","8","2","145","416","5","10","150","426","6.4285714285714"
"7","2018","31","Otros","10","27","76","127","18","18","94","145","4.84"
"7","2018","31","Otros","5","9","3","4","0","0","3","4","4.0454545454545"
"7","2018","31","Otros","6","27","7","7","0","0","7","7","3.960088691796"
"7","2018","31","Otros","6","10","140","417","13","24","153","441","3.8518518518518"
"7","2018","31","Otros","6","10","157","367","8","24","165","391","3.8518518518518"
"7","2018","31","Otros","6","27","7","12","0","0","7","12","3.960088691796"
"7","2018","31","Otros","6","12","4","36","0","0","4","36","1.8256578947368"
"7","2018","31","Otros","6","10","113","426","0","0","113","426","3.8518518518518"
"7","2018","20","Otros","6","10","63","117","0","0","63","117","3.8518518518518"
"7","2018","31","Otros","6","27","3","3","0","0","3","3","3.960088691796"
"7","2018","31","Otros","6","12","79","95","0","0","79","95","1.8256578947368"
"7","2018","31","Otros","6","10","31","59","0","0","31","59","3.8518518518518"
"7","2018","31","Hotel","6","25","48","78","0","0","48","78","1"
"7","2018","31","Otros","6","27","3","3","0","0","3","3","3.960088691796"
"7","2018","31","Otros","5","9","22","39","2","4","24","43","4.0454545454545"
"7","2018","31","Otros","5","5","23","66","0","0","23","66","3.65625"
"7","2018","31","Otros","5","5","6","7","0","0","6","7","3.65625"
"7","2018","31","Otros","5","5","20","29","4","4","24","33","3.65625"
"7","2018","31","Otros","11","36","108","214","4","8","112","222","5.1904761904762"
"7","2018","31","Hotel","6","10","660","2498","216","1159","876","3657","1"
"7","2018","31","Otros","5","9","3","4","0","0","3","4","4.0454545454545"
"7","2018","31","Otros","5","8","7","14","0","0","7","14","5"
"7","2018","0","Hotel","15","27","0","0","0","0","0","0","1"
"7","2018","31","Hotel","14","31","3","43","182","2713","185","2756","1"
"7","2018","31","Hotel","3","4","156","854","14","84","170","938","3"
"7","2018","31","Otros","3","7","43","43","39","39","82","82","1"
"7","2018","31","Otros","7","38","126","301","0","0","126","301","2.75"
"7","2018","31","Hotel","10","27","19","19","5","5","24","24","1"
"7","2018","31","Hotel","12","35","1","1","2","2","3","3","1.7272727272727"
"7","2018","31","Hotel","10","27","5","18","0","0","5","18","2.25"
"7","2018","31","Hotel","7","17","572","975","51","95","623","1070","4"
"7","2018","31","Hotel","16","19","1","3","0","0","1","3","4"
"7","2018","31","Hotel","2","6","147","270","0","0","147","270","2.2"
"7","2018","17","Otros","5","5","26","108","0","0","26","108","3.65625"
"7","2018","31","Otros","12","24","120","149","92","126","212","275","9.2"
"7","2018","31","Otros","5","8","24","41","0","0","24","41","5"
"7","2018","31","Otros","4","13","143","163","7","7","150","170","1"
"7","2018","31","Otros","10","11","116","116","0","0","116","116","11.764705882353"
"7","2018","31","Otros","12","35","34","54","29","51","63","105","3.5"
"7","2018","31","Otros","10","23","62","66","2","2","64","68","7"
"7","2018","31","Otros","11","36","504","873","91","121","595","994","5.1904761904762"
"7","2018","31","Otros","12","35","8","12","1","1","9","13","3.5"
"7","2018","31","Otros","11","36","17","46","0","0","17","46","5.1904761904762"
"7","2018","31","Otros","8","2","84","167","45","111","129","278","6.4285714285714"
"7","2018","31","Otros","9","30","46","146","0","0","46","146","2.3333333333333"
"7","2018","31","Otros","11","36","87","156","1","1","88","157","5.1904761904762"
"7","2018","31","Otros","6","10","11","13","0","0","11","13","3.8518518518518"
"7","2018","31","Otros","10","18","34","85","0","0","34","85","10.25"
"7","2018","31","Otros","7","27","18","22","5","5","23","27","4.8333333333333"
"7","2018","31","Otros","16","20","4","24","0","0","4","24","1"
"7","2018","31","Otros","9","22","35","60","0","0","35","60","7.6428571428571"
"7","2018","31","Otros","5","5","152","223","2","6","154","229","3.65625"
"7","2018","31","Otros","12","35","8","12","1","1","9","13","3.5"
"7","2018","31","Otros","10","11","30","59","0","0","30","59","11.764705882353"
"7","2018","31","Otros","10","11","3","34","0","0","3","34","11.764705882353"
"7","2018","24","Otros","5","9","24","53","3","3","27","56","4.0454545454545"
"7","2018","31","Otros","5","5","4","6","2","2","6","8","3.65625"
"7","2018","31","Otros","12","35","26","36","33","59","59","95","3.5"
"7","2018","31","Otros","7","38","128","258","12","28","140","286","2.75"
"7","2018","31","Hotel","12","35","1","1","0","0","1","1","1.7272727272727"
"7","2018","31","Otros","13","14","66","94","0","0","66","94","1"
"7","2018","31","Otros","5","5","3","5","0","0","3","5","3.65625"
"7","2018","31","Hotel","14","31","82","1223","396","5940","478","7163","1"
"7","2018","31","Hotel","14","31","114","1707","236","3528","350","5235","1"
"7","2018","31","Hotel","9","26","7","13","0","0","7","13","1.5"
"7","2018","31","Hotel","16","19","7","22","0","0","7","22","1"
"7","2018","31","Otros","16","19","36","69","1","2","37","71","10.263157894737"
"7","2018","31","Otros","9","30","57","71","0","0","57","71","2.3333333333333"
"7","2018","31","Otros","16","19","55","101","0","0","55","101","10.263157894737"
"7","2018","31","Otros","16","19","74","260","0","0","74","260","10.263157894737"
"7","2018","31","Otros","9","26","40","80","0","0","40","80","3.8888888888889"
"7","2018","31","Otros","16","40","1","1","0","0","1","1","28.142857142857"
"7","2018","31","Hotel","16","27","17","34","0","0","17","34","5.8571428571429"
"7","2018","31","Otros","16","19","11","11","0","0","11","11","10.263157894737"
"7","2018","31","Otros","16","19","88","164","0","0","88","164","10.263157894737"
"7","2018","31","","9","30","88","203","12","28","100","231","1"
"7","2018","31","Otros","16","19","6","8","0","0","6","8","10.263157894737"
"7","2018","31","Otros","10","11","6","13","0","0","6","13","11.764705882353"
"7","2018","31","Otros","11","36","25","25","0","0","25","25","5.1904761904762"
"7","2018","31","Otros","16","19","12","21","0","0","12","21","10.263157894737"
"7","2018","31","Otros","16","19","76","94","0","0","76","94","1.3333333333333"
"7","2018","31","Otros","16","19","29","43","0","0","29","43","10.263157894737"
"7","2018","31","Otros","10","18","26","62","12","36","38","98","10.25"
"7","2018","31","Otros","16","19","12","14","0","0","12","14","10.263157894737"
"7","2018","31","Otros","16","19","1","1","0","0","1","1","1.3333333333333"
"7","2018","31","","9","26","436","2118","0","0","436","2118","1"
"7","2018","31","Otros","16","19","26","32","0","0","26","32","10.263157894737"
"7","2018","31","Otros","16","19","36","46","0","0","36","46","10.263157894737"
"7","2018","31","Hotel","8","2","511","1577","217","984","728","2561","1"
"7","2018","31","Otros","6","10","80","118","0","0","80","118","3.8518518518518"
"7","2018","31","Otros","6","12","32","37","0","0","32","37","1.8256578947368"
"7","2018","31","Hotel","16","19","22","52","16","30","38","82","1"
"7","2018","31","Otros","3","7","22","22","76","76","98","98","2"
"7","2018","31","Hotel","2","6","833","2959","41","165","874","3124","1"
"7","2018","31","Hotel","3","4","305","541","37","74","342","615","2.6"
"7","2018","31","Hotel","16","40","1807","2921","507","832","2314","3753","1"
"7","2018","31","Otros","16","27","65","69","0","0","65","69","13.818181818182"
"7","2018","31","Hotel","6","28","214","375","0","0","214","375","2.4"
"7","2018","31","Hotel","8","34","3040","4215","230","424","3270","4639","1"
"7","2018","31","Otros","9","30","1","20","0","0","1","20","2.3333333333333"
"7","2018","31","Hotel","10","18","268","278","276","276","544","554","1"
"7","2018","31","Hotel","9","30","117","170","0","0","117","170","1"
"7","2018","31","Hotel","15","27","71","108","1","1","72","109","1"
"7","2018","31","Hotel","9","22","22","112","0","0","22","112","2.5555555555556"
"7","2018","31","Hotel","6","10","138","272","44","83","182","355","1"
"7","2018","0","","11","15","0","0","0","0","0","0","1"
"7","2018","31","Otros","6","12","5","5","0","0","5","5","1.8256578947368"
"7","2018","31","Hotel","15","27","30","930","0","0","30","930","1"
"7","2018","31","Otros","15","27","18","90","0","0","18","90","1.4222222222222"
"7","2018","31","Otros","15","27","38","38","0","0","38","38","1.4222222222222"
"7","2018","31","Otros","2","1","14","14","16","16","30","30","1"
"7","2018","31","Otros","12","24","4","4","0","0","4","4","9.2"
"7","2018","31","Otros","5","5","5","15","4","4","9","19","3.65625"
"7","2018","31","Hotel","7","27","161","239","19","19","180","258","1"
"7","2018","31","Otros","16","20","37","63","4","4","41","67","3.0769230769231"
"7","2018","31","","10","11","140","213","3","9","143","222","1"
"7","2018","31","Hotel","16","40","40","92","4","12","44","104","16.333333333333"
"7","2018","31","Otros","12","35","2","8","0","0","2","8","3.5"
"7","2018","31","Hotel","6","27","16","20","0","0","16","20","3"
"7","2018","31","Otros","5","5","3","4","0","0","3","4","3.65625"
"7","2018","31","Hotel","6","27","46","46","0","0","46","46","3"
"7","2018","31","Otros","6","25","57","57","0","0","57","57","2.3846153846154"
"7","2018","0","Hotel","15","27","0","0","0","0","0","0","1"
"7","2018","10","Otros","5","9","0","0","6","9","6","9","4.0454545454545"
"7","2018","31","Hotel","15","27","59","177","0","0","59","177","1"
"7","2018","31","Hotel","5","9","20","26","0","0","20","26","1"
"7","2018","31","Hotel","8","34","64","88","20","49","84","137","2.5714285714286"
"7","2018","0","Hotel","15","27","0","0","0","0","0","0","1"
"7","2018","31","Hotel","6","27","243","671","0","0","243","671","3"
"7","2018","31","Otros","6","27","52","168","0","0","52","168","1"
"7","2018","31","Otros","12","27","3","3","31","31","34","34","3.4285714285714"
"7","2018","31","Hotel","2","27","567","596","137","143","704","739","1"
"7","2018","31","Hotel","2","6","140","250","0","0","140","250","1"
"7","2018","31","Otros","2","6","51","51","0","0","51","51","1"
"7","2018","31","Hotel","4","39","123","123","0","0","123","123","1"
"7","2018","31","Hotel","6","10","562","728","42","42","604","770","1"
"7","2018","9","Otros","5","8","2","2","0","0","2","2","5"
"7","2018","0","Hotel","13","33","0","0","0","0","0","0","1"
"7","2018","31","Hotel","13","33","168","336","66","132","234","468","1"
"7","2018","31","Otros","11","32","135","338","2","2","137","340","2.2857142857143"
"7","2018","31","Hotel","9","26","123","184","41","87","164","271","1"
"7","2018","31","Hotel","16","20","43","56","2","2","45","58","1"
"7","2018","31","Otros","16","20","20","26","0","0","20","26","3.0769230769231"
"7","2018","31","","16","40","1262","3465","4","12","1266","3477","1"
"7","2018","31","Hotel","15","16","1694","3563","157","358","1851","3921","1"
"7","2018","31","Hotel","16","27","0","0","0","0","0","0","1"
"7","2018","31","Hotel","5","9","3","4","0","0","3","4","1"
"7","2018","31","Otros","7","38","77","128","4","10","81","138","2.75"
"7","2018","31","Otros","2","6","206","2997","0","0","206","2997","1"
"7","2018","31","Otros","2","6","148","1719","0","0","148","1719","1"
"7","2018","31","Hotel","15","27","394","1187","21","21","415","1208","1"
"7","2018","31","Otros","7","38","69","172","0","0","69","172","2.75"
"7","2018","31","Otros","2","1","9","27","8","23","17","50","1"
"7","2018","31","Otros","8","3","85","208","1","1","86","209","10"
"7","2018","31","Otros","11","36","35","35","0","0","35","35","5.1904761904762"
"7","2018","31","Otros","16","20","50","126","0","0","50","126","3.0769230769231"
"7","2018","31","Otros","8","3","475","702","0","0","475","702","1"
"7","2018","31","Otros","4","39","82","135","0","0","82","135","2.2222222222222"
"7","2018","31","Otros","5","5","7","16","0","0","7","16","3.65625"
"7","2018","31","Otros","12","27","3","8","2","2","5","10","3.4285714285714"
"7","2018","31","Otros","7","27","18","105","0","0","18","105","1"
"7","2018","31","Hotel","2","6","399","808","17","28","416","836","1"
"7","2018","31","Hotel","14","27","313","708","113","273","426","981","1"
"7","2018","31","Hotel","16","19","665","1249","0","0","665","1249","1"
"7","2018","31","","2","1","10","150","0","0","10","150","1"
"7","2018","31","Hotel","2","27","67","123","17","24","84","147","1"
"7","2018","31","Otros","16","20","27","34","0","0","27","34","1"
"7","2018","0","Otros","13","14","0","0","0","0","0","0","1"
"7","2018","31","Hotel","11","36","155","206","0","0","155","206","2.375"
"7","2018","31","Otros","13","14","2","2","0","0","2","2","7.3846153846154"
"7","2018","31","Otros","12","27","14","36","0","0","14","36","3.4285714285714"
"7","2018","31","Hotel","2","6","477","598","7","9","484","607","2.2"
"7","2018","31","Otros","2","6","645","1729","0","0","645","1729","1"
"7","2018","31","Otros","10","27","3","93","0","0","3","93","4.84"
"7","2018","31","Otros","12","27","5","5","6","7","11","12","3.4285714285714"
"7","2018","31","Otros","13","14","53","53","0","0","53","53","7.3846153846154"
"7","2018","31","Otros","6","12","163","230","36","50","199","280","1.8256578947368"
"7","2018","31","Otros","2","6","2240","2240","84","88","2324","2328","1"
"7","2018","31","Hotel","12","35","19","19","0","0","19","19","1.7272727272727"
"7","2018","31","Otros","5","5","16","45","0","0","16","45","3.65625"
"7","2018","31","Otros","9","30","0","0","2","62","2","62","2.3333333333333"
"7","2018","0","Hotel","8","2","0","0","0","0","0","0","1"
"7","2018","31","Otros","9","30","5","109","0","0","5","109","2.3333333333333"
"7","2018","31","Hotel","15","27","127","153","0","0","127","153","1"
"7","2018","31","Hotel","3","7","43","43","2","2","45","45","1"
"7","2018","31","Otros","6","12","453","707","0","0","453","707","1.8256578947368"
"7","2018","31","Otros","12","27","30","53","0","0","30","53","3.4285714285714"
"7","2018","31","Otros","2","6","12","52","0","0","12","52","5"
"7","2018","31","Otros","6","27","2","3","0","0","2","3","3.960088691796"
"7","2018","0","Hotel","10","11","0","0","0","0","0","0","1"
"7","2018","31","Otros","2","1","5","23","0","0","5","23","1"
"7","2018","31","Otros","11","36","40","98","0","0","40","98","5.1904761904762"
"7","2018","31","Hotel","11","32","0","0","0","0","0","0","1"
"7","2018","31","Otros","2","27","12","12","0","0","12","12","1"
"7","2018","31","Otros","12","27","8","24","0","0","8","24","3.4285714285714"
"7","2018","31","Hotel","8","2","61","203","0","0","61","203","3"
"7","2018","31","Hotel","16","20","36","46","0","0","36","46","1"
"7","2018","31","Otros","12","35","32","60","12","16","44","76","3.5"
"7","2018","31","Otros","13","14","19","32","0","0","19","32","1"
"7","2018","31","Otros","2","27","73","87","0","0","73","87","3.2"
"7","2018","31","Hotel","6","27","18","18","0","0","18","18","3"
"7","2018","31","Hotel","8","3","90","182","21","53","111","235","4.1111111111111"
"7","2018","31","Hotel","15","27","45","74","21","77","66","151","1"
"7","2018","31","Otros","8","3","25","57","2","2","27","59","10"
"7","2018","0","Hotel","16","20","0","0","0","0","0","0","1"
"7","2018","31","Hotel","6","28","52","66","0","0","52","66","2.4"
"7","2018","31","Otros","2","1","82","217","26","53","108","270","5.5"
"7","2018","31","Hotel","11","36","105","220","42","85","147","305","2.375"
"7","2018","31","Otros","4","13","65","205","0","0","65","205","1"
"7","2018","31","Otros","2","6","174","1218","0","0","174","1218","1"
"7","2018","31","Otros","8","34","76","115","33","62","109","177","5.75"
"7","2018","31","Hotel","11","15","0","0","0","0","0","0","1"
"7","2018","31","Otros","15","27","6","6","0","0","6","6","1.4222222222222"
"7","2018","31","Hotel","13","14","130","246","0","0","130","246","1"
"7","2018","31","Hotel","13","14","164","348","8","15","172","363","1"
"7","2018","0","Hotel","9","30","0","0","0","0","0","0","1"
"7","2018","31","Hotel","4","13","267","456","6","10","273","466","5.4"
"7","2018","31","Otros","6","27","8","22","0","0","8","22","3.960088691796"
"7","2018","0","Hotel","15","27","0","0","0","0","0","0","1"
"7","2018","31","Hotel","2","29","16","44","67","197","83","241","2"
"7","2018","31","Hotel","13","33","11","18","0","0","11","18","2"
"7","2018","31","Hotel","12","35","51","79","25","46","76","125","1.7272727272727"
"7","2018","31","Hotel","13","14","108","324","5","11","113","335","1"
"7","2018","31","Otros","6","25","39","48","0","0","39","48","2.3846153846154"
"7","2018","31","Hotel","8","2","39","70","0","0","39","70","3"
"7","2018","31","Otros","4","39","7","7","0","0","7","7","2.2222222222222"
"7","2018","31","Otros","6","12","173","285","3","3","176","288","1.8256578947368"
"7","2018","31","Otros","13","33","81","138","2","4","83","142","5.125"
"7","2018","31","Hotel","4","13","101","225","5","17","106","242","5.4"
"7","2018","31","Hotel","7","27","213","370","13","53","226","423","4.1666666666667"
"7","2018","31","Hotel","4","13","623","1792","95","1213","718","3005","1"
"7","2018","0","","5","8","0","0","0","0","0","0","1"
"7","2018","31","Otros","8","2","179","412","16","28","195","440","6.4285714285714"
"7","2018","31","Otros","2","6","2","2","0","0","2","2","1"
"7","2018","31","","6","10","170","428","0","0","170","428","1"
"7","2018","31","Hotel","2","29","25","70","5","16","30","86","2"
"7","2018","31","","14","31","239","464","426","1708","665","2172","1"
"7","2018","31","Hotel","16","27","5712","17136","0","0","5712","17136","1"
"7","2018","31","Hotel","12","35","92","151","46","67","138","218","1.7272727272727"
"7","2018","31","","12","35","9","19","69","142","78","161","1"
"7","2018","31","","9","26","125","212","13","16","138","228","1"
"7","2018","31","Otros","11","32","242","268","0","0","242","268","2.2857142857143"
"7","2018","31","Otros","12","24","25","78","29","42","54","120","9.2"
"7","2018","31","Hotel","6","25","34","36","2","4","36","40","1"
"7","2018","31","Otros","11","32","39","39","0","0","39","39","2.2857142857143"
"7","2018","31","Hotel","16","19","32","36","0","0","32","36","4"
"7","2018","31","Otros","13","33","17","23","2","2","19","25","5.125"
"7","2018","31","Otros","16","27","26","79","0","0","26","79","13.818181818182"
"7","2018","31","Otros","6","12","49","62","0","0","49","62","1.8256578947368"
"7","2018","31","Otros","2","29","31","93","4","10","35","103","3.28"
"7","2018","31","Hotel","14","27","323","413","58","90","381","503","1"
"7","2018","31","Otros","2","1","154","2156","0","0","154","2156","1"
"7","2018","31","Otros","11","32","24","24","0","0","24","24","2.2857142857143"
"7","2018","31","Otros","2","27","42","52","0","0","42","52","1"
"7","2018","31","Hotel","2","29","169","590","22","71","191","661","1"
"7","2018","31","Hotel","4","13","47","385","0","0","47","385","3.2"
"7","2018","31","Hotel","4","21","11","13","2","6","13","19","3"
"7","2018","31","Otros","7","27","126","154","0","0","126","154","4.8333333333333"
"7","2018","31","","3","4","68","157","19","34","87","191","1"
"7","2018","31","Hotel","6","27","47","54","0","0","47","54","3"
"7","2018","31","Otros","16","19","4","7","0","0","4","7","10.263157894737"
"7","2018","31","Otros","11","32","22","42","0","0","22","42","2.2857142857143"
"7","2018","31","Otros","3","7","21","63","28","56","49","119","2"
"7","2018","31","Otros","5","5","7","9","0","0","7","9","3.65625"
"7","2018","24","Otros","15","27","1035","1686","0","0","1035","1686","1.4222222222222"
"7","2018","31","Otros","6","25","2","2","0","0","2","2","2.3846153846154"
"7","2018","31","","10","27","2","2","0","0","2","2","1"
"7","2018","31","Otros","2","29","50","90","159","239","209","329","3.28"
"7","2018","31","Otros","12","35","8","12","1","1","9","13","3.5"
"7","2018","31","Otros","16","19","82","147","0","0","82","147","10.263157894737"
"7","2018","31","Otros","9","26","48","55","3","3","51","58","3.8888888888889"
"7","2018","31","Hotel","13","33","42","42","0","0","42","42","2"
"7","2018","31","Otros","11","32","35","65","0","0","35","65","2.2857142857143"
"7","2018","31","Otros","9","22","11","17","0","0","11","17","7.6428571428571"
"7","2018","31","Otros","6","27","13","128","0","0","13","128","3.960088691796"
"7","2018","31","Otros","15","27","18","18","0","0","18","18","1.4222222222222"
"7","2018","31","Otros","11","32","45","45","0","0","45","45","2.2857142857143"
"7","2018","31","Otros","11","15","41","41","0","0","41","41","2.3571428571429"
"7","2018","31","Otros","9","37","11","95","0","0","11","95","4.5"
"7","2018","31","Otros","5","9","13","18","0","0","13","18","4.0454545454545"
"7","2018","31","Hotel","10","27","21","363","0","0","21","363","2.25"
"7","2018","31","Otros","6","28","22","550","0","0","22","550","4.65"
"7","2018","31","Otros","4","13","23","38","1","2","24","40","3.4"
"7","2018","31","Otros","2","1","0","0","40","800","40","800","1"
"7","2018","31","Otros","2","29","65","90","66","119","131","209","3.28"
"7","2018","31","Hotel","8","3","16","41","0","0","16","41","4.1111111111111"
"7","2018","31","Otros","16","19","53","173","0","0","53","173","1.3333333333333"
"7","2018","31","Otros","12","35","6","8","0","0","6","8","3.5"
"7","2018","31","Hotel","12","35","16","28","7","16","23","44","1.7272727272727"
"7","2018","31","Otros","12","35","0","0","3","3","3","3","3.5"
"7","2018","31","Otros","2","29","55","130","78","160","133","290","3.28"
"7","2018","31","Hotel","7","27","130","183","14","14","144","197","1"
"7","2018","31","Hotel","9","22","38","54","0","0","38","54","2.5555555555556"
"7","2018","31","Hotel","12","35","16","18","13","19","29","37","1.7272727272727"
"7","2018","31","Otros","15","16","133","243","20","65","153","308","2"
"7","2018","31","Hotel","15","27","5","5","0","0","5","5","1"
"7","2018","31","Otros","4","13","79","85","8","8","87","93","3.4"
"7","2018","31","Hotel","8","34","60","74","6","10","66","84","2.5714285714286"
"7","2018","31","Hotel","16","20","52","104","0","0","52","104","1"
"7","2018","31","Hotel","6","28","158","238","42","54","200","292","2.4"
"7","2018","31","Hotel","15","27","136","534","19","182","155","716","1"
"7","2018","31","Otros","12","35","134","230","19","25","153","255","3.5"
"7","2018","31","Otros","11","15","28","93","0","0","28","93","2.3571428571429"
"7","2018","31","Otros","11","15","102","201","0","0","102","201","2.3571428571429"
"7","2018","31","Otros","11","36","43","74","11","27","54","101","5.1904761904762"
"7","2018","31","Hotel","11","36","72","144","3","6","75","150","2.375"
"7","2018","31","Hotel","6","12","44","100","0","0","44","100","5"
"7","2018","31","Otros","8","3","49","77","2","2","51","79","10"
"7","2018","31","Otros","10","27","15","24","4","5","19","29","4.84"
"7","2018","31","Otros","8","3","4","24","0","0","4","24","10"
"7","2018","31","Otros","6","25","21","33","0","0","21","33","2.3846153846154"
"7","2018","31","Hotel","2","27","54","142","0","0","54","142","1"
"7","2018","31","Hotel","10","18","0","0","70","187","70","187","3.2"
"7","2018","31","Otros","11","32","58","130","2","2","60","132","1"
"7","2018","31","Hotel","6","10","2289","2962","502","747","2791","3709","1"
"7","2018","31","Otros","11","32","108","174","12","12","120","186","2.2857142857143"
"7","2018","0","Otros","2","27","0","0","0","0","0","0","1"
"7","2018","31","","12","24","6","26","8","31","14","57","1"
"7","2018","31","Hotel","16","27","589","691","14","14","603","705","5.8571428571429"
"7","2018","31","Hotel","7","38","30","38","4","4","34","42","1"
"7","2018","31","Hotel","6","12","1571","1571","30","30","1601","1601","1"
"8","2018","31","Hotel","14","31","1701","2865","8154","9392","9855","12257","1"
"8","2018","31","Hotel","14","31","679","1425","2425","7298","3104","8723","1"
"8","2018","31","Hotel","14","31","401","692","1060","3496","1461","4188","1"
"8","2018","0","Hotel","11","32","0","0","0","0","0","0","1"
"8","2018","31","Hotel","14","27","3702","5469","757","1119","4459","6588","1"
"8","2018","31","Otros","11","32","78","265","10","34","88","299","2.2857142857143"
"8","2018","31","Hotel","14","31","547","744","3661","4687","4208","5431","5.4"
"8","2018","31","Hotel","15","16","1058","1838","51","69","1109","1907","1"
"8","2018","31","Hotel","14","31","945","1893","1662","6171","2607","8064","5.4"
"8","2018","31","Hotel","12","24","2863","4054","334","421","3197","4475","1"
"8","2018","31","Hotel","16","40","1861","3187","254","500","2115","3687","1"
"8","2018","31","Hotel","6","12","1792","2690","81","154","1873","2844","1"
"8","2018","31","Hotel","10","23","1504","2039","49","61","1553","2100","1"
"8","2018","31","Hotel","14","31","2066","4471","424","916","2490","5387","5.4"
"8","2018","31","Hotel","3","4","1271","2506","149","257","1420","2763","1"
"8","2018","31","","11","32","299","699","39","87","338","786","1"
"8","2018","31","Hotel","6","12","368","721","34","84","402","805","1"
"8","2018","31","Hotel","6","12","2695","3587","1123","1433","3818","5020","1"
"8","2018","31","Hotel","9","26","3687","6845","58","113","3745","6958","1"
"8","2018","31","Hotel","2","1","1179","2721","51","158","1230","2879","1"
"8","2018","31","Hotel","9","26","1239","1931","151","557","1390","2488","1"
"8","2018","31","Hotel","6","12","843","1495","28","51","871","1546","1"
"8","2018","31","Hotel","14","31","102","136","4869","8929","4971","9065","5.4"
"8","2018","31","Hotel","11","32","52","96","13","24","65","120","1"
"8","2018","31","Hotel","2","6","1209","1800","96","204","1305","2004","1"
"8","2018","31","Hotel","16","40","1827","3189","439","650","2266","3839","1"
"8","2018","31","Hotel","14","27","489","1081","1975","2822","2464","3903","1"
"8","2018","31","Otros","11","36","36","140","0","0","36","140","1"
"8","2018","31","Hotel","10","23","1330","2297","163","338","1493","2635","1"
"8","2018","31","Hotel","14","31","426","1112","560","2906","986","4018","7.8"
"8","2018","31","Hotel","7","17","342","702","77","172","419","874","1"
"8","2018","31","Hotel","2","1","1838","3438","0","0","1838","3438","2"
"8","2018","31","Hotel","2","1","1869","2750","251","583","2120","3333","2"
"8","2018","31","Hotel","4","13","1128","2030","86","144","1214","2174","1"
"8","2018","31","Hotel","2","1","1129","2417","114","358","1243","2775","2"
"8","2018","31","Hotel","10","27","2112","5233","546","1051","2658","6284","1"
"8","2018","31","Hotel","14","27","686","808","1330","1588","2016","2396","1"
"8","2018","31","Hotel","14","27","2299","2982","842","2046","3141","5028","1"
"8","2018","31","Hotel","6","12","2311","2327","53","95","2364","2422","1"
"8","2018","31","Hotel","6","12","1743","2149","582","653","2325","2802","1"
"8","2018","31","Hotel","13","27","2268","3465","0","0","2268","3465","1"
"8","2018","31","Hotel","14","31","99","190","1252","3232","1351","3422","7.8"
"8","2018","31","Hotel","6","12","1515","3719","312","764","1827","4483","1"
"8","2018","31","Hotel","16","27","2063","3779","129","231","2192","4010","1"
"8","2018","31","","10","27","11","18","4","4","15","22","1"
"8","2018","31","Hotel","10","18","724","1353","253","547","977","1900","1"
"8","2018","31","Hotel","9","37","1694","2700","204","381","1898","3081","1"
"8","2018","31","Hotel","16","27","521","2084","0","0","521","2084","1"
"8","2018","31","Hotel","15","16","903","1693","92","211","995","1904","2"
"8","2018","31","Hotel","2","1","1460","2447","299","500","1759","2947","2"
"8","2018","31","Hotel","3","4","569","1726","150","190","719","1916","1"
"8","2018","31","Hotel","16","40","1624","2686","760","1014","2384","3700","1"
"8","2018","31","Hotel","7","17","4312","4963","117","131","4429","5094","1"
"8","2018","31","Hotel","12","24","946","1910","316","749","1262","2659","1"
"8","2018","31","Hotel","12","35","518","938","232","490","750","1428","1"
"8","2018","31","Hotel","2","6","372","1143","12","40","384","1183","1"
"8","2018","31","Hotel","13","33","1202","1629","67","147","1269","1776","1"
"8","2018","31","Hotel","10","27","1317","1747","347","599","1664","2346","1"
"8","2018","31","Hotel","10","23","1328","2313","271","474","1599","2787","1"
"8","2018","31","Hotel","11","36","1176","2115","150","1035","1326","3150","1"
"8","2018","31","Hotel","8","34","1523","2266","70","160","1593","2426","1"
"8","2018","31","Hotel","2","6","785","1544","31","62","816","1606","1"
"8","2018","31","Hotel","14","31","667","912","1557","2065","2224","2977","7.8"
"8","2018","31","Hotel","11","36","1868","2954","121","175","1989","3129","1"
"8","2018","31","","10","27","863","3163","103","338","966","3501","1"
"8","2018","31","Hotel","14","31","1629","2266","2275","6757","3904","9023","5.4"
"8","2018","31","Hotel","4","13","2772","2782","4","8","2776","2790","1"
"8","2018","31","Hotel","6","28","1390","1628","107","134","1497","1762","1"
"8","2018","31","Otros","14","31","6","26","7","28","13","54","2.8"
"8","2018","31","Otros","16","27","56","56","0","0","56","56","2"
"8","2018","31","Hotel","2","1","1051","1771","54","119","1105","1890","2"
"8","2018","31","Hotel","10","18","1106","1587","195","280","1301","1867","1"
"8","2018","31","Hotel","7","17","1035","1388","66","76","1101","1464","1"
"8","2018","31","Hotel","12","24","559","1602","185","620","744","2222","1"
"8","2018","31","Hotel","10","18","1268","1978","130","198","1398","2176","1"
"8","2018","31","Hotel","2","1","2884","3459","9","19","2893","3478","1"
"8","2018","31","Hotel","10","18","670","1347","191","389","861","1736","1"
"8","2018","31","Hotel","6","28","1608","2013","219","247","1827","2260","1"
"8","2018","31","Hotel","5","5","764","1441","78","145","842","1586","1"
"8","2018","31","Hotel","4","13","490","948","22","52","512","1000","1"
"8","2018","31","Hotel","10","18","599","951","140","223","739","1174","1"
"8","2018","31","Hotel","16","40","915","1325","80","140","995","1465","1"
"8","2018","31","Hotel","8","3","1761","3690","571","1186","2332","4876","1"
"8","2018","31","Hotel","15","16","402","1393","194","221","596","1614","2"
"8","2018","31","Hotel","14","31","97","291","474","2237","571","2528","7.8"
"8","2018","31","Hotel","13","33","731","1012","130","258","861","1270","1"
"8","2018","31","Hotel","15","16","558","1845","227","441","785","2286","2"
"8","2018","31","Otros","4","21","477","624","0","0","477","624","1"
"8","2018","31","Hotel","6","10","1209","2032","190","564","1399","2596","1"
"8","2018","31","Hotel","16","19","80","92","14","16","94","108","1"
"8","2018","31","Hotel","16","27","825","1800","12","24","837","1824","1"
"8","2018","31","Hotel","10","11","1228","1991","122","171","1350","2162","1"
"8","2018","31","Otros","10","23","346","727","2","4","348","731","1"
"8","2018","1","Hotel","12","35","4","4","1","1","5","5","1"
"8","2018","31","Hotel","11","36","668","1150","15","38","683","1188","1"
"8","2018","31","Hotel","14","31","12","20","573","2524","585","2544","17.4"
"8","2018","31","Hotel","10","18","631","1385","335","881","966","2266","3.2"
"8","2018","31","Hotel","4","13","420","669","24","95","444","764","1"
"8","2018","31","Hotel","6","12","688","815","39","55","727","870","5"
"8","2018","31","Hotel","6","10","726","1015","33","69","759","1084","1"
"8","2018","31","Otros","5","5","138","234","35","70","173","304","3.65625"
"8","2018","31","Hotel","12","24","900","1003","656","875","1556","1878","1"
"8","2018","31","Hotel","8","3","897","1729","179","339","1076","2068","1"
"8","2018","31","Hotel","13","27","767","834","0","0","767","834","2.75"
"8","2018","31","Hotel","15","16","123","369","40","240","163","609","4"
"8","2018","31","Otros","15","16","188","907","71","284","259","1191","2"
"8","2018","31","Otros","16","20","160","302","0","0","160","302","1"
"8","2018","31","Hotel","3","4","1015","1735","89","89","1104","1824","1"
"8","2018","31","Hotel","11","36","76","87","0","0","76","87","1"
"8","2018","31","Hotel","2","6","169","1181","49","295","218","1476","1"
"8","2018","31","Hotel","8","34","842","1433","172","292","1014","1725","1"
"8","2018","31","Hotel","4","13","74","204","0","0","74","204","3.2"
"8","2018","31","Hotel","13","27","1140","2436","0","0","1140","2436","2.75"
"8","2018","31","Hotel","2","29","915","1111","718","900","1633","2011","1"
"8","2018","31","Otros","11","36","61","112","0","0","61","112","1"
"8","2018","31","","10","11","0","0","0","0","0","0","1"
"8","2018","31","Hotel","4","13","1102","1378","92","487","1194","1865","1"
"8","2018","31","Hotel","16","40","2228","3345","315","475","2543","3820","5.6666666666667"
"8","2018","31","Hotel","10","23","1014","1712","145","251","1159","1963","2.8"
"8","2018","31","Hotel","8","34","562","667","30","43","592","710","1"
"8","2018","31","Hotel","5","5","676","1081","25","40","701","1121","1"
"8","2018","31","Hotel","3","4","44","97","50","103","94","200","3"
"8","2018","31","Hotel","9","26","31","34","1","14","32","48","1"
"8","2018","31","Hotel","8","34","534","611","67","90","601","701","1"
"8","2018","31","Hotel","7","17","207","405","41","60","248","465","4"
"8","2018","31","Hotel","4","13","210","432","14","59","224","491","3.2"
"8","2018","31","Hotel","12","35","52","192","135","519","187","711","1"
"8","2018","31","Hotel","16","40","651","1315","207","380","858","1695","1"
"8","2018","31","Hotel","9","26","500","851","58","256","558","1107","1"
"8","2018","31","","6","27","148","279","23","129","171","408","1"
"8","2018","31","Hotel","9","26","491","856","0","0","491","856","1"
"8","2018","31","Hotel","4","13","90","148","15","19","105","167","3.2"
"8","2018","31","Hotel","6","28","275","334","6","8","281","342","1"
"8","2018","31","","2","29","78","219","514","1552","592","1771","1"
"8","2018","31","Hotel","14","31","64","89","149","404","213","493","1"
"8","2018","31","Hotel","13","33","1193","1645","60","139","1253","1784","1"
"8","2018","31","Hotel","8","3","461","1161","166","389","627","1550","1"
"8","2018","31","Hotel","14","27","1776","3289","660","1128","2436","4417","1"
"8","2018","31","Hotel","16","40","200","400","89","178","289","578","5.6666666666667"
"8","2018","31","Hotel","12","24","188","463","123","181","311","644","1"
"8","2018","31","Hotel","10","18","930","1653","84","211","1014","1864","3.2"
"8","2018","31","Otros","15","16","65","65","24","24","89","89","9"
"8","2018","31","Hotel","6","10","589","671","0","0","589","671","1"
"8","2018","31","Hotel","10","11","582","1190","68","319","650","1509","1"
"8","2018","31","Otros","6","10","112","2220","0","0","112","2220","3.8518518518518"
"8","2018","31","Otros","10","23","35","70","0","0","35","70","1"
"8","2018","31","Hotel","10","23","542","896","116","217","658","1113","2.8"
"8","2018","31","Hotel","6","12","341","774","2","2","343","776","5"
"8","2018","31","Hotel","6","27","56","98","4","8","60","106","3"
"8","2018","31","Hotel","10","23","621","994","115","261","736","1255","2.8"
"8","2018","31","","4","39","239","417","0","0","239","417","1"
"8","2018","31","Hotel","8","34","219","377","40","100","259","477","1"
"8","2018","31","Hotel","8","34","411","756","30","55","441","811","1"
"8","2018","31","Otros","4","39","87","156","0","0","87","156","2.2222222222222"
"8","2018","31","Otros","13","14","157","320","0","0","157","320","1"
"8","2018","31","Hotel","10","23","135","180","7","9","142","189","2.8"
"8","2018","31","Otros","13","14","169","699","0","0","169","699","1"
"8","2018","31","Hotel","12","24","145","395","177","333","322","728","1"
"8","2018","31","","6","25","107","147","0","0","107","147","1"
"8","2018","31","Hotel","15","27","518","1018","2","4","520","1022","1"
"8","2018","0","Hotel","12","35","0","0","0","0","0","0","1"
"8","2018","31","Hotel","16","40","58","63","96","120","154","183","1"
"8","2018","31","Hotel","16","27","484","1363","1801","8124","2285","9487","1"
"8","2018","31","Hotel","9","30","58","111","0","0","58","111","1"
"8","2018","31","Hotel","4","13","400","837","39","76","439","913","3.2"
"8","2018","31","Hotel","2","29","124","347","232","729","356","1076","1"
"8","2018","31","Hotel","16","20","389","632","40","103","429","735","1"
"8","2018","31","Hotel","5","5","451","667","26","50","477","717","1"
"8","2018","31","Hotel","13","33","775","1227","76","168","851","1395","1"
"8","2018","31","Otros","16","19","89","174","0","0","89","174","1.3333333333333"
"8","2018","31","Hotel","12","24","196","437","150","370","346","807","1"
"8","2018","31","","8","2","537","1092","15","31","552","1123","1"
"8","2018","0","Hotel","12","35","0","0","0","0","0","0","1"
"8","2018","31","Hotel","16","27","126","264","84","102","210","366","2.5"
"8","2018","29","Otros","16","27","401","628","3","5","404","633","2"
"8","2018","31","Hotel","8","34","335","551","42","58","377","609","1"
"8","2018","31","Otros","8","3","82","207","0","0","82","207","1"
"8","2018","31","Hotel","7","27","219","303","120","147","339","450","1"
"8","2018","31","Hotel","4","39","175","300","2","2","177","302","1"
"8","2018","31","Hotel","15","16","234","468","14","30","248","498","4"
"8","2018","31","Hotel","4","39","9","16","2","2","11","18","1"
"8","2018","31","Hotel","4","39","202","369","5","9","207","378","1"
"8","2018","31","Hotel","15","16","182","917","2","2","184","919","4"
"8","2018","31","Hotel","14","31","86","202","285","1111","371","1313","17.4"
"8","2018","31","Hotel","8","34","297","423","33","43","330","466","1"
"8","2018","31","Hotel","6","28","213","338","4","8","217","346","1"
"8","2018","31","Hotel","7","17","916","1469","62","99","978","1568","4"
"8","2018","31","Otros","7","27","1","2","0","0","1","2","1"
"8","2018","31","Hotel","11","36","1101","1304","43","62","1144","1366","1"
"8","2018","31","Otros","4","21","250","384","76","103","326","487","1"
"8","2018","31","Otros","15","16","66","101","24","27","90","128","2"
"8","2018","31","Otros","7","17","371","964","0","0","371","964","3"
"8","2018","31","Hotel","7","38","42","48","0","0","42","48","1"
"8","2018","31","Hotel","16","27","531","996","10","40","541","1036","2.5"
"8","2018","31","Hotel","2","6","78","89","4","4","82","93","2.2"
"8","2018","31","Hotel","11","36","320","560","61","145","381","705","1"
"8","2018","31","Hotel","6","28","13","13","0","0","13","13","1"
"8","2018","31","Hotel","6","12","198","331","0","0","198","331","5"
"8","2018","31","Otros","9","22","68","92","4","4","72","96","1"
"8","2018","31","","13","14","199","246","0","0","199","246","2"
"8","2018","31","Hotel","2","29","110","140","418","789","528","929","1"
"8","2018","31","Hotel","2","29","41","115","41","153","82","268","1"
"8","2018","31","Otros","4","13","302","345","5","5","307","350","1"
"8","2018","31","Hotel","15","16","69","188","32","96","101","284","4"
"8","2018","31","Hotel","2","1","158","460","3","17","161","477","6.4"
"8","2018","31","Otros","7","27","115","121","0","0","115","121","1"
"8","2018","31","Otros","13","33","6","6","0","0","6","6","5.125"
"8","2018","31","","4","21","133","157","0","0","133","157","1"
"8","2018","31","Hotel","6","10","345","345","5","5","350","350","1"
"8","2018","31","Hotel","11","36","124","282","0","0","124","282","1"
"8","2018","31","Otros","14","31","100","700","0","0","100","700","2.8"
"8","2018","31","Hotel","7","27","245","303","1","1","246","304","1"
"8","2018","31","Otros","6","10","63","403","0","0","63","403","3.8518518518518"
"8","2018","31","Hotel","4","39","45","77","2","2","47","79","2.6"
"8","2018","31","Otros","8","2","35","69","21","48","56","117","6.4285714285714"
"8","2018","31","Otros","11","36","26","51","2","4","28","55","5.1904761904762"
"8","2018","31","Hotel","13","33","280","280","0","0","280","280","1"
"8","2018","31","","3","4","46","119","33","56","79","175","1"
"8","2018","31","Hotel","7","17","281","742","22","84","303","826","4"
"8","2018","31","Hotel","8","2","189","238","7","10","196","248","1"
"8","2018","31","Otros","15","16","197","288","38","71","235","359","2"
"8","2018","31","Hotel","10","11","334","374","13","25","347","399","1"
"8","2018","31","Hotel","16","19","300","455","0","0","300","455","1"
"8","2018","31","Hotel","10","23","66","96","21","23","87","119","4"
"8","2018","31","","7","38","254","447","49","87","303","534","1"
"8","2018","31","Hotel","7","27","517","885","21","27","538","912","1"
"8","2018","31","Hotel","11","36","270","590","0","0","270","590","1"
"8","2018","31","Hotel","16","40","170","265","11","18","181","283","16.333333333333"
"8","2018","31","Hotel","16","19","15","19","0","0","15","19","1"
"8","2018","31","Hotel","16","19","0","0","0","0","0","0","1"
"8","2018","0","Hotel","16","20","0","0","0","0","0","0","1"
"8","2018","31","Hotel","10","11","227","363","19","29","246","392","1"
"8","2018","31","Otros","7","27","43","95","0","0","43","95","4.8333333333333"
"8","2018","31","Otros","7","27","23","54","0","0","23","54","1"
"8","2018","31","Hotel","7","27","32","39","0","0","32","39","4.1666666666667"
"8","2018","31","Otros","13","14","22","26","0","0","22","26","1"
"8","2018","31","Otros","11","15","27","27","0","0","27","27","2.3571428571429"
"8","2018","31","Otros","10","27","20","152","4","4","24","156","4.84"
"8","2018","31","Otros","14","31","462","462","2560","2560","3022","3022","2.8"
"8","2018","31","Otros","11","36","12","13","0","0","12","13","5.1904761904762"
"8","2018","31","Hotel","16","19","49","60","0","0","49","60","1"
"8","2018","31","","14","27","360","470","20","36","380","506","2.6666666666667"
"8","2018","31","Hotel","16","40","70","80","10","10","80","90","5.6666666666667"
"8","2018","31","Hotel","10","27","10","27","0","0","10","27","2.25"
"8","2018","31","Otros","2","29","50","164","181","497","231","661","3.28"
"8","2018","31","Hotel","13","27","2","6","4","8","6","14","1"
"8","2018","31","Otros","9","22","5","5","0","0","5","5","1"
"8","2018","31","Hotel","2","27","150","182","8","8","158","190","1"
"8","2018","31","Hotel","8","34","522","662","5","10","527","672","1"
"8","2018","31","Hotel","7","27","464","623","0","0","464","623","1"
"8","2018","31","Hotel","15","16","197","440","27","48","224","488","4"
"8","2018","31","Hotel","16","20","34","49","0","0","34","49","1"
"8","2018","31","Otros","4","13","87","214","0","0","87","214","1"
"8","2018","31","Hotel","2","1","206","539","3","3","209","542","6.4"
"8","2018","31","Otros","11","32","7","9","0","0","7","9","2.2857142857143"
"8","2018","31","Hotel","2","29","14","120","83","780","97","900","1"
"8","2018","31","Hotel","16","27","224","229","75","90","299","319","2.5"
"8","2018","31","Hotel","10","18","197","732","0","0","197","732","3.2"
"8","2018","31","Otros","11","36","295","389","21","27","316","416","1"
"8","2018","31","Otros","13","14","47","68","2","2","49","70","1"
"8","2018","0","Hotel","7","27","0","0","0","0","0","0","1"
"8","2018","31","Otros","7","17","135","437","22","206","157","643","3"
"8","2018","31","Otros","14","31","305","441","119","291","424","732","2.8"
"8","2018","31","Hotel","2","29","435","1270","149","472","584","1742","1"
"8","2018","31","Hotel","8","3","79","131","20","43","99","174","1"
"8","2018","31","Hotel","8","34","410","593","73","112","483","705","2.5714285714286"
"8","2018","31","Hotel","8","34","254","316","43","68","297","384","2.5714285714286"
"8","2018","31","Hotel","12","35","120","155","36","49","156","204","1"
"8","2018","31","Hotel","11","32","48","228","4","12","52","240","1"
"8","2018","31","Hotel","13","33","156","244","5","36","161","280","2"
"8","2018","31","Hotel","10","23","153","202","17","33","170","235","2.8"
"8","2018","31","Hotel","12","35","55","74","13","27","68","101","1"
"8","2018","31","","16","40","241","363","22","43","263","406","3.0555555555556"
"8","2018","31","Otros","16","19","84","188","0","0","84","188","1.3333333333333"
"8","2018","0","Otros","16","20","0","0","0","0","0","0","1"
"8","2018","31","Hotel","6","12","187","340","10","19","197","359","5"
"8","2018","31","Hotel","16","19","168","217","0","0","168","217","4"
"8","2018","31","Hotel","12","24","110","143","104","125","214","268","1"
"8","2018","31","Hotel","12","24","160","320","45","62","205","382","3"
"8","2018","31","Hotel","8","3","72","504","0","0","72","504","1"
"8","2018","0","Hotel","5","9","0","0","0","0","0","0","1"
"8","2018","31","Hotel","16","27","289","496","7","15","296","511","2.5"
"8","2018","31","Otros","10","23","48","48","0","0","48","48","7"
"8","2018","31","Otros","13","14","98","128","0","0","98","128","7.3846153846154"
"8","2018","31","Otros","2","6","52","77","6","6","58","83","1"
"8","2018","21","Hotel","15","16","7","8","50","60","57","68","7.8"
"8","2018","31","Hotel","8","3","224","1047","0","0","224","1047","1"
"8","2018","31","Hotel","8","34","220","380","33","48","253","428","1"
"8","2018","31","Hotel","8","3","34","45","4","4","38","49","1"
"8","2018","31","","2","29","71","150","64","274","135","424","1"
"8","2018","31","Hotel","2","1","443","610","19","26","462","636","6.4"
"8","2018","31","Hotel","7","17","61","147","0","0","61","147","4"
"8","2018","31","Otros","7","17","202","403","0","0","202","403","3"
"8","2018","31","Hotel","16","40","70","127","12","29","82","156","5.6666666666667"
"8","2018","31","Hotel","12","24","199","394","54","82","253","476","1"
"8","2018","31","Hotel","14","31","91","206","286","1453","377","1659","17.4"
"8","2018","0","Hotel","9","26","0","0","0","0","0","0","1"
"8","2018","31","Hotel","6","12","2","31","0","0","2","31","5"
"8","2018","31","Otros","5","9","12","12","0","0","12","12","4.0454545454545"
"8","2018","31","Otros","5","9","2","2","1","1","3","3","4.0454545454545"
"8","2018","31","Otros","15","27","37","51","0","0","37","51","1.4222222222222"
"8","2018","31","Hotel","8","34","13","13","0","0","13","13","2.5714285714286"
"8","2018","31","Hotel","10","18","365","711","85","208","450","919","7.75"
"8","2018","31","Hotel","15","16","292","608","33","68","325","676","7.8"
"8","2018","31","Hotel","2","29","119","306","263","787","382","1093","1"
"8","2018","31","Hotel","4","39","78","145","5","10","83","155","2.6"
"8","2018","31","Otros","4","39","151","198","0","0","151","198","2.2222222222222"
"8","2018","31","Hotel","4","13","127","272","11","17","138","289","5.4"
"8","2018","31","Otros","10","23","23","23","0","0","23","23","7"
"8","2018","31","Otros","14","31","131","289","267","629","398","918","20.2"
"8","2018","31","Hotel","3","4","46","67","11","11","57","78","2.6"
"8","2018","31","Hotel","10","23","87","106","5","9","92","115","4"
"8","2018","31","Otros","9","22","297","560","0","0","297","560","1"
"8","2018","31","Hotel","12","24","110","251","47","97","157","348","3"
"8","2018","31","Hotel","13","14","30","32","0","0","30","32","1"
"8","2018","31","Hotel","12","35","137","198","27","41","164","239","1.7272727272727"
"8","2018","31","Hotel","6","28","336","532","0","0","336","532","1"
"8","2018","31","","6","28","134","479","0","0","134","479","1"
"8","2018","31","Hotel","12","24","297","527","140","401","437","928","3"
"8","2018","31","Otros","5","9","14","25","1","1","15","26","4.0454545454545"
"8","2018","31","Hotel","16","20","45","47","0","0","45","47","1"
"8","2018","31","Hotel","4","21","144","221","5","6","149","227","3"
"8","2018","31","Otros","10","11","20","32","0","0","20","32","11.764705882353"
"8","2018","31","Otros","13","14","20","24","0","0","20","24","7.3846153846154"
"8","2018","31","Otros","16","27","18","18","0","0","18","18","13.818181818182"
"8","2018","31","Hotel","9","26","273","546","0","0","273","546","1"
"8","2018","31","Hotel","16","27","710","716","511","517","1221","1233","2.5"
"8","2018","31","Hotel","3","4","867","1184","166","187","1033","1371","3"
"8","2018","31","Otros","16","27","80","80","0","0","80","80","2"
"8","2018","31","Otros","16","19","363","487","4","4","367","491","1.3333333333333"
"8","2018","31","Hotel","6","12","453","666","4","4","457","670","5"
"8","2018","31","Hotel","2","1","304","521","15","23","319","544","6.4"
"8","2018","31","Hotel","10","11","390","615","28","92","418","707","1"
"8","2018","31","Otros","10","23","60","60","0","0","60","60","1"
"8","2018","31","Otros","10","27","546","598","7","9","553","607","4.84"
"8","2018","31","Hotel","16","27","379","522","29","114","408","636","2.5"
"8","2018","31","Hotel","6","28","113","143","0","0","113","143","1"
"8","2018","31","Hotel","4","13","55","81","0","0","55","81","5.4"
"8","2018","31","Hotel","14","27","467","769","12","12","479","781","8.5"
"8","2018","31","Hotel","10","27","115","157","137","168","252","325","1"
"8","2018","31","Hotel","13","27","260","430","14","20","274","450","4.2"
"8","2018","31","Hotel","3","4","702","846","13","33","715","879","3"
"8","2018","31","Otros","4","13","79","144","1","1","80","145","3.4"
"8","2018","31","Otros","11","15","14","24","0","0","14","24","2.3571428571429"
"8","2018","31","Otros","6","10","34","162","208","884","242","1046","3.8518518518518"
"8","2018","31","Otros","2","1","52","56","1","3","53","59","1"
"8","2018","31","","6","12","40","286","0","0","40","286","1"
"8","2018","31","Otros","10","23","326","913","2","4","328","917","1"
"8","2018","31","Hotel","16","19","104","112","0","0","104","112","4"
"8","2018","31","Hotel","10","11","4","4","0","0","4","4","5.6666666666667"
"8","2018","31","Hotel","10","23","65","65","4","4","69","69","4"
"8","2018","31","Otros","14","31","38","94","224","510","262","604","2.8"
"8","2018","31","Otros","13","27","3","4","0","0","3","4","12.2"
"8","2018","31","Hotel","2","1","185","668","0","0","185","668","6.4"
"8","2018","8","Hotel","16","19","18","38","0","0","18","38","4"
"8","2018","31","Otros","12","35","11","11","0","0","11","11","3.5"
"8","2018","31","Otros","15","16","96","189","42","79","138","268","2"
"8","2018","31","Otros","9","22","220","440","32","64","252","504","1"
"8","2018","31","Hotel","10","27","203","333","87","111","290","444","1"
"8","2018","31","Hotel","2","27","30","34","0","0","30","34","3.6"
"8","2018","31","Hotel","16","20","36","77","0","0","36","77","1"
"8","2018","31","Hotel","10","18","164","284","31","46","195","330","7.75"
"8","2018","31","Hotel","6","12","189","189","0","0","189","189","5"
"8","2018","31","Hotel","2","27","88","267","0","0","88","267","3.6"
"8","2018","31","Hotel","15","16","121","182","9","12","130","194","7.8"
"8","2018","31","Hotel","10","23","71","71","14","14","85","85","4"
"8","2018","31","Hotel","11","32","26","34","2","2","28","36","1"
"8","2018","31","Hotel","14","27","110","323","35","89","145","412","8.5"
"8","2018","31","Otros","10","11","15","31","0","0","15","31","11.764705882353"
"8","2018","31","Hotel","2","27","47","67","0","0","47","67","3.6"
"8","2018","31","Otros","13","14","190","366","0","0","190","366","7.3846153846154"
"8","2018","31","Hotel","2","1","168","212","12","12","180","224","6.4"
"8","2018","31","Otros","7","17","188","380","0","0","188","380","17.166666666667"
"8","2018","31","Otros","10","23","22","194","0","0","22","194","7"
"8","2018","31","Hotel","13","27","132","132","2","2","134","134","2.75"
"8","2018","31","Otros","10","18","8","10","8","8","16","18","10.25"
"8","2018","31","Otros","5","9","10","20","0","0","10","20","4.0454545454545"
"8","2018","31","Hotel","4","39","128","175","0","0","128","175","2.6"
"8","2018","31","Otros","16","27","86","277","6","6","92","283","13.818181818182"
"8","2018","31","Hotel","14","27","12","28","17","25","29","53","8.5"
"8","2018","31","Hotel","10","11","268","492","24","30","292","522","5.6666666666667"
"8","2018","31","Hotel","10","18","178","380","28","58","206","438","7.75"
"8","2018","31","Otros","14","31","156","196","140","263","296","459","20.2"
"8","2018","31","Otros","11","32","11","18","0","0","11","18","2.2857142857143"
"8","2018","31","Otros","5","5","35","78","0","0","35","78","3.65625"
"8","2018","31","Otros","6","25","62","89","0","0","62","89","2.3846153846154"
"8","2018","31","Hotel","3","4","47","153","4","8","51","161","2.6"
"8","2018","31","Otros","7","27","34","56","6","6","40","62","4.8333333333333"
"8","2018","31","Otros","2","29","23","79","106","919","129","998","3.28"
"8","2018","31","Hotel","2","29","79","206","149","576","228","782","1"
"8","2018","31","Otros","4","21","83","203","0","0","83","203","1"
"8","2018","31","Hotel","7","27","231","256","0","0","231","256","4.1666666666667"
"8","2018","31","Otros","5","5","4","44","0","0","4","44","3.65625"
"8","2018","31","Otros","11","36","10","18","2","2","12","20","5.1904761904762"
"8","2018","31","Hotel","7","27","319","319","0","0","319","319","4.1666666666667"
"8","2018","0","Hotel","16","20","0","0","0","0","0","0","1"
"8","2018","31","Hotel","12","24","210","248","3","8","213","256","3"
"8","2018","31","Hotel","9","26","145","200","5","8","150","208","1.5"
"8","2018","31","Hotel","7","17","221","305","5","8","226","313","10"
"8","2018","31","Hotel","9","37","248","331","18","27","266","358","3.4"
"8","2018","31","Hotel","5","5","300","476","15","38","315","514","2.1428571428571"
"8","2018","31","Otros","6","27","123","242","0","0","123","242","3.960088691796"
"8","2018","31","Hotel","9","37","44","76","0","0","44","76","3.4"
"8","2018","31","Otros","10","27","55","55","81","81","136","136","4.84"
"8","2018","31","Otros","8","3","94","120","8","12","102","132","10"
"8","2018","31","Otros","16","20","21","21","0","0","21","21","3.0769230769231"
"8","2018","31","Otros","9","22","5","7","0","0","5","7","7.6428571428571"
"8","2018","31","Otros","10","27","138","229","9","9","147","238","4.84"
"8","2018","31","Otros","10","23","25","36","0","0","25","36","7"
"8","2018","31","Otros","2","6","394","394","84","84","478","478","1"
"8","2018","31","Otros","4","39","18","18","0","0","18","18","2.2222222222222"
"8","2018","31","Hotel","2","27","47","55","3","3","50","58","1"
"8","2018","31","Hotel","14","31","41","104","132","953","173","1057","24"
"8","2018","31","Otros","2","29","118","256","130","300","248","556","3.28"
"8","2018","31","Otros","8","3","312","1548","0","0","312","1548","10"
"8","2018","31","","13","14","10","14","1","1","11","15","1"
"8","2018","31","Hotel","6","10","140","206","24","24","164","230","6.6"
"8","2018","31","Hotel","8","34","59","72","3","5","62","77","2.5714285714286"
"8","2018","31","Hotel","9","22","421","1601","0","0","421","1601","2.5555555555556"
"8","2018","31","Hotel","2","6","103","203","28","34","131","237","2.2"
"8","2018","31","Hotel","10","27","117","235","39","59","156","294","2.25"
"8","2018","31","Otros","14","27","102","102","0","0","102","102","11.833333333333"
"8","2018","31","Otros","6","12","380","536","10","13","390","549","1.8256578947368"
"8","2018","31","Hotel","6","27","140","153","0","0","140","153","3"
"8","2018","31","Hotel","5","5","22","35","0","0","22","35","2.1428571428571"
"8","2018","31","Hotel","5","5","46","73","3","6","49","79","2.1428571428571"
"8","2018","31","Hotel","13","27","59","59","0","0","59","59","4.2"
"8","2018","31","Hotel","2","27","212","285","0","0","212","285","3.6"
"8","2018","31","Hotel","8","3","40","40","29","29","69","69","4.1111111111111"
"8","2018","31","Otros","11","36","43","61","0","0","43","61","5.1904761904762"
"8","2018","31","Otros","9","30","50","110","0","0","50","110","2.3333333333333"
"8","2018","31","Otros","16","19","8","9","0","0","8","9","10.263157894737"
"8","2018","31","Hotel","14","31","117","174","287","930","404","1104","17.4"
"8","2018","31","Hotel","2","1","251","281","8","9","259","290","6.4"
"8","2018","31","Hotel","16","40","856","1522","365","437","1221","1959","5.6666666666667"
"8","2018","31","Otros","7","17","200","357","0","0","200","357","17.166666666667"
"8","2018","31","Hotel","13","27","220","244","120","133","340","377","2.75"
"8","2018","31","Hotel","14","31","158","174","199","399","357","573","24"
"8","2018","31","Otros","3","4","39","119","15","23","54","142","12.2"
"8","2018","31","Otros","8","34","177","241","48","90","225","331","5.75"
"8","2018","31","Hotel","9","22","69","89","0","0","69","89","2.5555555555556"
"8","2018","31","Hotel","4","21","37","59","0","0","37","59","3"
"8","2018","31","Hotel","6","27","126","174","0","0","126","174","3"
"8","2018","31","Hotel","12","35","201","317","132","307","333","624","1.7272727272727"
"8","2018","31","Hotel","2","29","41","93","41","90","82","183","2"
"8","2018","31","Otros","10","11","50","55","0","0","50","55","11.764705882353"
"8","2018","31","Hotel","6","10","29","66","0","0","29","66","6.6"
"8","2018","31","Hotel","13","14","55","88","1","1","56","89","2"
"8","2018","8","Otros","16","27","80","109","0","0","80","109","13.818181818182"
"8","2018","31","Otros","6","27","17","19","0","0","17","19","3.960088691796"
"8","2018","31","Hotel","16","40","350","661","61","132","411","793","5.6666666666667"
"8","2018","31","Otros","6","10","126","190","16","20","142","210","3.8518518518518"
"8","2018","31","Otros","10","23","54","102","5","5","59","107","7"
"8","2018","31","Hotel","6","28","221","257","2","2","223","259","1"
"8","2018","31","Otros","7","38","369","728","53","109","422","837","2.75"
"8","2018","31","Hotel","6","12","197","317","0","0","197","317","5"
"8","2018","31","Hotel","13","27","188","272","4","6","192","278","4.2"
"8","2018","31","Otros","4","21","9","18","0","0","9","18","4.8333333333333"
"8","2018","31","Hotel","16","27","67","202","0","0","67","202","5.8571428571429"
"8","2018","31","Hotel","5","5","48","88","0","0","48","88","2.1428571428571"
"8","2018","31","Otros","12","24","73","219","14","16","87","235","9.2"
"8","2018","31","Otros","15","16","77","156","12","22","89","178","9"
"8","2018","31","Hotel","8","27","127","127","2","2","129","129","4.5"
"8","2018","31","Hotel","9","22","17","39","0","0","17","39","2.5555555555556"
"8","2018","31","Hotel","10","11","146","225","7","13","153","238","5.6666666666667"
"8","2018","31","Hotel","8","3","38","67","14","16","52","83","4.1111111111111"
"8","2018","31","Hotel","6","10","294","494","0","0","294","494","6.6"
"8","2018","31","Otros","9","26","106","426","4","4","110","430","3.8888888888889"
"8","2018","31","Hotel","4","39","67","122","17","124","84","246","2.6"
"8","2018","31","Otros","6","27","1","1","0","0","1","1","3.960088691796"
"8","2018","31","Otros","6","12","145","203","0","0","145","203","1.8256578947368"
"8","2018","31","Hotel","6","27","96","201","0","0","96","201","3"
"8","2018","31","Otros","5","9","51","61","1","3","52","64","4.0454545454545"
"8","2018","31","Hotel","2","27","128","128","10","10","138","138","3.6"
"8","2018","31","Hotel","2","29","46","138","182","546","228","684","1"
"8","2018","31","Hotel","4","13","216","576","0","0","216","576","5.4"
"8","2018","31","","11","15","15","224","0","0","15","224","1"
"8","2018","31","Hotel","6","10","528","576","16","22","544","598","6.6"
"8","2018","31","Otros","6","12","1","1","0","0","1","1","1.8256578947368"
"8","2018","31","Otros","10","18","39","43","2","2","41","45","10.25"
"8","2018","31","Otros","9","22","156","214","0","0","156","214","7.6428571428571"
"8","2018","31","","14","27","189","413","26","72","215","485","1"
"8","2018","31","Hotel","16","27","74","143","4","35","78","178","5.8571428571429"
"8","2018","31","Otros","2","29","5","17","6","12","11","29","3.28"
"8","2018","31","Otros","13","33","27","34","0","0","27","34","5.125"
"8","2018","31","Otros","13","33","19","22","5","5","24","27","5.125"
"8","2018","31","Otros","6","10","63","243","0","0","63","243","3.8518518518518"
"8","2018","31","Hotel","10","18","40","73","8","12","48","85","7.75"
"8","2018","31","Hotel","14","31","157","293","33","130","190","423","24"
"8","2018","31","Hotel","4","21","63","63","0","0","63","63","3"
"8","2018","31","Hotel","3","4","4","12","0","0","4","12","2.6"
"8","2018","31","Otros","8","27","0","0","0","0","0","0","1"
"8","2018","31","Otros","6","27","10","18","0","0","10","18","3.960088691796"
"8","2018","31","Hotel","6","25","165","342","0","0","165","342","1"
"8","2018","31","Otros","6","12","118","305","0","0","118","305","1.8256578947368"
"8","2018","31","Hotel","6","27","22","25","0","0","22","25","3"
"8","2018","31","Otros","6","27","16","61","0","0","16","61","3.960088691796"
"8","2018","31","Otros","6","10","66","88","0","0","66","88","3.8518518518518"
"8","2018","31","Otros","6","12","48","226","0","0","48","226","1.8256578947368"
"8","2018","31","Otros","5","5","3","3","2","2","5","5","3.65625"
"8","2018","31","Hotel","12","24","56","258","3","9","59","267","3"
"8","2018","31","Hotel","15","16","56","104","7","9","63","113","7.8"
"8","2018","31","Otros","4","13","63","120","0","0","63","120","3.4"
"8","2018","31","Hotel","2","29","102","316","32","148","134","464","1"
"8","2018","31","Hotel","4","21","10","22","0","0","10","22","3"
"8","2018","31","Hotel","10","27","137","198","159","217","296","415","2.25"
"8","2018","31","Hotel","8","3","149","209","19","28","168","237","4.1111111111111"
"8","2018","31","Hotel","12","27","96","151","27","30","123","181","1"
"8","2018","31","Otros","5","5","39","76","8","16","47","92","3.65625"
"8","2018","31","Otros","13","14","15","19","0","0","15","19","7.3846153846154"
"8","2018","31","Otros","10","11","133","264","0","0","133","264","11.764705882353"
"8","2018","31","Otros","16","40","124","230","0","0","124","230","28.142857142857"
"8","2018","31","Hotel","11","36","269","608","0","0","269","608","1"
"8","2018","31","Otros","8","34","64","86","16","29","80","115","5.75"
"8","2018","31","Hotel","7","17","77","111","0","0","77","111","10"
"8","2018","31","Otros","12","35","158","295","4","6","162","301","3.5"
"8","2018","31","Otros","5","9","7","11","0","0","7","11","4.0454545454545"
"8","2018","31","Hotel","9","22","54","64","0","0","54","64","2.5555555555556"
"8","2018","31","Otros","2","29","32","82","87","156","119","238","3.28"
"8","2018","31","Otros","2","29","138","138","75","75","213","213","3.28"
"8","2018","31","Hotel","10","27","73","104","9","11","82","115","2.25"
"8","2018","31","Hotel","16","19","78","128","7","9","85","137","4"
"8","2018","31","Hotel","16","40","86","211","0","0","86","211","16.333333333333"
"8","2018","31","Hotel","8","27","208","310","10","10","218","320","4.5"
"8","2018","31","Otros","13","14","8","15","0","0","8","15","7.3846153846154"
"8","2018","31","Hotel","7","27","46","65","0","0","46","65","4.1666666666667"
"8","2018","31","Otros","2","6","63","1116","0","0","63","1116","5"
"8","2018","31","Hotel","7","17","251","455","18","69","269","524","10"
"8","2018","31","Hotel","3","4","119","221","38","77","157","298","2.6"
"8","2018","31","Otros","6","12","10","92","0","0","10","92","1.8256578947368"
"8","2018","31","Otros","6","10","12","12","0","0","12","12","3.8518518518518"
"8","2018","31","Hotel","16","40","74","74","10","10","84","84","16.333333333333"
"8","2018","31","Otros","4","39","35","59","0","0","35","59","2.2222222222222"
"8","2018","31","Otros","13","14","6","12","0","0","6","12","7.3846153846154"
"8","2018","31","Otros","7","38","70","123","3","4","73","127","2.75"
"8","2018","31","Hotel","11","32","205","377","0","0","205","377","1"
"8","2018","31","Otros","11","36","141","232","0","0","141","232","5.1904761904762"
"8","2018","31","Hotel","4","21","46","75","1","1","47","76","3"
"8","2018","31","Otros","3","4","11","45","2","4","13","49","12.2"
"8","2018","31","Otros","5","9","68","85","12","12","80","97","4.0454545454545"
"8","2018","31","Hotel","8","27","95","172","1","8","96","180","4.5"
"8","2018","31","","7","17","111","264","0","0","111","264","1"
"8","2018","31","Otros","16","20","9","24","0","0","9","24","3.0769230769231"
"8","2018","31","Otros","4","21","85","102","0","0","85","102","4.8333333333333"
"8","2018","31","Otros","13","33","85","98","9","16","94","114","5.125"
"8","2018","0","","12","35","0","0","0","0","0","0","1"
"8","2018","31","Hotel","13","33","1","1","0","0","1","1","2"
"8","2018","31","Otros","4","39","120","240","0","0","120","240","2.2222222222222"
"8","2018","31","Otros","10","18","17","49","2","3","19","52","10.25"
"8","2018","31","Otros","6","27","100","150","1","1","101","151","3.960088691796"
"8","2018","31","Hotel","4","39","59","176","0","0","59","176","2.6"
"8","2018","31","Otros","14","31","82","245","124","277","206","522","20.2"
"8","2018","31","Hotel","2","29","34","99","138","332","172","431","2"
"8","2018","31","Hotel","9","26","109","213","1","1","110","214","1.5"
"8","2018","31","Otros","12","35","1","1","0","0","1","1","3.5"
"8","2018","31","Hotel","14","27","94","116","24","33","118","149","8.5"
"8","2018","31","Otros","11","36","40","75","0","0","40","75","5.1904761904762"
"8","2018","31","Otros","16","20","132","223","0","0","132","223","3.0769230769231"
"8","2018","31","Otros","4","39","2","3","0","0","2","3","2.2222222222222"
"8","2018","31","Otros","7","27","98","106","2","2","100","108","4.8333333333333"
"8","2018","31","Otros","6","27","42","61","0","0","42","61","3.960088691796"
"8","2018","31","Otros","5","8","10","230","0","0","10","230","5"
"8","2018","31","Otros","9","37","193","251","4","12","197","263","4.5"
"8","2018","31","Hotel","2","6","44","175","0","0","44","175","5.5"
"8","2018","31","Hotel","10","27","87","117","28","31","115","148","2.25"
"8","2018","31","Hotel","9","30","117","175","3","6","120","181","1"
"8","2018","31","Otros","4","13","201","225","0","0","201","225","3.4"
"8","2018","31","Hotel","5","5","313","313","0","0","313","313","1"
"8","2018","31","Otros","7","38","137","245","6","10","143","255","2.75"
"8","2018","31","Hotel","13","14","12","15","0","0","12","15","1"
"8","2018","31","Otros","5","9","111","258","0","0","111","258","4.0454545454545"
"8","2018","31","Otros","5","8","1","1","0","0","1","1","5"
"8","2018","31","Otros","10","27","16","496","0","0","16","496","4.84"
"8","2018","31","Hotel","13","14","14","28","0","0","14","28","1"
"8","2018","31","Otros","11","15","16","26","0","0","16","26","2.3571428571429"
"8","2018","31","Hotel","9","22","216","470","0","0","216","470","2.5555555555556"
"8","2018","31","Otros","11","36","75","147","2","8","77","155","5.1904761904762"
"8","2018","31","Hotel","10","18","1123","2455","685","1644","1808","4099","1"
"8","2018","31","Hotel","6","12","340","394","0","0","340","394","5"
"8","2018","31","","2","29","515","1264","445","1144","960","2408","1"
"8","2018","31","Hotel","16","27","1162","2324","16","32","1178","2356","1"
"8","2018","31","","14","31","344","918","252","1305","596","2223","1"
"8","2018","31","Hotel","8","3","2","2","3","3","5","5","4.1111111111111"
"8","2018","31","Otros","13","33","12","18","0","0","12","18","5.125"
"8","2018","31","","14","27","149","149","0","0","149","149","2.6666666666667"
"8","2018","31","Otros","9","22","62","352","0","0","62","352","7.6428571428571"
"8","2018","31","Hotel","10","11","20","20","0","0","20","20","5.6666666666667"
"8","2018","31","Otros","6","12","17","30","0","0","17","30","1.8256578947368"
"8","2018","31","Hotel","8","3","14","16","0","0","14","16","4.1111111111111"
"8","2018","31","Otros","6","12","151","175","0","0","151","175","1.8256578947368"
"8","2018","31","Hotel","8","27","223","223","0","0","223","223","4.5"
"8","2018","31","Hotel","6","28","229","258","3","9","232","267","2.4"
"8","2018","31","Otros","6","25","28","179","0","0","28","179","2.3846153846154"
"8","2018","31","Otros","6","25","6","10","0","0","6","10","2.3846153846154"
"8","2018","31","Hotel","11","36","834","2356","0","0","834","2356","1"
"8","2018","31","Otros","2","6","24","67","128","367","152","434","5"
"8","2018","31","Hotel","14","31","60","98","100","289","160","387","24"
"8","2018","31","Otros","4","21","12","24","0","0","12","24","4.8333333333333"
"8","2018","31","Otros","7","38","17","28","0","0","17","28","2.75"
"8","2018","31","Otros","13","14","13","13","0","0","13","13","7.3846153846154"
"8","2018","31","Otros","2","29","15","36","18","30","33","66","3.28"
"8","2018","31","Otros","3","4","85","105","38","38","123","143","12.2"
"8","2018","31","Hotel","3","4","402","811","36","57","438","868","3"
"8","2018","31","Otros","7","27","89","605","0","0","89","605","1"
"8","2018","31","Otros","7","17","176","185","0","0","176","185","3"
"8","2018","31","Hotel","12","27","283","491","60","123","343","614","1"
"8","2018","31","Otros","5","5","12","15","0","0","12","15","3.65625"
"8","2018","31","Hotel","6","10","210","335","0","0","210","335","6.6"
"8","2018","31","Otros","10","18","2","6","6","24","8","30","10.25"
"8","2018","31","Otros","8","27","51","89","0","0","51","89","9.4"
"8","2018","31","Otros","8","3","12","16","0","0","12","16","10"
"8","2018","31","Hotel","16","27","52","90","0","0","52","90","5.8571428571429"
"8","2018","31","Otros","6","10","24","60","0","0","24","60","3.8518518518518"
"8","2018","31","Hotel","2","6","33","42","5","5","38","47","5.5"
"8","2018","31","Hotel","8","3","1","1","0","0","1","1","4.1111111111111"
"8","2018","31","Otros","10","11","21","29","3","4","24","33","11.764705882353"
"8","2018","31","Otros","6","27","70","85","0","0","70","85","3.960088691796"
"8","2018","31","Otros","15","16","1","1","0","0","1","1","9"
"8","2018","31","Otros","5","5","12","14","5","10","17","24","3.65625"
"8","2018","31","Otros","10","27","118","209","7","7","125","216","4.84"
"8","2018","31","Hotel","7","38","65","169","4","4","69","173","1"
"8","2018","31","Hotel","13","27","5","85","0","0","5","85","4.2"
"8","2018","31","Hotel","16","20","56","90","0","0","56","90","1"
"8","2018","31","Otros","10","27","58","88","45","52","103","140","4.84"
"8","2018","31","Hotel","3","7","65","72","65","118","130","190","1"
"8","2018","31","Otros","2","29","78","97","22","50","100","147","3.28"
"8","2018","31","Otros","10","18","2","4","0","0","2","4","10.25"
"8","2018","31","Otros","9","22","96","179","0","0","96","179","7.6428571428571"
"8","2018","31","Otros","15","27","60","60","0","0","60","60","1.4222222222222"
"8","2018","31","Otros","11","36","5","15","0","0","5","15","5.1904761904762"
"8","2018","31","Otros","5","5","17","29","1","1","18","30","3.65625"
"8","2018","31","Otros","2","29","9","28","11","36","20","64","3.28"
"8","2018","31","Hotel","9","22","162","162","2","2","164","164","2.5555555555556"
"8","2018","31","Otros","11","32","15","30","0","0","15","30","2.2857142857143"
"8","2018","31","Hotel","10","27","248","411","32","48","280","459","1"
"8","2018","31","Otros","16","27","42","78","0","0","42","78","2"
"8","2018","31","Hotel","16","20","13","26","0","0","13","26","1"
"8","2018","31","Otros","11","15","16","54","4","11","20","65","2.3571428571429"
"8","2018","31","Otros","7","17","135","675","0","0","135","675","3"
"8","2018","31","Otros","5","8","8","8","0","0","8","8","5"
"8","2018","31","Hotel","13","33","82","132","0","0","82","132","2"
"8","2018","31","Otros","5","9","34","53","5","5","39","58","4.0454545454545"
"8","2018","31","Otros","10","27","94","112","3","3","97","115","4.84"
"8","2018","31","Otros","9","22","35","46","2","2","37","48","7.6428571428571"
"8","2018","31","Otros","16","40","90","162","0","0","90","162","28.142857142857"
"8","2018","31","Hotel","16","40","56","68","4","4","60","72","1"
"8","2018","31","Otros","15","16","17","51","9","18","26","69","9"
"8","2018","31","Hotel","8","2","15","18","12","12","27","30","3"
"8","2018","31","Otros","8","3","41","45","0","0","41","45","10"
"8","2018","31","Otros","7","17","66","75","0","0","66","75","17.166666666667"
"8","2018","31","Otros","16","20","28","42","0","0","28","42","3.0769230769231"
"8","2018","31","Otros","6","27","17","25","0","0","17","25","3.960088691796"
"8","2018","31","Otros","12","35","14","16","13","21","27","37","3.5"
"8","2018","31","Otros","6","28","105","422","4","8","109","430","4.65"
"8","2018","31","Otros","6","28","270","1029","3","6","273","1035","4.65"
"8","2018","31","Hotel","8","34","121","248","38","53","159","301","2.5714285714286"
"8","2018","31","Hotel","16","20","1081","2405","4","13","1085","2418","1"
"8","2018","31","Hotel","2","6","306","996","0","0","306","996","2.2"
"8","2018","31","Hotel","7","27","50","775","0","0","50","775","4.1666666666667"
"8","2018","31","Hotel","10","23","15","15","1","1","16","16","4"
"8","2018","31","Hotel","9","26","41","65","4","4","45","69","1.5"
"8","2018","31","Otros","8","27","6","6","0","0","6","6","9.4"
"8","2018","31","Otros","10","27","7","7","1","1","8","8","4.84"
"8","2018","31","Otros","11","15","9","12","0","0","9","12","2.3571428571429"
"8","2018","31","Otros","16","20","3","3","0","0","3","3","3.0769230769231"
"8","2018","31","Otros","11","32","51","80","0","0","51","80","1"
"8","2018","31","Otros","16","27","63","63","2","2","65","65","13.818181818182"
"8","2018","31","Otros","9","37","59","59","0","0","59","59","4.5"
"8","2018","31","Hotel","2","29","4","5","33","62","37","67","2"
"8","2018","31","Hotel","2","1","30","204","5","20","35","224","6.4"
"8","2018","31","Otros","5","8","7","8","0","0","7","8","5"
"8","2018","31","Otros","9","37","39","51","8","11","47","62","4.5"
"8","2018","31","Otros","7","38","112","147","0","0","112","147","2.75"
"8","2018","31","Otros","11","32","9","19","0","0","9","19","1"
"8","2018","31","Otros","4","39","136","149","0","0","136","149","2.2222222222222"
"8","2018","31","Hotel","11","36","45","98","10","20","55","118","2.375"
"8","2018","31","Otros","10","23","19","58","6","24","25","82","7"
"8","2018","31","Hotel","15","16","664","1560","0","0","664","1560","2"
"8","2018","31","Otros","2","29","25","30","30","30","55","60","3.28"
"8","2018","31","Hotel","6","12","1136","1470","47","59","1183","1529","1"
"8","2018","31","Hotel","11","15","24","36","0","0","24","36","1"
"8","2018","31","Otros","4","21","117","146","0","0","117","146","1"
"8","2018","31","Otros","16","19","44","99","0","0","44","99","10.263157894737"
"8","2018","31","","9","37","257","308","1","2","258","310","1"
"8","2018","31","Otros","10","27","27","40","18","24","45","64","4.84"
"8","2018","31","Otros","11","15","68","68","0","0","68","68","2.3571428571429"
"8","2018","31","Hotel","2","29","36","108","58","176","94","284","2"
"8","2018","31","Hotel","10","27","117","175","41","72","158","247","1"
"8","2018","31","Hotel","11","36","56","166","3","3","59","169","2.375"
"8","2018","31","Hotel","9","37","64","81","33","44","97","125","3.4"
"8","2018","31","Otros","14","27","10","20","3","4","13","24","11.833333333333"
"8","2018","31","Otros","7","38","47","76","0","0","47","76","1"
"8","2018","31","Hotel","2","1","10","150","0","0","10","150","6.4"
"8","2018","31","Otros","2","29","6","18","28","98","34","116","3.28"
"8","2018","31","Hotel","6","27","3","3","0","0","3","3","3"
"8","2018","31","Otros","5","9","14","76","0","0","14","76","4.0454545454545"
"8","2018","31","Hotel","2","1","15","30","0","0","15","30","6.4"
"8","2018","31","Hotel","3","7","20","33","84","100","104","133","1"
"8","2018","31","Otros","7","38","27","234","3","3","30","237","2.75"
"8","2018","31","Otros","7","17","19","66","0","0","19","66","17.166666666667"
"8","2018","31","Otros","7","38","12","25","0","0","12","25","2.75"
"8","2018","31","Otros","4","21","8","8","0","0","8","8","4.8333333333333"
"8","2018","31","Otros","2","1","54","54","4","4","58","58","5.5"
"8","2018","31","Otros","12","35","39","45","2","4","41","49","3.5"
"8","2018","31","Otros","12","35","9","13","3","3","12","16","3.5"
"8","2018","31","Otros","4","21","54","68","4","4","58","72","4.8333333333333"
"8","2018","31","Otros","12","24","5","10","0","0","5","10","9.2"
"8","2018","31","Otros","16","19","1","1","0","0","1","1","10.263157894737"
"8","2018","31","Otros","10","11","40","48","0","0","40","48","11.764705882353"
"8","2018","31","Otros","16","19","46","50","0","0","46","50","10.263157894737"
"8","2018","31","Hotel","2","27","65","202","0","0","65","202","1"
"8","2018","31","Otros","6","28","17","17","0","0","17","17","4.65"
"8","2018","31","Otros","10","18","146","372","18","52","164","424","10.25"
"8","2018","31","Otros","14","27","51","145","0","0","51","145","11.833333333333"
"8","2018","31","Hotel","11","32","11","29","0","0","11","29","1"
"8","2018","31","Otros","8","27","17","41","0","0","17","41","9.4"
"8","2018","31","Hotel","12","35","19","27","5","11","24","38","1.7272727272727"
"8","2018","31","Otros","13","14","16","16","0","0","16","16","7.3846153846154"
"8","2018","31","Otros","11","36","21","54","0","0","21","54","5.1904761904762"
"8","2018","31","Otros","16","20","23","25","2","2","25","27","3.0769230769231"
"8","2018","31","Hotel","14","31","249","336","1356","1734","1605","2070","7.8"
"8","2018","31","Otros","2","27","121","177","24","74","145","251","3.2"
"8","2018","31","","16","40","177","364","0","0","177","364","3.0555555555556"
"8","2018","31","Hotel","11","36","82","144","3","9","85","153","2.375"
"8","2018","31","Hotel","9","22","24","30","0","0","24","30","2.5555555555556"
"8","2018","31","Otros","2","29","4","10","8","25","12","35","3.28"
"8","2018","31","Hotel","10","27","47","60","13","16","60","76","2.25"
"8","2018","31","Otros","10","27","24","63","0","0","24","63","4.84"
"8","2018","7","Hotel","16","19","4","8","0","0","4","8","4"
"8","2018","28","Otros","2","6","13","54","0","0","13","54","5"
"8","2018","31","Otros","7","27","91","169","0","0","91","169","4.8333333333333"
"8","2018","31","Hotel","2","6","106","820","0","0","106","820","5.5"
"8","2018","31","Hotel","6","28","2","2","3","3","5","5","2.4"
"8","2018","31","Otros","6","10","163","356","8","32","171","388","3.8518518518518"
"8","2018","31","Hotel","6","27","29","32","2","2","31","34","3"
"8","2018","31","Otros","5","5","17","29","1","1","18","30","3.65625"
"8","2018","31","Otros","12","24","52","79","13","17","65","96","9.2"
"8","2018","31","Hotel","8","2","42","75","17","64","59","139","3"
"8","2018","31","Hotel","11","32","17","59","2","7","19","66","1"
"8","2018","31","Otros","10","18","7","13","14","31","21","44","10.25"
"8","2018","31","Hotel","9","37","17","18","0","0","17","18","3.4"
"8","2018","31","Otros","5","9","13","21","1","1","14","22","4.0454545454545"
"8","2018","31","Otros","12","24","4","5","0","0","4","5","9.2"
"8","2018","31","Otros","9","22","1","1","0","0","1","1","7.6428571428571"
"8","2018","31","Otros","2","29","15","45","18","46","33","91","3.28"
"8","2018","31","Otros","10","23","4","48","2","8","6","56","7"
"8","2018","31","Otros","10","27","4","48","2","8","6","56","4.84"
"8","2018","31","Otros","10","11","35","35","0","0","35","35","11.764705882353"
"8","2018","31","Otros","8","3","2","2","0","0","2","2","10"
"8","2018","31","Otros","14","31","107","149","246","407","353","556","20.2"
"8","2018","31","Otros","2","29","170","420","152","424","322","844","3.28"
"8","2018","0","Otros","6","25","0","0","0","0","0","0","1"
"8","2018","31","Hotel","15","16","25","47","0","0","25","47","7.8"
"8","2018","31","Hotel","15","27","117","151","2","2","119","153","1"
"8","2018","31","Otros","10","27","8","146","4","16","12","162","4.84"
"8","2018","31","Otros","10","23","56","56","0","0","56","56","7"
"8","2018","31","Otros","6","27","11","41","0","0","11","41","3.960088691796"
"8","2018","31","Otros","16","40","84","143","1","2","85","145","28.142857142857"
"8","2018","31","Otros","11","36","58","65","4","8","62","73","5.1904761904762"
"8","2018","31","Otros","8","34","50","72","0","0","50","72","5.75"
"8","2018","31","Otros","6","12","27","177","0","0","27","177","1.8256578947368"
"8","2018","31","Otros","6","10","127","269","0","0","127","269","3.8518518518518"
"8","2018","31","Hotel","4","21","86","180","0","0","86","180","3"
"8","2018","31","Hotel","11","36","57","86","3","3","60","89","2.375"
"8","2018","31","Otros","5","8","40","52","6","8","46","60","5"
"8","2018","31","Hotel","7","17","78","114","0","0","78","114","10"
"8","2018","27","Hotel","11","36","239","305","18","24","257","329","1"
"8","2018","31","Otros","9","30","21","45","0","0","21","45","2.3333333333333"
"8","2018","31","Hotel","12","35","62","98","37","68","99","166","1.7272727272727"
"8","2018","31","Otros","2","1","50","173","3","6","53","179","5.5"
"8","2018","31","Hotel","6","25","139","144","2","2","141","146","1"
"8","2018","31","Otros","5","5","4","124","0","0","4","124","3.65625"
"8","2018","31","Otros","2","29","26","52","92","266","118","318","3.28"
"8","2018","31","Hotel","2","6","17","26","5","5","22","31","5.5"
"8","2018","31","Otros","7","17","2","20","0","0","2","20","17.166666666667"
"8","2018","31","Hotel","8","2","2","2","0","0","2","2","3"
"8","2018","31","Hotel","13","14","15","15","0","0","15","15","1"
"8","2018","31","Otros","7","38","27","43","4","4","31","47","2.75"
"8","2018","31","Hotel","14","31","13","35","82","267","95","302","24"
"8","2018","31","Hotel","5","5","6","13","6","10","12","23","2.1428571428571"
"8","2018","31","Otros","2","27","2","4","5","5","7","9","3.2"
"8","2018","31","Otros","5","8","15","19","10","10","25","29","5"
"8","2018","31","Otros","3","4","21","370","0","0","21","370","12.2"
"8","2018","31","Otros","13","14","7","7","0","0","7","7","7.3846153846154"
"8","2018","31","Otros","9","37","19","44","0","0","19","44","4.5"
"8","2018","31","Hotel","10","23","494","670","5","8","499","678","1"
"8","2018","31","Otros","11","32","6","6","0","0","6","6","2.2857142857143"
"8","2018","31","Otros","11","15","4","8","0","0","4","8","2.3571428571429"
"8","2018","31","Otros","8","3","11","12","0","0","11","12","10"
"8","2018","31","Otros","16","20","25","42","0","0","25","42","3.0769230769231"
"8","2018","31","Otros","8","3","9","22","0","0","9","22","10"
"8","2018","31","Otros","16","27","7","9","0","0","7","9","2"
"8","2018","31","Hotel","16","19","13","18","0","0","13","18","4"
"8","2018","31","Hotel","16","27","33","66","0","0","33","66","5.8571428571429"
"8","2018","31","Otros","9","26","32","80","2","2","34","82","3.8888888888889"
"8","2018","31","Otros","5","5","7","7","3","3","10","10","3.65625"
"8","2018","31","Otros","14","27","18","23","0","0","18","23","11.833333333333"
"8","2018","31","Hotel","5","5","1","1","0","0","1","1","2.1428571428571"
"8","2018","31","Hotel","12","24","104","277","19","33","123","310","3"
"8","2018","31","Otros","16","27","4","6","0","0","4","6","13.818181818182"
"8","2018","31","Hotel","14","31","14","19","238","668","252","687","1"
"8","2018","31","Otros","8","3","0","0","4","8","4","8","1"
"8","2018","31","Otros","13","27","112","206","0","0","112","206","12.2"
"8","2018","31","Hotel","16","40","12","16","9","24","21","40","16.333333333333"
"8","2018","31","Otros","11","36","37","191","0","0","37","191","1"
"8","2018","31","Otros","10","27","16","55","5","5","21","60","4.84"
"8","2018","31","Otros","9","22","29","37","0","0","29","37","7.6428571428571"
"8","2018","31","Hotel","5","5","30","92","4","24","34","116","2.1428571428571"
"8","2018","31","Otros","2","29","80","182","72","170","152","352","3.28"
"8","2018","31","Otros","2","29","1","1","4","10","5","11","3.28"
"8","2018","31","Hotel","13","14","2","2","0","0","2","2","1"
"8","2018","31","Otros","6","25","2","3","0","0","2","3","2.3846153846154"
"8","2018","31","Otros","2","1","18","18","1","1","19","19","5.5"
"8","2018","6","Hotel","12","27","14","70","4","20","18","90","1"
"8","2018","31","Hotel","13","27","7","7","0","0","7","7","4.2"
"8","2018","31","Otros","6","12","71","258","0","0","71","258","1.8256578947368"
"8","2018","31","Otros","6","27","18","25","25","169","43","194","3.960088691796"
"8","2018","31","Otros","6","25","6","7","0","0","6","7","2.3846153846154"
"8","2018","31","Hotel","6","28","19","53","0","0","19","53","2.5833333333333"
"8","2018","31","Otros","5","5","17","29","1","1","18","30","3.65625"
"8","2018","31","Otros","5","9","11","11","0","0","11","11","4.0454545454545"
"8","2018","31","Otros","5","8","7","10","0","0","7","10","5"
"8","2018","31","Hotel","2","29","85","249","59","235","144","484","1"
"8","2018","31","Otros","5","5","62","98","4","8","66","106","3.65625"
"8","2018","31","Hotel","9","26","13","13","0","0","13","13","1.5"
"8","2018","31","Otros","9","30","15","25","0","0","15","25","2.3333333333333"
"8","2018","31","Otros","11","15","3","7","0","0","3","7","2.3571428571429"
"8","2018","31","Hotel","16","27","8","10","0","0","8","10","5.8571428571429"
"8","2018","31","Otros","9","30","38","70","0","0","38","70","2.3333333333333"
"8","2018","31","Otros","2","29","16","56","12","52","28","108","3.28"
"8","2018","31","Otros","7","38","34","61","13","23","47","84","2.75"
"8","2018","31","Otros","4","21","29","72","4","8","33","80","4.8333333333333"
"8","2018","31","Otros","9","22","13","15","0","0","13","15","7.6428571428571"
"8","2018","31","Otros","9","22","31","45","0","0","31","45","7.6428571428571"
"8","2018","1","Otros","13","27","2","2","0","0","2","2","12.2"
"8","2018","31","Hotel","11","36","1381","1425","29","111","1410","1536","1"
"8","2018","31","Otros","13","33","5","6","0","0","5","6","5.125"
"8","2018","31","Otros","11","36","32","81","27","62","59","143","5.1904761904762"
"8","2018","31","Otros","12","35","1","2","0","0","1","2","3.5"
"8","2018","31","Otros","12","35","9","13","3","3","12","16","3.5"
"8","2018","31","Otros","10","11","13","17","4","4","17","21","11.764705882353"
"8","2018","31","Otros","12","24","14","32","5","5","19","37","9.2"
"8","2018","31","Otros","16","20","17","52","0","0","17","52","3.0769230769231"
"8","2018","31","Hotel","7","27","110","151","2","2","112","153","1"
"8","2018","31","Otros","6","12","13","15","0","0","13","15","1.8256578947368"
"8","2018","31","Otros","11","32","20","44","5","12","25","56","2.2857142857143"
"8","2018","31","Otros","6","28","27","39","0","0","27","39","4.65"
"8","2018","31","Otros","8","34","1","1","0","0","1","1","5.75"
"8","2018","31","Otros","16","27","15","28","9","32","24","60","13.818181818182"
"8","2018","31","Otros","10","11","1","1","0","0","1","1","11.764705882353"
"8","2018","31","Otros","6","10","23","62","4","10","27","72","3.8518518518518"
"8","2018","31","Otros","8","3","34","95","1","2","35","97","10"
"8","2018","31","Hotel","16","20","97","155","8","12","105","167","1"
"8","2018","31","Hotel","11","32","29","82","3","3","32","85","1"
"8","2018","31","Otros","8","27","26","159","0","0","26","159","9.4"
"8","2018","31","Otros","12","27","19","106","21","34","40","140","3.4285714285714"
"8","2018","31","Otros","6","10","81","146","4","16","85","162","3.8518518518518"
"8","2018","31","Otros","6","10","11","115","0","0","11","115","3.8518518518518"
"8","2018","31","Otros","5","8","14","14","2","2","16","16","5"
"8","2018","31","Otros","5","8","1","1","0","0","1","1","5"
"8","2018","31","Hotel","9","26","23","24","2","2","25","26","1.5"
"8","2018","31","Hotel","13","14","11","33","0","0","11","33","1"
"8","2018","31","Otros","10","18","49","102","17","78","66","180","10.25"
"8","2018","31","Otros","8","2","36","37","15","16","51","53","6.4285714285714"
"8","2018","31","Otros","7","27","2","2","0","0","2","2","4.8333333333333"
"8","2018","31","Otros","2","29","40","100","13","42","53","142","3.28"
"8","2018","20","Otros","11","32","13","21","1","1","14","22","2.2857142857143"
"8","2018","31","Otros","9","30","9","9","0","0","9","9","2.3333333333333"
"8","2018","31","Otros","2","29","7","21","6","24","13","45","3.28"
"8","2018","31","Otros","5","5","6","21","0","0","6","21","3.65625"
"8","2018","31","Otros","11","15","8","12","0","0","8","12","2.3571428571429"
"8","2018","31","Otros","10","23","7","7","0","0","7","7","7"
"8","2018","31","Otros","11","36","78","140","12","14","90","154","5.1904761904762"
"8","2018","31","Hotel","3","7","43","110","60","94","103","204","1"
"8","2018","31","Otros","10","27","1","2","0","0","1","2","4.84"
"8","2018","31","Otros","2","27","3","3","0","0","3","3","3.2"
"8","2018","31","Otros","12","35","0","0","8","8","8","8","3.5"
"8","2018","31","Otros","10","27","41","83","0","0","41","83","4.84"
"8","2018","31","Otros","16","40","28","58","133","370","161","428","28.142857142857"
"8","2018","31","Hotel","8","3","270","393","107","184","377","577","4.1111111111111"
"8","2018","31","Otros","9","22","41","43","0","0","41","43","7.6428571428571"
"8","2018","31","Otros","13","14","42","84","0","0","42","84","7.3846153846154"
"8","2018","31","Otros","5","9","6","12","0","0","6","12","4.0454545454545"
"8","2018","31","Otros","10","18","54","73","0","0","54","73","10.25"
"8","2018","31","Otros","6","25","194","288","0","0","194","288","2.3846153846154"
"8","2018","31","Otros","9","22","18","30","0","0","18","30","7.6428571428571"
"8","2018","31","Otros","10","27","25","121","0","0","25","121","4.84"
"8","2018","31","Otros","16","20","8","19","0","0","8","19","3.0769230769231"
"8","2018","31","Hotel","7","17","136","234","0","0","136","234","10"
"8","2018","31","Otros","15","27","30","30","0","0","30","30","1.4222222222222"
"8","2018","31","Otros","12","35","0","0","1","1","1","1","3.5"
"8","2018","31","Otros","12","35","2","4","9","28","11","32","3.5"
"8","2018","31","Otros","3","7","16","41","0","0","16","41","2"
"8","2018","31","Otros","10","11","4","6","0","0","4","6","11.764705882353"
"8","2018","31","Otros","12","24","4","4","0","0","4","4","9.2"
"8","2018","31","Otros","10","23","18","49","0","0","18","49","7"
"8","2018","31","Otros","7","27","8","20","0","0","8","20","4.8333333333333"
"8","2018","31","","10","18","10","10","0","0","10","10","1"
"8","2018","31","Otros","16","27","0","0","9","9","9","9","13.818181818182"
"8","2018","31","Hotel","2","29","2","6","12","38","14","44","1"
"8","2018","31","Otros","14","27","31","62","0","0","31","62","11.833333333333"
"8","2018","31","Otros","11","32","88","107","0","0","88","107","2.2857142857143"
"8","2018","31","Otros","16","19","24","46","0","0","24","46","1"
"8","2018","31","Otros","16","27","12","14","0","0","12","14","13.818181818182"
"8","2018","31","Otros","8","3","8","16","10","20","18","36","10"
"8","2018","31","Otros","16","27","32","32","0","0","32","32","13.818181818182"
"8","2018","31","Otros","16","20","36","53","0","0","36","53","3.0769230769231"
"8","2018","31","Otros","16","40","126","200","19","41","145","241","28.142857142857"
"8","2018","31","Hotel","11","36","58","101","2","2","60","103","2.375"
"8","2018","31","Otros","6","10","28","51","0","0","28","51","3.8518518518518"
"8","2018","31","Otros","7","38","107","320","12","36","119","356","2.75"
"8","2018","31","Otros","13","14","21","53","0","0","21","53","7.3846153846154"
"8","2018","31","Otros","9","30","27","29","2","2","29","31","2.3333333333333"
"8","2018","31","Otros","13","27","16","61","0","0","16","61","12.2"
"8","2018","31","Otros","10","27","44","44","0","0","44","44","4.84"
"8","2018","31","Otros","6","25","19","22","0","0","19","22","2.3846153846154"
"8","2018","31","Otros","9","26","55","532","0","0","55","532","3.8888888888889"
"8","2018","31","Otros","10","18","8","14","0","0","8","14","10.25"
"8","2018","31","Otros","2","29","45","117","20","57","65","174","3.28"
"8","2018","31","Otros","6","25","2","6","0","0","2","6","2.3846153846154"
"8","2018","31","Otros","5","9","9","123","1","1","10","124","4.0454545454545"
"8","2018","31","Otros","5","9","13","21","1","1","14","22","4.0454545454545"
"8","2018","31","Hotel","9","37","27","64","0","0","27","64","3.4"
"8","2018","31","Hotel","7","38","40","72","16","33","56","105","1"
"8","2018","31","Otros","7","27","81","90","0","0","81","90","4.8333333333333"
"8","2018","31","Otros","5","9","13","21","1","1","14","22","4.0454545454545"
"8","2018","31","Otros","10","27","2","2","0","0","2","2","4.84"
"8","2018","31","Otros","7","27","60","566","0","0","60","566","4.8333333333333"
"8","2018","31","Otros","16","40","43","56","7","20","50","76","28.142857142857"
"8","2018","31","Otros","10","23","33","33","0","0","33","33","7"
"8","2018","31","Otros","15","16","58","207","5","5","63","212","9"
"8","2018","31","Otros","3","7","2","6","82","190","84","196","2"
"8","2018","31","Otros","7","17","29","64","0","0","29","64","17.166666666667"
"8","2018","31","Otros","8","27","29","119","0","0","29","119","9.4"
"8","2018","31","Otros","9","22","57","99","0","0","57","99","7.6428571428571"
"8","2018","31","Otros","16","19","11","11","0","0","11","11","10.263157894737"
"8","2018","0","","15","27","0","0","0","0","0","0","1"
"8","2018","31","Hotel","10","11","13","13","3","3","16","16","5.6666666666667"
"8","2018","31","Otros","2","27","6","101","9","9","15","110","3.2"
"8","2018","31","Otros","8","2","61","88","23","50","84","138","6.4285714285714"
"8","2018","31","Otros","5","5","17","29","1","1","18","30","3.65625"
"8","2018","31","Otros","12","35","1","1","0","0","1","1","3.5"
"8","2018","31","Otros","8","3","2","6","4","20","6","26","10"
"8","2018","31","Otros","12","24","29","56","17","21","46","77","9.2"
"8","2018","31","Otros","11","32","20","143","0","0","20","143","2.2857142857143"
"8","2018","31","Otros","10","27","41","58","17","35","58","93","4.84"
"8","2018","31","Otros","11","15","29","67","0","0","29","67","2.3571428571429"
"8","2018","31","Otros","5","8","1","1","0","0","1","1","5"
"8","2018","31","Otros","14","27","13","13","3","3","16","16","11.833333333333"
"8","2018","31","Otros","13","27","49","78","0","0","49","78","12.2"
"8","2018","31","Hotel","10","18","35","35","77","78","112","113","3.2"
"8","2018","31","Otros","10","27","5","7","0","0","5","7","4.84"
"8","2018","31","Otros","11","32","23","32","0","0","23","32","1"
"8","2018","31","Otros","9","37","22","62","0","0","22","62","4.5"
"8","2018","31","Otros","12","35","10","10","36","36","46","46","3.5"
"8","2018","31","Otros","8","34","216","326","55","87","271","413","5.75"
"8","2018","31","Hotel","16","40","16","21","40","67","56","88","16.333333333333"
"8","2018","31","Hotel","10","11","40","302","0","0","40","302","5.6666666666667"
"8","2018","31","Otros","7","27","9","21","0","0","9","21","4.8333333333333"
"8","2018","31","Hotel","7","38","3","4","0","0","3","4","1"
"8","2018","31","Otros","6","27","2","3","0","0","2","3","3.960088691796"
"8","2018","31","Otros","6","10","37","93","0","0","37","93","3.8518518518518"
"8","2018","31","Otros","6","25","71","116","0","0","71","116","1"
"8","2018","31","Otros","6","25","6","7","0","0","6","7","2.3846153846154"
"8","2018","31","Otros","6","27","12","170","0","0","12","170","3.960088691796"
"8","2018","31","Otros","6","27","68","168","0","0","68","168","3.960088691796"
"8","2018","31","Otros","5","5","18","23","5","10","23","33","3.65625"
"8","2018","31","Otros","5","5","3","3","0","0","3","3","3.65625"
"8","2018","31","Otros","3","4","17","36","2","2","19","38","12.2"
"8","2018","31","Otros","10","23","2","2","0","0","2","2","7"
"8","2018","31","Otros","8","3","10","10","0","0","10","10","10"
"8","2018","31","Otros","5","5","13","32","3","3","16","35","3.65625"
"8","2018","31","Otros","5","8","3","3","0","0","3","3","5"
"8","2018","31","Otros","6","10","32","54","2","2","34","56","3.8518518518518"
"8","2018","31","Otros","16","19","14","30","0","0","14","30","10.263157894737"
"8","2018","31","Otros","11","15","22","57","0","0","22","57","2.3571428571429"
"8","2018","31","Otros","7","38","15","24","0","0","15","24","2.75"
"8","2018","31","Otros","11","32","74","121","3","3","77","124","2.2857142857143"
"8","2018","31","Otros","8","2","44","76","0","0","44","76","6.4285714285714"
"8","2018","31","Otros","10","27","24","27","1","2","25","29","4.84"
"8","2018","31","Otros","6","27","4","6","0","0","4","6","3.960088691796"
"8","2018","31","Otros","11","32","32","62","1","1","33","63","2.2857142857143"
"8","2018","31","Otros","8","34","14","19","6","6","20","25","5.75"
"8","2018","31","Otros","11","32","12","18","0","0","12","18","2.2857142857143"
"8","2018","31","Otros","10","11","6","39","0","0","6","39","11.764705882353"
"8","2018","31","Otros","11","32","6","10","0","0","6","10","2.2857142857143"
"8","2018","31","Otros","14","31","6","6","7","10","13","16","20.2"
"8","2018","31","Hotel","14","31","169","294","493","2292","662","2586","17.4"
"8","2018","31","Otros","11","36","185","515","8","32","193","547","5.1904761904762"
"8","2018","31","Hotel","15","16","1107","2322","225","476","1332","2798","2"
"8","2018","31","Otros","15","27","14","18","1","4","15","22","1.4222222222222"
"8","2018","31","Otros","5","5","4","7","0","0","4","7","3.65625"
"8","2018","31","Otros","8","34","8","12","2","2","10","14","5.75"
"8","2018","31","Otros","7","27","4","6","0","0","4","6","4.8333333333333"
"8","2018","31","Otros","12","35","9","13","3","3","12","16","3.5"
"8","2018","31","Otros","5","5","43","82","0","0","43","82","3.65625"
"8","2018","31","Otros","10","11","1","1","0","0","1","1","11.764705882353"
"8","2018","31","Otros","10","11","1","1","0","0","1","1","11.764705882353"
"8","2018","31","Otros","9","30","7","155","0","0","7","155","2.3333333333333"
"8","2018","31","Otros","8","2","46","61","0","0","46","61","6.4285714285714"
"8","2018","31","Otros","10","27","67","142","4","4","71","146","4.84"
"8","2018","31","Otros","5","9","13","21","1","1","14","22","4.0454545454545"
"8","2018","31","Otros","6","27","10","15","0","0","10","15","3.960088691796"
"8","2018","31","Otros","6","10","72","123","39","144","111","267","3.8518518518518"
"8","2018","30","Otros","6","10","8","14","0","0","8","14","3.8518518518518"
"8","2018","31","Otros","6","27","21","21","0","0","21","21","3.960088691796"
"8","2018","31","Otros","6","12","4","34","0","0","4","34","1.8256578947368"
"8","2018","31","Otros","6","10","27","104","0","0","27","104","3.8518518518518"
"8","2018","3","Otros","6","10","10","15","0","0","10","15","3.8518518518518"
"8","2018","31","Otros","6","27","3","4","0","0","3","4","3.960088691796"
"8","2018","31","Otros","6","12","57","78","0","0","57","78","1.8256578947368"
"8","2018","31","Otros","6","10","18","23","0","0","18","23","3.8518518518518"
"8","2018","31","Hotel","6","25","30","40","0","0","30","40","1"
"8","2018","31","Otros","6","27","1","1","0","0","1","1","3.960088691796"
"8","2018","31","Otros","5","9","21","28","2","2","23","30","4.0454545454545"
"8","2018","31","Otros","5","5","13","34","1","1","14","35","3.65625"
"8","2018","31","Otros","5","5","11","11","6","6","17","17","3.65625"
"8","2018","31","Otros","5","5","30","39","0","0","30","39","3.65625"
"8","2018","31","Otros","11","36","49","80","0","0","49","80","5.1904761904762"
"8","2018","31","Hotel","6","10","674","1796","348","1702","1022","3498","1"
"8","2018","31","Otros","5","9","13","21","1","1","14","22","4.0454545454545"
"8","2018","31","Otros","5","8","9","11","0","0","9","11","5"
"8","2018","0","Hotel","15","27","0","0","0","0","0","0","1"
"8","2018","31","Hotel","14","31","3","48","166","2478","169","2526","1"
"8","2018","31","Hotel","3","4","210","1343","15","51","225","1394","3"
"8","2018","31","Otros","3","7","24","24","33","33","57","57","1"
"8","2018","31","Otros","7","38","53","69","0","0","53","69","2.75"
"8","2018","31","Hotel","10","27","44","44","18","21","62","65","1"
"8","2018","31","Hotel","12","35","1","1","7","8","8","9","1.7272727272727"
"8","2018","31","Hotel","10","27","7","21","0","0","7","21","2.25"
"8","2018","31","Hotel","7","17","598","1056","34","63","632","1119","4"
"8","2018","31","Hotel","16","19","9","11","1","1","10","12","4"
"8","2018","31","Hotel","2","6","340","726","0","0","340","726","2.2"
"8","2018","31","Otros","5","5","35","82","5","19","40","101","3.65625"
"8","2018","31","Otros","12","24","90","103","27","37","117","140","9.2"
"8","2018","31","Otros","5","8","20","22","0","0","20","22","5"
"8","2018","31","Otros","4","13","112","152","20","20","132","172","1"
"8","2018","31","Otros","10","11","84","84","0","0","84","84","11.764705882353"
"8","2018","31","Otros","12","35","35","57","62","108","97","165","3.5"
"8","2018","31","Otros","10","23","53","54","0","0","53","54","7"
"8","2018","31","Otros","11","36","579","1042","25","60","604","1102","5.1904761904762"
"8","2018","31","Otros","12","35","9","13","3","3","12","16","3.5"
"8","2018","31","Otros","11","36","14","18","0","0","14","18","5.1904761904762"
"8","2018","31","Otros","8","2","68","273","0","0","68","273","6.4285714285714"
"8","2018","31","Otros","9","30","8","15","0","0","8","15","2.3333333333333"
"8","2018","31","Otros","11","36","17","527","0","0","17","527","5.1904761904762"
"8","2018","31","Otros","6","10","4","6","0","0","4","6","3.8518518518518"
"8","2018","31","Otros","10","18","22","31","6","12","28","43","10.25"
"8","2018","31","Otros","7","27","6","10","4","16","10","26","4.8333333333333"
"8","2018","31","Otros","16","20","5","20","0","0","5","20","1"
"8","2018","31","Otros","9","22","4","4","0","0","4","4","7.6428571428571"
"8","2018","31","Otros","5","5","184","376","1","1","185","377","3.65625"
"8","2018","31","Otros","12","35","9","13","3","3","12","16","3.5"
"8","2018","31","Otros","10","11","1","1","0","0","1","1","11.764705882353"
"8","2018","31","Otros","10","11","4","41","0","0","4","41","11.764705882353"
"8","2018","26","Otros","5","9","26","38","6","6","32","44","4.0454545454545"
"8","2018","31","Otros","5","5","8","14","1","1","9","15","3.65625"
"8","2018","31","Otros","12","35","22","35","31","68","53","103","3.5"
"8","2018","31","Otros","7","38","93","200","26","54","119","254","2.75"
"8","2018","31","Hotel","12","35","1","1","0","0","1","1","1.7272727272727"
"8","2018","31","Otros","13","14","13","17","0","0","13","17","1"
"8","2018","31","Otros","5","5","16","18","3","6","19","24","3.65625"
"8","2018","31","Hotel","14","31","47","697","437","6538","484","7235","1"
"8","2018","31","Hotel","14","31","37","551","291","4349","328","4900","1"
"8","2018","31","Hotel","9","26","9","18","0","0","9","18","1.5"
"8","2018","31","Hotel","16","19","10","20","0","0","10","20","1"
"8","2018","31","Otros","16","19","38","47","0","0","38","47","10.263157894737"
"8","2018","31","Otros","9","30","45","77","2","4","47","81","2.3333333333333"
"8","2018","31","Otros","16","19","33","48","0","0","33","48","10.263157894737"
"8","2018","31","Otros","16","19","76","131","0","0","76","131","10.263157894737"
"8","2018","31","Otros","9","26","50","73","0","0","50","73","3.8888888888889"
"8","2018","31","Otros","16","40","1","1","0","0","1","1","28.142857142857"
"8","2018","31","Hotel","16","27","21","61","0","0","21","61","5.8571428571429"
"8","2018","31","Otros","16","19","7","7","0","0","7","7","10.263157894737"
"8","2018","31","Otros","16","19","8","11","0","0","8","11","10.263157894737"
"8","2018","31","","9","30","77","122","2","4","79","126","1"
"8","2018","31","Otros","16","19","12","14","0","0","12","14","10.263157894737"
"8","2018","31","Otros","10","11","1","1","0","0","1","1","11.764705882353"
"8","2018","31","Otros","11","36","20","20","0","0","20","20","5.1904761904762"
"8","2018","31","Otros","16","19","8","11","0","0","8","11","10.263157894737"
"8","2018","31","Otros","16","19","87","114","2","2","89","116","1.3333333333333"
"8","2018","31","Otros","16","19","10","18","0","0","10","18","10.263157894737"
"8","2018","31","Otros","10","18","20","36","14","36","34","72","10.25"
"8","2018","31","Otros","16","19","12","22","0","0","12","22","10.263157894737"
"8","2018","31","Otros","16","19","1","1","0","0","1","1","1.3333333333333"
"8","2018","31","","9","26","448","2176","0","0","448","2176","1"
"8","2018","31","Otros","16","19","6","8","0","0","6","8","10.263157894737"
"8","2018","31","Otros","16","19","34","37","0","0","34","37","10.263157894737"
"8","2018","31","Hotel","8","2","566","1766","236","1025","802","2791","1"
"8","2018","31","Otros","6","10","21","47","0","0","21","47","3.8518518518518"
"8","2018","31","Otros","6","12","27","27","0","0","27","27","1.8256578947368"
"8","2018","31","Hotel","16","19","53","102","33","59","86","161","1"
"8","2018","31","Otros","3","7","44","88","40","80","84","168","2"
"8","2018","31","Hotel","2","6","928","2970","54","198","982","3168","1"
"8","2018","31","Hotel","3","4","363","434","75","120","438","554","2.6"
"8","2018","31","Hotel","16","40","1672","2267","357","699","2029","2966","1"
"8","2018","31","Otros","16","27","46","60","0","0","46","60","13.818181818182"
"8","2018","31","Hotel","6","28","179","372","5","16","184","388","2.4"
"8","2018","31","Hotel","8","34","2249","2875","144","208","2393","3083","1"
"8","2018","31","Otros","9","30","2","50","0","0","2","50","2.3333333333333"
"8","2018","31","Hotel","10","18","223","223","218","218","441","441","1"
"8","2018","31","Hotel","9","30","40","249","16","29","56","278","1"
"8","2018","31","Hotel","15","27","17","19","2","2","19","21","1"
"8","2018","31","Hotel","9","22","62","362","0","0","62","362","2.5555555555556"
"8","2018","31","Hotel","6","10","238","417","11","45","249","462","1"
"8","2018","0","","11","15","0","0","0","0","0","0","1"
"8","2018","31","Otros","6","12","9","11","0","0","9","11","1.8256578947368"
"8","2018","31","Hotel","15","27","30","910","0","0","30","910","1"
"8","2018","31","Otros","15","27","6","6","0","0","6","6","1.4222222222222"
"8","2018","31","Otros","15","27","6","11","0","0","6","11","1.4222222222222"
"8","2018","31","Otros","2","1","12","12","8","8","20","20","1"
"8","2018","31","Otros","12","24","2","33","0","0","2","33","9.2"
"8","2018","31","Otros","5","5","0","0","1","1","1","1","3.65625"
"8","2018","31","Hotel","7","27","175","518","6","6","181","524","1"
"8","2018","31","Otros","16","20","11","11","0","0","11","11","3.0769230769231"
"8","2018","31","","10","11","41","63","3","6","44","69","1"
"8","2018","31","Hotel","16","40","39","112","3","3","42","115","16.333333333333"
"8","2018","31","Otros","12","35","11","17","0","0","11","17","3.5"
"8","2018","31","Hotel","6","27","11","11","0","0","11","11","3"
"8","2018","31","Otros","5","5","9","21","0","0","9","21","3.65625"
"8","2018","31","Hotel","6","27","36","40","0","0","36","40","3"
"8","2018","31","Otros","6","25","15","19","6","24","21","43","2.3846153846154"
"8","2018","0","Hotel","15","27","0","0","0","0","0","0","1"
"8","2018","31","Otros","5","9","7","10","2","2","9","12","4.0454545454545"
"8","2018","28","Hotel","15","27","95","180","6","8","101","188","1"
"8","2018","31","Hotel","5","9","16","20","0","0","16","20","1"
"8","2018","31","Hotel","8","34","50","98","13","32","63","130","2.5714285714286"
"8","2018","0","Hotel","15","27","0","0","0","0","0","0","1"
"8","2018","31","Hotel","6","27","208","341","0","0","208","341","3"
"8","2018","31","Otros","6","27","52","168","0","0","52","168","1"
"8","2018","31","Otros","12","27","1","1","16","16","17","17","3.4285714285714"
"8","2018","31","Hotel","2","27","736","764","399","401","1135","1165","1"
"8","2018","31","Hotel","2","6","257","606","0","0","257","606","1"
"8","2018","31","Otros","2","6","63","63","0","0","63","63","1"
"8","2018","31","Hotel","4","39","149","149","0","0","149","149","1"
"8","2018","31","Hotel","6","10","352","441","21","27","373","468","1"
"8","2018","31","Otros","5","8","1","2","0","0","1","2","5"
"8","2018","0","Hotel","13","33","0","0","0","0","0","0","1"
"8","2018","31","Hotel","13","33","144","288","43","86","187","374","1"
"8","2018","31","Otros","11","32","163","379","16","22","179","401","2.2857142857143"
"8","2018","31","Hotel","9","26","598","1171","165","336","763","1507","1"
"8","2018","31","Hotel","16","20","49","55","2","2","51","57","1"
"8","2018","31","Otros","16","20","12","15","0","0","12","15","3.0769230769231"
"8","2018","31","","16","40","549","829","0","0","549","829","1"
"8","2018","31","Hotel","15","16","1425","2541","106","206","1531","2747","1"
"8","2018","31","Hotel","16","27","0","0","0","0","0","0","1"
"8","2018","31","Hotel","5","9","13","37","1","1","14","38","1"
"8","2018","31","Otros","7","38","23","31","0","0","23","31","2.75"
"8","2018","31","Otros","2","6","212","3055","0","0","212","3055","1"
"8","2018","31","Otros","2","6","150","1302","0","0","150","1302","1"
"8","2018","31","Hotel","15","27","293","1088","13","13","306","1101","1"
"8","2018","31","Otros","7","38","15","17","0","0","15","17","2.75"
"8","2018","31","Otros","2","1","22","38","25","46","47","84","1"
"8","2018","31","Otros","8","3","33","93","1","2","34","95","10"
"8","2018","31","Otros","11","36","26","46","0","0","26","46","5.1904761904762"
"8","2018","31","Otros","16","20","12","19","0","0","12","19","3.0769230769231"
"8","2018","31","Otros","8","3","181","349","2","2","183","351","1"
"8","2018","31","Otros","4","39","56","93","2","2","58","95","2.2222222222222"
"8","2018","31","Otros","5","5","77","174","0","0","77","174","3.65625"
"8","2018","31","Otros","12","27","6","6","5","5","11","11","3.4285714285714"
"8","2018","31","Otros","7","27","19","209","0","0","19","209","1"
"8","2018","31","Hotel","2","6","466","903","12","22","478","925","1"
"8","2018","31","Hotel","14","27","223","399","108","558","331","957","1"
"8","2018","31","Hotel","16","19","439","669","0","0","439","669","1"
"8","2018","31","","2","1","10","80","3","3","13","83","1"
"8","2018","31","Hotel","2","27","60","229","2","16","62","245","1"
"8","2018","31","Otros","16","20","17","17","0","0","17","17","1"
"8","2018","0","Otros","13","14","0","0","0","0","0","0","1"
"8","2018","31","Hotel","11","36","95","130","0","0","95","130","2.375"
"8","2018","31","Otros","13","14","13","156","0","0","13","156","7.3846153846154"
"8","2018","31","Otros","12","27","1","1","0","0","1","1","3.4285714285714"
"8","2018","31","Hotel","2","6","346","385","11","14","357","399","2.2"
"8","2018","31","Otros","2","6","670","2882","0","0","670","2882","1"
"8","2018","31","Otros","10","27","6","85","0","0","6","85","4.84"
"8","2018","31","Otros","12","27","7","11","0","0","7","11","3.4285714285714"
"8","2018","31","Otros","13","14","63","126","0","0","63","126","7.3846153846154"
"8","2018","31","Otros","6","12","130","223","37","62","167","285","1.8256578947368"
"8","2018","31","Otros","2","6","2330","2330","0","0","2330","2330","1"
"8","2018","31","Hotel","12","35","31","33","0","0","31","33","1.7272727272727"
"8","2018","31","Otros","5","5","6","24","1","4","7","28","3.65625"
"8","2018","31","Otros","9","30","0","0","2","62","2","62","2.3333333333333"
"8","2018","0","Hotel","8","2","0","0","0","0","0","0","1"
"8","2018","31","Otros","9","30","8","19","0","0","8","19","2.3333333333333"
"8","2018","31","Hotel","15","27","34","38","0","0","34","38","1"
"8","2018","16","Hotel","3","7","10","10","3","3","13","13","1"
"8","2018","31","Otros","6","12","347","577","0","0","347","577","1.8256578947368"
"8","2018","31","Otros","12","27","21","37","11","21","32","58","3.4285714285714"
"8","2018","31","Otros","2","6","23","66","0","0","23","66","5"
"8","2018","31","Otros","6","27","45","142","0","0","45","142","3.960088691796"
"8","2018","0","Hotel","10","11","0","0","0","0","0","0","1"
"8","2018","31","Otros","2","1","24","92","0","0","24","92","1"
"8","2018","31","Otros","11","36","28","28","1","1","29","29","5.1904761904762"
"8","2018","31","Hotel","11","32","0","0","0","0","0","0","1"
"8","2018","0","Otros","2","27","0","0","0","0","0","0","1"
"8","2018","31","Otros","12","27","0","0","12","24","12","24","3.4285714285714"
"8","2018","31","Hotel","8","2","31","76","7","7","38","83","3"
"8","2018","31","Hotel","16","20","26","26","0","0","26","26","1"
"8","2018","31","Otros","12","35","26","40","18","36","44","76","3.5"
"8","2018","31","Otros","13","14","10","11","0","0","10","11","1"
"8","2018","31","Otros","2","27","5","10","0","0","5","10","3.2"
"8","2018","31","Hotel","6","27","11","11","0","0","11","11","3"
"8","2018","31","Hotel","8","3","20","30","2","2","22","32","4.1111111111111"
"8","2018","31","Hotel","15","27","24","48","15","30","39","78","1"
"8","2018","31","Otros","8","3","33","91","1","2","34","93","10"
"8","2018","0","Hotel","16","20","0","0","0","0","0","0","1"
"8","2018","31","Hotel","6","28","59","101","4","4","63","105","2.4"
"8","2018","31","Otros","2","1","108","308","6","6","114","314","5.5"
"8","2018","31","Hotel","11","36","90","155","44","78","134","233","2.375"
"8","2018","31","Otros","4","13","25","222","0","0","25","222","1"
"8","2018","31","Otros","2","6","209","1463","0","0","209","1463","1"
"8","2018","31","Otros","8","34","120","155","25","66","145","221","5.75"
"8","2018","31","Hotel","11","15","2","2","0","0","2","2","1"
"8","2018","31","Otros","15","27","1","1","0","0","1","1","1.4222222222222"
"8","2018","31","Hotel","13","14","77","102","0","0","77","102","1"
"8","2018","31","Hotel","13","14","282","347","25","33","307","380","1"
"8","2018","0","Hotel","9","30","0","0","0","0","0","0","1"
"8","2018","31","Hotel","4","13","325","523","28","38","353","561","5.4"
"8","2018","31","Otros","6","27","7","16","0","0","7","16","3.960088691796"
"8","2018","0","Hotel","15","27","0","0","0","0","0","0","1"
"8","2018","31","Hotel","2","29","8","23","69","218","77","241","2"
"8","2018","31","Hotel","13","33","37","66","0","0","37","66","2"
"8","2018","31","Hotel","12","35","62","98","37","68","99","166","1.7272727272727"
"8","2018","31","Hotel","13","14","165","341","2","3","167","344","1"
"8","2018","31","Otros","6","25","34","42","0","0","34","42","2.3846153846154"
"8","2018","31","Hotel","8","2","13","16","1","1","14","17","3"
"8","2018","31","Otros","4","39","190","351","0","0","190","351","2.2222222222222"
"8","2018","31","Otros","6","12","123","179","8","8","131","187","1.8256578947368"
"8","2018","31","Otros","13","33","87","125","2","4","89","129","5.125"
"8","2018","31","Hotel","4","13","125","340","0","0","125","340","5.4"
"8","2018","31","Hotel","7","27","147","238","5","15","152","253","4.1666666666667"
"8","2018","31","Hotel","4","13","704","2022","145","2507","849","4529","1"
"8","2018","0","","5","8","0","0","0","0","0","0","1"
"8","2018","31","Otros","8","2","3","6","0","0","3","6","6.4285714285714"
"8","2018","31","Otros","2","6","16","112","0","0","16","112","1"
"8","2018","31","","6","10","110","177","0","0","110","177","1"
"8","2018","31","Hotel","2","29","5","15","4","10","9","25","2"
"8","2018","31","","14","31","163","253","466","1832","629","2085","1"
"8","2018","31","Hotel","16","27","3322","9967","0","0","3322","9967","1"
"8","2018","31","Hotel","12","35","59","97","27","44","86","141","1.7272727272727"
"8","2018","31","","12","35","16","26","57","109","73","135","1"
"8","2018","31","","9","26","103","160","7","12","110","172","1"
"8","2018","31","Otros","11","32","176","239","0","0","176","239","2.2857142857143"
"8","2018","31","Otros","12","24","22","59","16","21","38","80","9.2"
"8","2018","31","Hotel","6","25","71","74","0","0","71","74","1"
"8","2018","31","Otros","11","32","20","53","0","0","20","53","2.2857142857143"
"8","2018","31","Hotel","16","19","41","58","1","1","42","59","4"
"8","2018","31","Otros","13","33","9","13","0","0","9","13","5.125"
"8","2018","31","Otros","16","27","80","144","1","4","81","148","13.818181818182"
"8","2018","31","Otros","6","12","37","120","4","8","41","128","1.8256578947368"
"8","2018","31","Otros","2","29","2","4","0","0","2","4","3.28"
"8","2018","31","Hotel","14","27","352","408","61","95","413","503","1"
"8","2018","31","Otros","2","1","115","1610","0","0","115","1610","1"
"8","2018","31","Otros","11","32","17","17","0","0","17","17","2.2857142857143"
"8","2018","31","Otros","2","27","77","81","0","0","77","81","1"
"8","2018","31","Hotel","2","29","172","450","0","0","172","450","1"
"8","2018","31","Hotel","4","13","57","783","0","0","57","783","3.2"
"8","2018","31","Hotel","4","21","22","38","14","26","36","64","3"
"8","2018","31","Otros","7","27","106","269","9","15","115","284","4.8333333333333"
"8","2018","31","","3","4","41","73","9","12","50","85","1"
"8","2018","31","Hotel","6","27","5","5","0","0","5","5","3"
"8","2018","31","Otros","16","19","1","1","0","0","1","1","10.263157894737"
"8","2018","31","Otros","11","32","5","6","0","0","5","6","2.2857142857143"
"8","2018","31","Otros","3","7","16","26","14","25","30","51","2"
"8","2018","31","Otros","5","5","5","7","5","5","10","12","3.65625"
"8","2018","24","Otros","15","27","550","812","0","0","550","812","1.4222222222222"
"8","2018","31","Otros","6","25","4","4","0","0","4","4","2.3846153846154"
"8","2018","31","","10","27","0","0","0","0","0","0","1"
"8","2018","31","Otros","2","29","23","50","60","109","83","159","3.28"
"8","2018","31","Otros","12","35","9","13","3","3","12","16","3.5"
"8","2018","31","Otros","16","19","73","103","0","0","73","103","10.263157894737"
"8","2018","31","Otros","9","26","42","46","2","3","44","49","3.8888888888889"
"8","2018","31","Hotel","13","33","13","13","0","0","13","13","2"
"8","2018","31","Otros","11","32","16","20","2","2","18","22","2.2857142857143"
"8","2018","31","Otros","9","22","52","95","0","0","52","95","7.6428571428571"
"8","2018","31","Otros","6","27","1","6","0","0","1","6","3.960088691796"
"8","2018","31","Otros","15","27","9","9","1","1","10","10","1.4222222222222"
"8","2018","31","Otros","11","32","50","51","2","2","52","53","2.2857142857143"
"8","2018","31","Otros","11","15","26","26","0","0","26","26","2.3571428571429"
"8","2018","31","Otros","9","37","6","144","0","0","6","144","4.5"
"8","2018","31","Otros","5","9","10","17","0","0","10","17","4.0454545454545"
"8","2018","31","Hotel","10","27","12","74","0","0","12","74","2.25"
"8","2018","31","Otros","6","28","18","52","2","8","20","60","4.65"
"8","2018","31","Otros","4","13","22","30","2","2","24","32","3.4"
"8","2018","31","Otros","2","1","0","0","0","0","0","0","1"
"8","2018","31","Otros","2","29","28","78","44","92","72","170","3.28"
"8","2018","31","Hotel","8","3","14","20","0","0","14","20","4.1111111111111"
"8","2018","31","Otros","16","19","13","35","0","0","13","35","1.3333333333333"
"8","2018","31","Otros","12","35","17","31","12","26","29","57","3.5"
"8","2018","31","Hotel","12","35","2","5","2","2","4","7","1.7272727272727"
"8","2018","31","Otros","12","35","3","6","6","10","9","16","3.5"
"8","2018","31","Otros","2","29","42","101","46","100","88","201","3.28"
"8","2018","31","Hotel","7","27","47","79","1","1","48","80","1"
"8","2018","31","Hotel","9","22","23","35","0","0","23","35","2.5555555555556"
"8","2018","31","Hotel","12","35","10","23","32","62","42","85","1.7272727272727"
"8","2018","31","Otros","15","16","137","244","20","61","157","305","2"
"8","2018","31","Hotel","15","27","1","1","0","0","1","1","1"
"8","2018","31","Otros","4","13","40","41","6","6","46","47","3.4"
"8","2018","31","Hotel","8","34","59","70","18","26","77","96","2.5714285714286"
"8","2018","31","Hotel","16","20","90","180","0","0","90","180","1"
"8","2018","31","Hotel","6","28","118","175","25","29","143","204","2.4"
"8","2018","31","Hotel","15","27","76","321","15","59","91","380","1"
"8","2018","31","Otros","12","35","106","164","9","21","115","185","3.5"
"8","2018","31","Otros","11","15","29","69","0","0","29","69","2.3571428571429"
"8","2018","31","Otros","11","15","18","39","0","0","18","39","2.3571428571429"
"8","2018","31","Otros","11","36","51","95","35","55","86","150","5.1904761904762"
"8","2018","31","Hotel","11","36","38","76","3","6","41","82","2.375"
"8","2018","31","Hotel","6","12","81","141","0","0","81","141","5"
"8","2018","31","Otros","8","3","34","62","2","2","36","64","10"
"8","2018","31","Otros","10","27","14","27","0","0","14","27","4.84"
"8","2018","31","Otros","8","3","8","16","0","0","8","16","10"
"8","2018","31","Otros","6","25","22","25","0","0","22","25","2.3846153846154"
"8","2018","31","Hotel","2","27","44","116","0","0","44","116","1"
"8","2018","31","Hotel","10","18","0","0","66","176","66","176","3.2"
"8","2018","31","Otros","11","32","34","66","4","8","38","74","1"
"8","2018","31","Hotel","6","10","1954","2394","182","273","2136","2667","1"
"8","2018","31","Otros","11","32","62","88","0","0","62","88","2.2857142857143"
"8","2018","31","Otros","2","27","17","340","0","0","17","340","1"
"8","2018","31","","12","24","90","170","100","126","190","296","1"
"8","2018","31","Hotel","16","27","549","671","5","8","554","679","5.8571428571429"
"8","2018","31","Hotel","7","38","21","26","3","7","24","33","1"
"8","2018","31","Hotel","6","12","1130","1130","1","10","1131","1140","1"
"9","2018","30","Hotel","14","31","1336","1927","8068","9378","9404","11305","1"
"9","2018","30","Hotel","14","31","463","714","2391","6548","2854","7262","1"
"9","2018","30","Hotel","14","31","255","400","1009","2837","1264","3237","1"
"9","2018","0","Hotel","11","32","0","0","0","0","0","0","1"
"9","2018","30","Hotel","14","27","3418","6348","700","1301","4118","7649","1"
"9","2018","30","Otros","11","32","99","330","0","0","99","330","2.285714286"
"9","2018","30","Hotel","14","31","388","540","2866","3828","3254","4368","5.4"
"9","2018","30","Hotel","15","16","802","1391","43","55","845","1446","1"
"9","2018","30","Hotel","14","31","866","1737","1273","4940","2139","6677","5.4"
"9","2018","30","Hotel","12","24","2300","2976","165","228","2465","3204","1"
"9","2018","30","Hotel","16","40","632","2458","139","489","771","2947","1"
"9","2018","30","Hotel","6","12","1562","2112","59","144","1621","2256","1"
"9","2018","30","Hotel","10","23","1725","2271","51","99","1776","2370","1"
"9","2018","30","Hotel","14","31","1439","3172","295","650","1734","3822","5.4"
"9","2018","30","Hotel","3","4","1075","2224","212","416","1287","2640","1"
"9","2018","30","","11","32","225","575","41","92","266","667","1"
"9","2018","30","Hotel","6","12","624","1076","46","123","670","1199","1"
"9","2018","30","Hotel","6","12","2670","3854","716","877","3386","4731","1"
"9","2018","30","Hotel","9","26","3525","6466","88","138","3613","6604","1"
"9","2018","30","Hotel","2","1","709","1859","41","234","750","2093","1"
"9","2018","30","Hotel","9","26","1025","1807","84","548","1109","2355","1"
"9","2018","30","Hotel","6","12","522","836","60","131","582","967","1"
"9","2018","30","Hotel","14","31","71","93","3652","7455","3723","7548","5.4"
"9","2018","30","Hotel","11","32","147","400","11","22","158","422","1"
"9","2018","30","Hotel","2","6","771","1183","63","95","834","1278","1"
"9","2018","30","Hotel","16","40","1733","3395","427","661","2160","4056","1"
"9","2018","30","Hotel","14","27","556","766","1365","2213","1921","2979","1"
"9","2018","30","Otros","11","36","32","249","0","0","32","249","1"
"9","2018","30","Hotel","10","23","1427","1858","389","558","1816","2416","1"
"9","2018","30","Hotel","14","31","291","1045","541","3008","832","4053","7.8"
"9","2018","30","Hotel","7","17","287","586","96","247","383","833","1"
"9","2018","30","Hotel","2","1","2079","2833","0","0","2079","2833","2"
"9","2018","30","Hotel","2","1","1369","1997","197","480","1566","2477","2"
"9","2018","30","Hotel","4","13","1404","2493","328","644","1732","3137","1"
"9","2018","30","Hotel","2","1","810","1742","64","144","874","1886","2"
"9","2018","30","Hotel","10","27","1753","4213","501","1055","2254","5268","1"
"9","2018","30","Hotel","14","27","1279","1529","1189","1579","2468","3108","1"
"9","2018","30","Hotel","14","27","2057","2725","787","1764","2844","4489","1"
"9","2018","30","Hotel","6","12","1794","1862","60","87","1854","1949","1"
"9","2018","30","Hotel","6","12","1477","2096","592","649","2069","2745","1"
"9","2018","30","Hotel","13","27","1911","4129","7","14","1918","4143","1"
"9","2018","30","Hotel","14","31","69","99","685","2557","754","2656","7.8"
"9","2018","30","Hotel","6","12","1347","2160","276","442","1623","2602","1"
"9","2018","30","Hotel","16","27","2152","3990","84","142","2236","4132","1"
"9","2018","30","","10","27","18","50","5","20","23","70","1"
"9","2018","30","Hotel","10","18","1037","2080","547","1210","1584","3290","1"
"9","2018","30","Hotel","9","37","1402","2848","222","501","1624","3349","1"
"9","2018","30","Hotel","16","27","892","3565","0","0","892","3565","1"
"9","2018","30","Hotel","15","16","848","1843","83","166","931","2009","2"
"9","2018","30","Hotel","2","1","1219","2043","249","420","1468","2463","2"
"9","2018","30","Hotel","3","4","494","1081","130","179","624","1260","1"
"9","2018","30","Hotel","16","40","1610","2665","698","1096","2308","3761","1"
"9","2018","30","Hotel","7","17","4132","4752","164","185","4296","4937","1"
"9","2018","30","Hotel","12","24","1201","1876","422","666","1623","2542","1"
"9","2018","30","Hotel","12","35","862","1749","812","1916","1674","3665","1"
"9","2018","30","Hotel","2","6","426","2281","4","58","430","2339","1"
"9","2018","30","Hotel","13","33","1003","1582","59","172","1062","1754","1"
"9","2018","30","Hotel","10","27","1342","1777","310","514","1652","2291","1"
"9","2018","30","Hotel","10","23","1228","2248","251","459","1479","2707","1"
"9","2018","30","Hotel","11","36","1171","1961","99","191","1270","2152","1"
"9","2018","30","Hotel","8","34","1193","2090","80","160","1273","2250","1"
"9","2018","30","Hotel","2","6","1020","1223","25","44","1045","1267","1"
"9","2018","30","Hotel","14","31","737","1013","1487","1964","2224","2977","7.8"
"9","2018","30","Hotel","11","36","1692","2794","149","189","1841","2983","1"
"9","2018","30","","10","27","812","3226","102","617","914","3843","1"
"9","2018","30","Hotel","14","31","1354","2134","2048","5478","3402","7612","5.4"
"9","2018","30","Hotel","4","13","2896","2908","3","6","2899","2914","1"
"9","2018","30","Hotel","6","28","1292","1660","97","125","1389","1785","1"
"9","2018","30","Otros","14","31","8","10","5","13","13","23","2.8"
"9","2018","30","Otros","16","27","89","89","0","0","89","89","2"
"9","2018","30","Hotel","2","1","710","1141","45","77","755","1218","2"
"9","2018","30","Hotel","10","18","786","1306","262","435","1048","1741","1"
"9","2018","30","Hotel","7","17","1069","1374","83","129","1152","1503","1"
"9","2018","30","Hotel","12","24","795","1332","230","381","1025","1713","1"
"9","2018","30","Hotel","10","18","980","1894","371","518","1351","2412","1"
"9","2018","30","Hotel","2","1","1297","1587","10","19","1307","1606","1"
"9","2018","30","Hotel","10","18","565","1119","258","519","823","1638","1"
"9","2018","30","Hotel","6","28","1530","2322","189","224","1719","2546","1"
"9","2018","30","Hotel","5","5","822","1472","60","81","882","1553","1"
"9","2018","30","Hotel","4","13","438","760","11","16","449","776","1"
"9","2018","30","Hotel","10","18","879","1552","220","388","1099","1940","1"
"9","2018","30","Hotel","16","40","570","970","81","90","651","1060","1"
"9","2018","30","Hotel","8","3","2109","4817","318","647","2427","5464","1"
"9","2018","30","Hotel","15","16","713","1410","54","199","767","1609","2"
"9","2018","30","Hotel","14","31","81","249","342","1504","423","1753","7.8"
"9","2018","30","Hotel","13","33","588","860","57","193","645","1053","1"
"9","2018","30","Hotel","15","16","659","919","109","194","768","1113","2"
"9","2018","30","Otros","4","21","494","775","0","0","494","775","1"
"9","2018","30","Hotel","1","10","934","1596","31","93","965","1689","1"
"9","2018","30","Hotel","16","19","178","314","6","6","184","320","1"
"9","2018","30","Hotel","16","27","831","1991","5","10","836","2001","1"
"9","2018","30","Hotel","10","11","1065","2043","31","56","1096","2099","1"
"9","2018","30","Otros","10","23","439","1033","1","2","440","1035","1"
"9","2018","30","Hotel","12","35","75","248","102","253","177","501","1"
"9","2018","30","Hotel","11","36","500","866","30","49","530","915","1"
"9","2018","30","Hotel","14","31","68","70","1192","1354","1260","1424","17.4"
"9","2018","30","Hotel","10","18","495","1186","500","1369","995","2555","3.2"
"9","2018","30","Hotel","4","13","316","582","6","8","322","590","1"
"9","2018","30","Hotel","6","12","691","1135","29","56","720","1191","5"
"9","2018","30","Hotel","1","10","631","888","33","39","664","927","1"
"9","2018","30","Otros","5","5","216","464","25","42","241","506","3.65625"
"9","2018","30","Hotel","12","24","771","917","595","743","1366","1660","1"
"9","2018","30","Hotel","8","3","1021","2038","163","276","1184","2314","1"
"9","2018","30","Hotel","13","27","675","1191","0","0","675","1191","2.75"
"9","2018","30","Hotel","15","16","120","750","15","110","135","860","4"
"9","2018","30","Otros","15","16","198","767","196","693","394","1460","2"
"9","2018","30","Otros","16","20","356","484","0","0","356","484","1"
"9","2018","30","Hotel","3","4","594","868","60","60","654","928","1"
"9","2018","30","Hotel","11","36","69","82","0","0","69","82","1"
"9","2018","30","Hotel","2","6","154","1130","24","207","178","1337","1"
"9","2018","30","Hotel","8","34","735","1563","151","318","886","1881","1"
"9","2018","30","Hotel","4","13","61","141","0","0","61","141","3.2"
"9","2018","30","Hotel","13","27","862","1963","0","0","862","1963","2.75"
"9","2018","30","Hotel","2","29","1064","1549","906","1698","1970","3247","1"
"9","2018","30","Otros","11","36","119","233","0","0","119","233","1"
"9","2018","0","","10","11","0","0","0","0","0","0","1"
"9","2018","30","Hotel","4","13","739","1089","57","131","796","1220","1"
"9","2018","30","Hotel","16","40","2403","3606","188","286","2591","3892","5.666666667"
"9","2018","30","Hotel","10","23","920","1506","291","706","1211","2212","2.8"
"9","2018","30","Hotel","8","34","405","519","48","86","453","605","1"
"9","2018","30","Hotel","5","5","315","1762","0","0","315","1762","1"
"9","2018","30","Hotel","3","4","50","116","46","97","96","213","3"
"9","2018","30","Hotel","9","26","25","26","4","7","29","33","1"
"9","2018","30","Hotel","8","34","240","281","35","57","275","338","1"
"9","2018","30","Hotel","7","17","210","502","70","124","280","626","4"
"9","2018","30","Hotel","4","13","168","873","1","2","169","875","3.2"
"9","2018","30","Hotel","12","35","39","141","313","1208","352","1349","1"
"9","2018","30","Hotel","16","40","1353","3300","143","330","1496","3630","1"
"9","2018","30","Hotel","9","26","383","654","55","400","438","1054","1"
"9","2018","30","","6","27","106","247","16","75","122","322","1"
"9","2018","30","Hotel","9","26","454","743","0","0","454","743","1"
"9","2018","30","Hotel","4","13","51","71","1","1","52","72","3.2"
"9","2018","30","Hotel","6","28","688","839","16","16","704","855","1"
"9","2018","30","","2","29","148","519","536","1751","684","2270","1"
"9","2018","10","Hotel","14","31","2","2","16","39","18","41","1"
"9","2018","30","Hotel","13","33","1229","1511","41","76","1270","1587","1"
"9","2018","30","Hotel","8","3","191","258","27","32","218","290","1"
"9","2018","30","Hotel","14","27","1586","2897","392","552","1978","3449","1"
"9","2018","30","Hotel","16","40","357","632","0","0","357","632","5.666666667"
"9","2018","30","Hotel","12","24","171","380","98","137","269","517","1"
"9","2018","30","Hotel","10","18","654","1502","62","138","716","1640","3.2"
"9","2018","30","Otros","15","16","76","76","3","3","79","79","9"
"9","2018","30","Hotel","1","10","647","759","0","0","647","759","1"
"9","2018","30","Hotel","10","11","574","1068","28","180","602","1248","1"
"9","2018","30","Otros","1","10","61","292","0","0","61","292","3.851851852"
"9","2018","30","Otros","10","23","52","67","0","0","52","67","1"
"9","2018","30","Hotel","10","23","370","561","177","458","547","1019","2.8"
"9","2018","30","Hotel","6","12","417","853","3","8","420","861","5"
"9","2018","30","Hotel","6","27","76","162","2","12","78","174","3"
"9","2018","30","Hotel","10","23","600","1079","141","358","741","1437","2.8"
"9","2018","30","","4","39","67","100","0","0","67","100","1"
"9","2018","30","Hotel","8","34","380","654","30","35","410","689","1"
"9","2018","30","Hotel","8","34","299","437","16","20","315","457","1"
"9","2018","30","Otros","4","39","4","7","0","0","4","7","2.222222222"
"9","2018","30","Otros","13","14","254","584","0","0","254","584","1"
"9","2018","30","Hotel","10","23","133","221","3","3","136","224","2.8"
"9","2018","30","Otros","13","14","385","1220","0","0","385","1220","1"
"9","2018","30","Hotel","12","24","125","278","215","432","340","710","1"
"9","2018","30","","1","25","170","259","0","0","170","259","1"
"9","2018","30","Hotel","15","27","744","1254","4","12","748","1266","1"
"9","2018","0","Hotel","12","35","0","0","0","0","0","0","1"
"9","2018","30","Hotel","16","40","223","787","0","0","223","787","1"
"9","2018","30","Hotel","16","27","110","251","352","1622","462","1873","1"
"9","2018","30","Hotel","9","30","110","161","0","0","110","161","1"
"9","2018","30","Hotel","4","13","422","741","27","45","449","786","3.2"
"9","2018","30","Hotel","2","29","121","480","263","704","384","1184","1"
"9","2018","30","Hotel","16","20","334","671","46","102","380","773","1"
"9","2018","30","Hotel","5","5","506","655","24","36","530","691","1"
"9","2018","30","Hotel","13","33","569","899","62","123","631","1022","1"
"9","2018","30","Otros","16","19","87","154","0","0","87","154","1.333333333"
"9","2018","30","Hotel","12","24","129","271","81","234","210","505","1"
"9","2018","30","","8","2","470","1014","43","120","513","1134","1"
"9","2018","0","Hotel","12","35","0","0","0","0","0","0","1"
"9","2018","30","Hotel","16","27","38","48","106","128","144","176","2.5"
"9","2018","30","Otros","16","27","368","734","10","30","378","764","2"
"9","2018","30","Hotel","8","34","313","447","46","69","359","516","1"
"9","2018","30","Otros","8","3","398","2698","0","0","398","2698","1"
"9","2018","30","Hotel","7","27","185","350","58","95","243","445","1"
"9","2018","30","Hotel","4","39","86","124","0","0","86","124","1"
"9","2018","30","Hotel","15","16","251","508","18","48","269","556","4"
"9","2018","30","Hotel","4","39","29","58","2","2","31","60","1"
"9","2018","30","Hotel","4","39","146","291","3","10","149","301","1"
"9","2018","30","Hotel","15","16","143","533","4","10","147","543","4"
"9","2018","30","Hotel","14","31","79","193","246","934","325","1127","17.4"
"9","2018","30","Hotel","8","34","276","350","16","20","292","370","1"
"9","2018","30","Hotel","6","28","211","335","16","22","227","357","1"
"9","2018","30","Hotel","7","17","785","1474","33","45","818","1519","4"
"9","2018","30","Otros","7","27","2","2","0","0","2","2","1"
"9","2018","30","Hotel","11","36","971","1154","6","14","977","1168","1"
"9","2018","30","Otros","4","21","277","709","55","94","332","803","1"
"9","2018","30","Otros","15","16","70","104","23","34","93","138","2"
"9","2018","30","Otros","7","17","248","524","0","0","248","524","3"
"9","2018","30","Hotel","7","38","111","116","0","0","111","116","1"
"9","2018","30","Hotel","16","27","540","938","13","46","553","984","2.5"
"9","2018","30","Hotel","2","6","70","79","4","8","74","87","2.2"
"9","2018","30","Hotel","11","36","336","553","30","86","366","639","1"
"9","2018","30","Hotel","6","28","22","24","0","0","22","24","1"
"9","2018","30","Hotel","6","12","156","254","0","0","156","254","5"
"9","2018","30","Otros","9","22","152","454","0","0","152","454","1"
"9","2018","30","","13","14","205","334","0","0","205","334","2"
"9","2018","30","Hotel","2","29","310","624","391","825","701","1449","1"
"9","2018","30","Hotel","2","29","90","311","28","103","118","414","1"
"9","2018","30","Otros","4","13","362","374","14","14","376","388","1"
"9","2018","30","Hotel","15","16","58","173","34","86","92","259","4"
"9","2018","30","Hotel","2","1","105","246","14","34","119","280","6.4"
"9","2018","30","Otros","7","27","124","130","0","0","124","130","1"
"9","2018","30","Otros","13","33","19","19","0","0","19","19","5.125"
"9","2018","30","","4","21","193","220","4","4","197","224","1"
"9","2018","30","Hotel","1","10","372","372","3","3","375","375","1"
"9","2018","30","Hotel","11","36","154","415","9","15","163","430","1"
"9","2018","30","Otros","14","31","912","912","0","0","912","912","2.8"
"9","2018","30","Hotel","7","27","180","308","6","11","186","319","1"
"9","2018","30","Otros","1","10","29","522","0","0","29","522","3.851851852"
"9","2018","30","Hotel","4","39","24","38","19","171","43","209","2.6"
"9","2018","30","Otros","8","2","56","186","18","49","74","235","6.428571429"
"9","2018","30","Otros","11","36","25","45","4","10","29","55","5.19047619"
"9","2018","30","Hotel","13","33","231","231","0","0","231","231","1"
"9","2018","30","","3","4","70","113","44","55","114","168","1"
"9","2018","30","Hotel","7","17","343","698","28","87","371","785","4"
"9","2018","30","Hotel","8","2","275","403","6","6","281","409","1"
"9","2018","30","Otros","15","16","153","179","26","27","179","206","2"
"9","2018","30","Hotel","10","11","190","268","13","29","203","297","1"
"9","2018","30","Hotel","16","19","96","199","0","0","96","199","1"
"9","2018","30","Hotel","10","23","86","119","4","7","90","126","4"
"9","2018","30","","7","38","357","623","61","79","418","702","1"
"9","2018","30","Hotel","7","27","303","552","13","28","316","580","1"
"9","2018","30","Hotel","11","36","200","426","4","113","204","539","1"
"9","2018","30","Hotel","16","40","163","242","10","14","173","256","16.33333333"
"9","2018","30","Hotel","16","19","61","97","3","3","64","100","1"
"9","2018","15","Hotel","16","19","0","0","0","0","0","0","1"
"9","2018","0","Hotel","16","20","0","0","0","0","0","0","1"
"9","2018","30","Hotel","10","11","215","321","13","24","228","345","1"
"9","2018","30","Otros","7","27","51","129","0","0","51","129","4.833333333"
"9","2018","30","Otros","7","27","19","51","0","0","19","51","1"
"9","2018","30","Hotel","7","27","27","38","0","0","27","38","4.166666667"
"9","2018","30","Otros","13","14","121","180","0","0","121","180","1"
"9","2018","30","Otros","11","15","45","45","0","0","45","45","2.357142857"
"9","2018","30","Otros","10","27","34","58","5","7","39","65","4.84"
"9","2018","30","Otros","14","31","627","627","2067","2067","2694","2694","2.8"
"9","2018","30","Otros","11","36","13","24","1","6","14","30","5.19047619"
"9","2018","30","Hotel","16","19","78","78","0","0","78","78","1"
"9","2018","30","","14","27","390","533","8","20","398","553","2.666666667"
"9","2018","30","Hotel","16","40","106","146","8","8","114","154","5.666666667"
"9","2018","30","Hotel","10","27","10","30","0","0","10","30","2.25"
"9","2018","30","Otros","2","29","128","342","132","365","260","707","3.28"
"9","2018","30","Hotel","13","27","30","30","4","7","34","37","1"
"9","2018","30","Otros","9","22","20","37","0","0","20","37","1"
"9","2018","30","Hotel","2","27","105","140","19","19","124","159","1"
"9","2018","30","Hotel","8","34","235","452","36","58","271","510","1"
"9","2018","30","Hotel","7","27","464","623","0","0","464","623","1"
"9","2018","30","Hotel","15","16","145","261","21","29","166","290","4"
"9","2018","30","Hotel","16","20","27","60","2","2","29","62","1"
"9","2018","30","Otros","4","13","71","184","3","3","74","187","1"
"9","2018","30","Hotel","2","1","167","461","7","11","174","472","6.4"
"9","2018","30","Otros","11","32","26","43","0","0","26","43","2.285714286"
"9","2018","30","Hotel","2","29","12","124","103","782","115","906","1"
"9","2018","30","Hotel","16","27","227","232","99","114","326","346","2.5"
"9","2018","30","Hotel","10","18","102","266","48","150","150","416","3.2"
"9","2018","30","Otros","11","36","368","484","15","15","383","499","1"
"9","2018","30","Otros","13","14","95","150","0","0","95","150","1"
"9","2018","0","Hotel","7","27","0","0","0","0","0","0","1"
"9","2018","30","Otros","7","17","73","143","3","3","76","146","3"
"9","2018","30","Otros","14","31","200","483","140","419","340","902","2.8"
"9","2018","30","Hotel","2","29","340","1174","108","420","448","1594","1"
"9","2018","30","Hotel","8","3","106","139","25","41","131","180","1"
"9","2018","30","Hotel","8","34","225","428","23","89","248","517","2.571428571"
"9","2018","30","Hotel","8","34","121","156","16","39","137","195","2.571428571"
"9","2018","30","Hotel","12","35","179","250","30","55","209","305","1"
"9","2018","30","Hotel","11","32","51","109","6","10","57","119","1"
"9","2018","30","Hotel","13","33","140","204","2","9","142","213","2"
"9","2018","30","Hotel","10","23","81","143","4","6","85","149","2.8"
"9","2018","30","Hotel","12","35","51","149","13","34","64","183","1"
"9","2018","30","","16","40","227","339","5","5","232","344","3.055555556"
"9","2018","30","Otros","16","19","10","30","0","0","10","30","1.333333333"
"9","2018","0","Otros","16","20","0","0","0","0","0","0","1"
"9","2018","30","Hotel","6","12","132","274","9","13","141","287","5"
"9","2018","30","Hotel","16","19","194","223","0","0","194","223","4"
"9","2018","30","Hotel","12","24","159","209","150","182","309","391","1"
"9","2018","30","Hotel","12","24","185","379","74","86","259","465","3"
"9","2018","30","Hotel","8","3","73","471","0","0","73","471","1"
"9","2018","0","Hotel","5","9","0","0","0","0","0","0","1"
"9","2018","30","Hotel","16","27","204","352","8","17","212","369","2.5"
"9","2018","27","Otros","10","23","45","45","0","0","45","45","7"
"9","2018","30","Otros","13","14","105","275","0","0","105","275","7.384615385"
"9","2018","30","Otros","2","6","38","77","4","5","42","82","1"
"9","2018","22","Hotel","15","16","0","0","26","30","26","30","7.8"
"9","2018","30","Hotel","8","3","84","205","0","0","84","205","1"
"9","2018","30","Hotel","8","34","415","559","40","57","455","616","1"
"9","2018","30","Hotel","8","3","70","142","12","21","82","163","1"
"9","2018","30","","2","29","87","246","43","148","130","394","1"
"9","2018","30","Hotel","2","1","303","394","11","21","314","415","6.4"
"9","2018","30","Hotel","7","17","43","122","0","0","43","122","4"
"9","2018","30","Otros","7","17","272","893","0","0","272","893","3"
"9","2018","30","Hotel","16","40","126","233","24","38","150","271","5.666666667"
"9","2018","30","Hotel","12","24","258","517","53","75","311","592","1"
"9","2018","30","Hotel","14","31","261","868","179","947","440","1815","17.4"
"9","2018","0","Hotel","9","26","0","0","0","0","0","0","1"
"9","2018","30","Hotel","6","12","20","25","0","0","20","25","5"
"9","2018","30","Otros","5","9","13","13","0","0","13","13","4.045454545"
"9","2018","30","Otros","5","9","7","9","0","0","7","9","4.045454545"
"9","2018","30","Otros","15","27","23","124","0","0","23","124","1.422222222"
"9","2018","30","Hotel","8","34","17","17","1","1","18","18","2.571428571"
"9","2018","30","Hotel","10","18","309","673","85","181","394","854","7.75"
"9","2018","30","Hotel","15","16","261","542","47","96","308","638","7.8"
"9","2018","30","Hotel","2","29","95","351","248","806","343","1157","1"
"9","2018","30","Hotel","4","39","56","94","6","12","62","106","2.6"
"9","2018","30","Otros","4","39","71","89","0","0","71","89","2.222222222"
"9","2018","23","Hotel","4","13","114","200","3","3","117","203","5.4"
"9","2018","30","Otros","10","23","31","31","1","1","32","32","7"
"9","2018","30","Otros","14","31","122","195","263","785","385","980","20.2"
"9","2018","30","Hotel","3","4","35","49","0","0","35","49","2.6"
"9","2018","30","Hotel","10","23","87","116","5","6","92","122","4"
"9","2018","30","Otros","9","22","273","912","0","0","273","912","1"
"9","2018","30","Hotel","12","24","167","315","62","115","229","430","3"
"9","2018","30","Hotel","13","14","37","71","4","6","41","77","1"
"9","2018","30","Hotel","12","35","139","231","25","54","164","285","1.727272727"
"9","2018","30","Hotel","6","28","312","509","0","0","312","509","1"
"9","2018","30","","6","28","57","382","0","0","57","382","1"
"9","2018","30","Hotel","12","24","280","623","39","167","319","790","3"
"9","2018","30","Otros","5","9","6","8","0","0","6","8","4.045454545"
"9","2018","30","Hotel","16","20","51","62","0","0","51","62","1"
"9","2018","30","Hotel","4","21","246","395","37","45","283","440","3"
"9","2018","30","Otros","10","11","41","78","1","1","42","79","11.76470588"
"9","2018","30","Otros","13","14","20","20","0","0","20","20","7.384615385"
"9","2018","30","Otros","16","27","43","70","0","0","43","70","13.81818182"
"9","2018","30","Hotel","9","26","350","350","0","0","350","350","1"
"9","2018","30","Hotel","16","27","700","731","249","269","949","1000","2.5"
"9","2018","30","Hotel","3","4","509","1071","14","26","523","1097","3"
"9","2018","30","Otros","16","27","120","240","0","0","120","240","2"
"9","2018","30","Otros","16","19","514","997","0","0","514","997","1.333333333"
"9","2018","30","Hotel","6","12","515","718","0","0","515","718","5"
"9","2018","30","Hotel","2","1","229","344","14","14","243","358","6.4"
"9","2018","30","Hotel","10","11","328","571","18","37","346","608","1"
"9","2018","30","Otros","10","23","43","43","0","0","43","43","1"
"9","2018","30","Otros","10","27","328","355","4","6","332","361","4.84"
"9","2018","30","Hotel","16","27","180","265","23","109","203","374","2.5"
"9","2018","30","Hotel","6","28","87","114","7","7","94","121","1"
"9","2018","30","Hotel","4","13","17","36","0","0","17","36","5.4"
"9","2018","30","Hotel","14","27","415","602","9","17","424","619","8.5"
"9","2018","30","Hotel","10","27","108","153","35","41","143","194","1"
"9","2018","30","Hotel","13","27","440","558","26","42","466","600","4.2"
"9","2018","30","Hotel","3","4","579","842","30","59","609","901","3"
"9","2018","30","Otros","4","13","44","44","0","0","44","44","3.4"
"9","2018","30","Otros","11","15","12","24","2","3","14","27","2.357142857"
"9","2018","30","Otros","1","10","254","586","0","0","254","586","3.851851852"
"9","2018","30","Otros","2","1","55","86","0","0","55","86","1"
"9","2018","30","","6","12","20","47","0","0","20","47","1"
"9","2018","30","Otros","10","23","276","623","4","4","280","627","1"
"9","2018","30","Hotel","16","19","81","91","0","0","81","91","4"
"9","2018","30","Hotel","10","11","11","66","0","0","11","66","5.666666667"
"9","2018","30","Hotel","10","23","87","111","8","9","95","120","4"
"9","2018","30","Otros","14","31","29","69","182","468","211","537","2.8"
"9","2018","30","Otros","13","27","5","5","0","0","5","5","12.2"
"9","2018","30","Hotel","2","1","121","245","0","0","121","245","6.4"
"9","2018","8","Hotel","16","19","12","23","0","0","12","23","4"
"9","2018","30","Otros","12","35","26","33","5","7","31","40","3.5"
"9","2018","30","Otros","15","16","143","376","5","7","148","383","2"
"9","2018","30","Otros","9","22","341","682","54","108","395","790","1"
"9","2018","30","Hotel","10","27","242","341","74","81","316","422","1"
"9","2018","30","Hotel","2","27","57","76","6","8","63","84","3.6"
"9","2018","30","Hotel","16","20","19","135","0","0","19","135","1"
"9","2018","30","Hotel","10","18","135","315","54","110","189","425","7.75"
"9","2018","30","Hotel","6","12","249","249","0","0","249","249","5"
"9","2018","30","Hotel","2","27","32","47","1","3","33","50","3.6"
"9","2018","30","Hotel","15","16","95","148","3","3","98","151","7.8"
"9","2018","30","Hotel","10","23","41","41","5","5","46","46","4"
"9","2018","30","Hotel","11","32","54","82","2","6","56","88","1"
"9","2018","30","Hotel","14","27","71","234","21","56","92","290","8.5"
"9","2018","30","Otros","10","11","37","83","0","0","37","83","11.76470588"
"9","2018","30","Hotel","2","27","63","107","0","0","63","107","3.6"
"9","2018","30","Otros","13","14","215","506","6","12","221","518","7.384615385"
"9","2018","30","Hotel","2","1","129","208","6","21","135","229","6.4"
"9","2018","30","Otros","7","17","274","809","0","0","274","809","17.16666667"
"9","2018","30","Otros","10","23","33","202","0","0","33","202","7"
"9","2018","30","Hotel","13","27","141","141","4","4","145","145","2.75"
"9","2018","30","Otros","10","18","78","134","6","6","84","140","10.25"
"9","2018","30","Otros","5","9","10","12","0","0","10","12","4.045454545"
"9","2018","30","Hotel","4","39","87","147","0","0","87","147","2.6"
"9","2018","30","Otros","16","27","55","249","9","14","64","263","13.81818182"
"9","2018","30","Hotel","14","27","12","94","18","142","30","236","8.5"
"9","2018","30","Hotel","10","11","302","575","8","19","310","594","5.666666667"
"9","2018","30","Hotel","10","18","171","371","36","128","207","499","7.75"
"9","2018","30","Otros","14","31","156","201","91","197","247","398","20.2"
"9","2018","30","Otros","11","32","35","66","0","0","35","66","2.285714286"
"9","2018","30","Otros","5","5","78","162","0","0","78","162","3.65625"
"9","2018","30","Otros","1","25","52","90","0","0","52","90","2.384615385"
"9","2018","30","Hotel","3","4","36","78","6","8","42","86","2.6"
"9","2018","30","Otros","7","27","118","425","0","0","118","425","4.833333333"
"9","2018","30","Otros","2","29","58","169","157","359","215","528","3.28"
"9","2018","30","Hotel","2","29","72","240","157","583","229","823","1"
"9","2018","30","Otros","4","21","111","256","23","23","134","279","1"
"9","2018","30","Hotel","7","27","272","345","0","0","272","345","4.166666667"
"9","2018","30","Otros","5","5","2","36","0","0","2","36","3.65625"
"9","2018","30","Otros","11","36","90","160","21","21","111","181","5.19047619"
"9","2018","30","Hotel","7","27","200","200","0","0","200","200","4.166666667"
"9","2018","0","Hotel","16","20","0","0","0","0","0","0","1"
"9","2018","30","Hotel","12","24","191","254","11","21","202","275","3"
"9","2018","30","Hotel","9","26","130","155","11","11","141","166","1.5"
"9","2018","30","Hotel","7","17","254","563","5","5","259","568","10"
"9","2018","30","Hotel","9","37","222","311","18","27","240","338","3.4"
"9","2018","30","Hotel","5","5","265","476","11","21","276","497","2.142857143"
"9","2018","30","Otros","6","27","138","276","0","0","138","276","3.960088692"
"9","2018","30","Hotel","9","37","47","63","5","14","52","77","3.4"
"9","2018","30","Otros","10","27","44","44","25","25","69","69","4.84"
"9","2018","30","Otros","8","3","169","279","7","9","176","288","10"
"9","2018","30","Otros","16","20","33","35","0","0","33","35","3.076923077"
"9","2018","30","Otros","9","22","8","16","0","0","8","16","7.642857143"
"9","2018","30","Otros","10","27","216","264","14","14","230","278","4.84"
"9","2018","30","Otros","10","23","30","37","0","0","30","37","7"
"9","2018","30","Otros","2","6","405","405","57","57","462","462","1"
"9","2018","30","Otros","4","39","13","23","0","0","13","23","2.222222222"
"9","2018","30","Hotel","2","27","66","73","14","14","80","87","1"
"9","2018","30","Hotel","14","31","71","168","101","721","172","889","24"
"9","2018","30","Otros","2","29","188","314","103","226","291","540","3.28"
"9","2018","30","Otros","8","3","308","1540","0","0","308","1540","10"
"9","2018","30","","13","14","36","96","0","0","36","96","1"
"9","2018","30","Hotel","1","10","175","222","8","12","183","234","6.6"
"9","2018","30","Hotel","8","34","20","22","11","15","31","37","2.571428571"
"9","2018","30","Hotel","9","22","138","454","0","0","138","454","2.555555556"
"9","2018","30","Hotel","2","6","121","294","18","21","139","315","2.2"
"9","2018","30","Hotel","10","27","79","124","26","51","105","175","2.25"
"9","2018","30","Otros","14","27","158","158","0","0","158","158","11.83333333"
"9","2018","30","Otros","6","12","380","493","15","39","395","532","1.825657895"
"9","2018","30","Hotel","6","27","200","371","0","0","200","371","3"
"9","2018","30","Hotel","5","5","22","55","1","1","23","56","2.142857143"
"9","2018","30","Hotel","5","5","59","107","0","0","59","107","2.142857143"
"9","2018","30","Hotel","13","27","85","160","0","0","85","160","4.2"
"9","2018","30","Hotel","2","27","197","315","13","26","210","341","3.6"
"9","2018","30","Hotel","8","3","61","61","37","37","98","98","4.111111111"
"9","2018","30","Otros","11","36","30","39","0","0","30","39","5.19047619"
"9","2018","30","Otros","9","30","102","266","0","0","102","266","2.333333333"
"9","2018","30","Otros","16","19","44","114","0","0","44","114","10.26315789"
"9","2018","30","Hotel","14","31","104","203","358","801","462","1004","17.4"
"9","2018","30","Hotel","2","1","206","255","5","7","211","262","6.4"
"9","2018","30","Hotel","16","40","906","1780","243","305","1149","2085","5.666666667"
"9","2018","30","Otros","7","17","219","490","4","6","223","496","17.16666667"
"9","2018","30","Hotel","13","27","343","438","97","126","440","564","2.75"
"9","2018","30","Hotel","14","31","170","234","111","416","281","650","24"
"9","2018","30","Otros","3","4","31","86","7","14","38","100","12.2"
"9","2018","30","Otros","8","34","131","160","22","22","153","182","5.75"
"9","2018","30","Hotel","9","22","111","188","5","12","116","200","2.555555556"
"9","2018","30","Hotel","4","21","34","39","0","0","34","39","3"
"9","2018","30","Hotel","6","27","149","225","0","0","149","225","3"
"9","2018","30","Hotel","12","35","164","320","173","335","337","655","1.727272727"
"9","2018","30","Hotel","2","29","33","98","78","166","111","264","2"
"9","2018","30","Otros","10","11","50","76","1","1","51","77","11.76470588"
"9","2018","30","Hotel","1","10","11","17","0","0","11","17","6.6"
"9","2018","30","Hotel","13","14","31","92","0","0","31","92","2"
"9","2018","19","Otros","16","27","98","193","0","0","98","193","13.81818182"
"9","2018","30","Otros","6","27","29","50","0","0","29","50","3.960088692"
"9","2018","30","Hotel","16","40","307","625","83","175","390","800","5.666666667"
"9","2018","30","Otros","1","10","82","154","6","18","88","172","3.851851852"
"9","2018","30","Otros","10","23","23","35","0","0","23","35","7"
"9","2018","30","Hotel","6","28","192","236","6","6","198","242","1"
"9","2018","30","Otros","7","38","294","698","12","21","306","719","2.75"
"9","2018","30","Hotel","6","12","175","277","5","15","180","292","5"
"9","2018","30","Hotel","13","27","311","513","0","0","311","513","4.2"
"9","2018","30","Otros","4","21","34","59","0","0","34","59","4.833333333"
"9","2018","30","Hotel","16","27","97","326","0","0","97","326","5.857142857"
"9","2018","30","Hotel","5","5","253","447","13","14","266","461","2.142857143"
"9","2018","30","Otros","12","24","49","90","8","8","57","98","9.2"
"9","2018","30","Otros","15","16","105","181","52","68","157","249","9"
"9","2018","30","Hotel","8","27","206","206","8","8","214","214","4.5"
"9","2018","30","Hotel","9","22","3","5","0","0","3","5","2.555555556"
"9","2018","30","Hotel","10","11","172","289","8","14","180","303","5.666666667"
"9","2018","30","Hotel","8","3","87","192","4","12","91","204","4.111111111"
"9","2018","30","Hotel","1","10","294","489","0","0","294","489","6.6"
"9","2018","30","Otros","9","26","34","178","2","2","36","180","3.888888889"
"9","2018","30","Hotel","4","39","88","149","6","12","94","161","2.6"
"9","2018","30","Otros","6","27","2","2","0","0","2","2","3.960088692"
"9","2018","30","Otros","6","12","149","204","0","0","149","204","1.825657895"
"9","2018","30","Hotel","6","27","75","134","0","0","75","134","3"
"9","2018","30","Otros","5","9","36","47","2","2","38","49","4.045454545"
"9","2018","30","Hotel","2","27","122","122","11","11","133","133","3.6"
"9","2018","30","Hotel","2","29","46","138","182","521","228","659","1"
"9","2018","30","Hotel","4","13","167","420","2","3","169","423","5.4"
"9","2018","30","","11","15","20","27","0","0","20","27","1"
"9","2018","30","Hotel","1","10","451","510","10","14","461","524","6.6"
"9","2018","30","Otros","6","12","9","18","0","0","9","18","1.825657895"
"9","2018","30","Otros","10","18","39","43","2","2","41","45","10.25"
"9","2018","30","Otros","9","22","198","402","0","0","198","402","7.642857143"
"9","2018","30","","14","27","147","268","36","302","183","570","1"
"9","2018","30","Hotel","16","27","61","78","2","2","63","80","5.857142857"
"9","2018","30","Otros","2","29","32","79","7","17","39","96","3.28"
"9","2018","30","Otros","13","33","42","44","0","0","42","44","5.125"
"9","2018","30","Otros","13","33","13","25","5","5","18","30","5.125"
"9","2018","27","Otros","1","10","66","283","0","0","66","283","3.851851852"
"9","2018","30","Hotel","10","18","60","122","11","20","71","142","7.75"
"9","2018","30","Hotel","14","31","109","172","4","11","113","183","24"
"9","2018","30","Hotel","4","21","62","62","2","2","64","64","3"
"9","2018","30","Hotel","3","4","0","0","2","18","2","18","2.6"
"9","2018","30","Otros","8","27","30","48","0","0","30","48","1"
"9","2018","30","Otros","6","27","20","42","0","0","20","42","3.960088692"
"9","2018","30","Hotel","1","25","163","581","0","0","163","581","1"
"9","2018","30","Otros","6","12","165","371","1","2","166","373","1.825657895"
"9","2018","30","Hotel","6","27","19","27","0","0","19","27","3"
"9","2018","30","Otros","6","27","15","33","0","0","15","33","3.960088692"
"9","2018","30","Otros","1","10","160","238","0","0","160","238","3.851851852"
"9","2018","30","Otros","6","12","71","119","0","0","71","119","1.825657895"
"9","2018","10","Otros","5","5","1","1","0","0","1","1","3.65625"
"9","2018","30","Hotel","12","24","94","583","5","22","99","605","3"
"9","2018","27","Hotel","15","16","37","54","8","10","45","64","7.8"
"9","2018","30","Otros","4","13","53","72","0","0","53","72","3.4"
"9","2018","30","Hotel","2","29","171","555","38","127","209","682","1"
"9","2018","30","Hotel","4","21","5","12","0","0","5","12","3"
"9","2018","30","Hotel","10","27","133","187","34","50","167","237","2.25"
"9","2018","30","Hotel","8","3","173","297","37","45","210","342","4.111111111"
"9","2018","30","Hotel","12","27","50","73","3","3","53","76","1"
"9","2018","30","Otros","5","5","63","145","6","18","69","163","3.65625"
"9","2018","30","Otros","13","14","9","12","0","0","9","12","7.384615385"
"9","2018","30","Otros","10","11","281","408","0","0","281","408","11.76470588"
"9","2018","30","Otros","16","40","127","225","2","2","129","227","28.14285714"
"9","2018","30","Hotel","11","36","167","430","0","0","167","430","1"
"9","2018","27","Otros","8","34","37","61","2","4","39","65","5.75"
"9","2018","30","Hotel","7","17","77","141","5","15","82","156","10"
"9","2018","30","Otros","12","35","161","320","4","6","165","326","3.5"
"9","2018","30","Otros","5","9","17","38","5","8","22","46","4.045454545"
"9","2018","30","Hotel","9","22","66","139","0","0","66","139","2.555555556"
"9","2018","30","Otros","2","29","32","58","36","42","68","100","3.28"
"9","2018","30","Otros","2","29","110","366","66","191","176","557","3.28"
"9","2018","30","Hotel","10","27","31","45","6","6","37","51","2.25"
"9","2018","30","Hotel","16","19","32","98","9","14","41","112","4"
"9","2018","30","Hotel","16","40","133","201","0","0","133","201","16.33333333"
"9","2018","26","Hotel","8","27","222","323","8","9","230","332","4.5"
"9","2018","30","Otros","13","14","6","10","0","0","6","10","7.384615385"
"9","2018","30","Hotel","7","27","42","55","0","0","42","55","4.166666667"
"9","2018","30","Otros","2","6","40","507","0","0","40","507","5"
"9","2018","30","Hotel","7","17","277","674","8","44","285","718","10"
"9","2018","30","Hotel","3","4","111","243","29","47","140","290","2.6"
"9","2018","30","Otros","6","12","10","122","0","0","10","122","1.825657895"
"9","2018","30","Otros","1","10","4","4","0","0","4","4","3.851851852"
"9","2018","30","Hotel","16","40","412","482","0","0","412","482","16.33333333"
"9","2018","30","Otros","4","39","60","115","0","0","60","115","2.222222222"
"9","2018","30","Otros","13","14","46","91","0","0","46","91","7.384615385"
"9","2018","30","Otros","7","38","83","147","1","1","84","148","2.75"
"9","2018","30","Hotel","11","32","210","377","0","0","210","377","1"
"9","2018","30","Otros","11","36","123","251","0","0","123","251","5.19047619"
"9","2018","30","Hotel","4","21","47","75","2","2","49","77","3"
"9","2018","30","Otros","3","4","5","9","0","0","5","9","12.2"
"9","2018","30","Otros","5","9","39","53","10","20","49","73","4.045454545"
"9","2018","30","Hotel","8","27","74","151","10","40","84","191","4.5"
"9","2018","30","","7","17","243","594","0","0","243","594","1"
"9","2018","30","Otros","16","20","80","182","0","0","80","182","3.076923077"
"9","2018","30","Otros","4","21","120","345","14","14","134","359","4.833333333"
"9","2018","30","Otros","13","33","63","75","8","10","71","85","5.125"
"9","2018","30","","12","35","18","24","246","443","264","467","1"
"9","2018","30","Hotel","13","33","1","1","0","0","1","1","2"
"9","2018","30","Otros","4","39","17","28","0","0","17","28","2.222222222"
"9","2018","30","Otros","10","18","8","33","0","0","8","33","10.25"
"9","2018","30","Otros","6","27","60","95","0","0","60","95","3.960088692"
"9","2018","30","Hotel","4","39","63","218","0","0","63","218","2.6"
"9","2018","30","Otros","14","31","169","184","52","104","221","288","20.2"
"9","2018","30","Hotel","2","29","36","105","298","661","334","766","2"
"9","2018","30","Hotel","9","26","181","328","4","13","185","341","1.5"
"9","2018","30","Otros","12","35","4","7","0","0","4","7","3.5"
"9","2018","30","Hotel","14","27","85","107","13","21","98","128","8.5"
"9","2018","30","Otros","11","36","23","76","0","0","23","76","5.19047619"
"9","2018","30","Otros","16","20","171","465","8","16","179","481","3.076923077"
"9","2018","30","Otros","4","39","3","8","0","0","3","8","2.222222222"
"9","2018","30","Otros","7","27","96","111","9","9","105","120","4.833333333"
"9","2018","30","Otros","6","27","45","81","0","0","45","81","3.960088692"
"9","2018","30","Otros","5","8","5","70","0","0","5","70","5"
"9","2018","30","Otros","9","37","206","297","11","22","217","319","4.5"
"9","2018","30","Hotel","2","6","40","165","0","0","40","165","5.5"
"9","2018","30","Hotel","10","27","54","78","24","27","78","105","2.25"
"9","2018","30","Hotel","9","30","116","264","2","8","118","272","1"
"9","2018","30","Otros","4","13","37","183","0","0","37","183","3.4"
"9","2018","30","Hotel","5","5","221","221","0","0","221","221","1"
"9","2018","30","Otros","7","38","282","539","9","9","291","548","2.75"
"9","2018","30","Hotel","13","14","17","26","0","0","17","26","1"
"9","2018","30","Otros","5","9","43","46","11","15","54","61","4.045454545"
"9","2018","30","Otros","5","8","4","4","0","0","4","4","5"
"9","2018","30","Otros","10","27","16","480","0","0","16","480","4.84"
"9","2018","30","Hotel","13","14","4","7","0","0","4","7","1"
"9","2018","30","Otros","11","15","4","8","0","0","4","8","2.357142857"
"9","2018","30","Hotel","9","22","250","531","0","0","250","531","2.555555556"
"9","2018","30","Otros","11","36","133","266","5","5","138","271","5.19047619"
"9","2018","30","Hotel","10","18","979","2312","833","2175","1812","4487","1"
"9","2018","30","Hotel","6","12","60","150","0","0","60","150","5"
"9","2018","30","","2","29","537","1587","616","1449","1153","3036","1"
"9","2018","30","Hotel","16","27","1078","3234","8","24","1086","3258","1"
"9","2018","30","","14","31","247","876","175","880","422","1756","1"
"9","2018","30","Hotel","8","3","3","7","2","2","5","9","4.111111111"
"9","2018","30","Otros","13","33","19","35","0","0","19","35","5.125"
"9","2018","30","","14","27","355","409","15","24","370","433","2.666666667"
"9","2018","30","Otros","9","22","60","242","0","0","60","242","7.642857143"
"9","2018","30","Hotel","10","11","12","20","0","0","12","20","5.666666667"
"9","2018","30","Otros","6","12","8","8","0","0","8","8","1.825657895"
"9","2018","30","Hotel","8","3","69","107","8","12","77","119","4.111111111"
"9","2018","30","Otros","6","12","281","604","0","0","281","604","1.825657895"
"9","2018","30","Hotel","8","27","356","468","10","10","366","478","4.5"
"9","2018","30","Hotel","6","28","184","225","2","2","186","227","2.4"
"9","2018","30","Otros","1","25","49","319","0","0","49","319","2.384615385"
"9","2018","30","Otros","1","25","68","154","0","0","68","154","2.384615385"
"9","2018","30","Hotel","11","36","875","2273","0","0","875","2273","1"
"9","2018","30","Otros","2","6","33","104","148","462","181","566","5"
"9","2018","30","Hotel","14","31","40","74","42","197","82","271","24"
"9","2018","22","Otros","4","21","31","31","0","0","31","31","4.833333333"
"9","2018","30","Otros","7","38","213","344","0","0","213","344","2.75"
"9","2018","30","Otros","13","14","32","44","0","0","32","44","7.384615385"
"9","2018","30","Otros","2","29","66","144","16","42","82","186","3.28"
"9","2018","30","Otros","3","4","74","74","26","29","100","103","12.2"
"9","2018","30","Hotel","3","4","332","702","31","43","363","745","3"
"9","2018","30","Otros","7","27","104","664","4","4","108","668","1"
"9","2018","30","Otros","7","17","180","196","0","0","180","196","3"
"9","2018","19","Hotel","12","27","152","270","16","32","168","302","1"
"9","2018","30","Otros","5","5","19","26","0","0","19","26","3.65625"
"9","2018","30","Hotel","1","10","174","340","0","0","174","340","6.6"
"9","2018","30","Otros","10","18","8","16","11","35","19","51","10.25"
"9","2018","30","Otros","8","27","30","58","0","0","30","58","9.4"
"9","2018","30","Otros","8","3","27","40","2","2","29","42","10"
"9","2018","30","Hotel","16","27","70","147","0","0","70","147","5.857142857"
"9","2018","30","Otros","1","10","87","226","0","0","87","226","3.851851852"
"9","2018","27","Hotel","2","6","27","31","2","2","29","33","5.5"
"9","2018","30","Hotel","8","3","27","81","0","0","27","81","4.111111111"
"9","2018","30","Otros","10","11","32","45","5","7","37","52","11.76470588"
"9","2018","30","Otros","6","27","52","379","0","0","52","379","3.960088692"
"9","2018","30","Otros","15","16","2","2","0","0","2","2","9"
"9","2018","30","Otros","5","5","9","9","2","2","11","11","3.65625"
"9","2018","30","Otros","10","27","106","155","17","21","123","176","4.84"
"9","2018","30","Hotel","7","38","79","142","2","2","81","144","1"
"9","2018","30","Hotel","13","27","12","132","0","0","12","132","4.2"
"9","2018","30","Hotel","16","20","119","238","0","0","119","238","1"
"9","2018","30","Otros","10","27","55","70","5","5","60","75","4.84"
"9","2018","30","Hotel","3","7","67","110","52","66","119","176","1"
"9","2018","30","Otros","2","29","96","243","4","6","100","249","3.28"
"9","2018","30","Otros","10","18","9","35","0","0","9","35","10.25"
"9","2018","30","Otros","9","22","126","426","0","0","126","426","7.642857143"
"9","2018","30","Otros","15","27","62","66","0","0","62","66","1.422222222"
"9","2018","30","Otros","11","36","12","21","0","0","12","21","5.19047619"
"9","2018","30","Otros","5","5","3","3","0","0","3","3","3.65625"
"9","2018","30","Otros","2","29","17","38","20","62","37","100","3.28"
"9","2018","30","Hotel","9","22","153","153","2","2","155","155","2.555555556"
"9","2018","28","Otros","11","32","15","15","0","0","15","15","2.285714286"
"9","2018","30","Hotel","10","27","189","288","30","45","219","333","1"
"9","2018","30","Otros","16","27","68","119","0","0","68","119","2"
"9","2018","30","Hotel","16","20","45","156","0","0","45","156","1"
"9","2018","30","Otros","11","15","27","61","3","12","30","73","2.357142857"
"9","2018","30","Otros","7","17","148","693","0","0","148","693","3"
"9","2018","30","Otros","5","8","11","11","0","0","11","11","5"
"9","2018","27","Hotel","13","33","56","81","0","0","56","81","2"
"9","2018","30","Otros","5","9","64","101","8","8","72","109","4.045454545"
"9","2018","30","Otros","10","27","60","109","9","15","69","124","4.84"
"9","2018","30","Otros","9","22","58","138","0","0","58","138","7.642857143"
"9","2018","30","Otros","16","40","33","73","2","4","35","77","28.14285714"
"9","2018","30","Hotel","16","40","84","125","18","36","102","161","1"
"9","2018","30","Otros","15","16","11","36","7","10","18","46","9"
"9","2018","30","Hotel","8","2","22","30","11","12","33","42","3"
"9","2018","30","Otros","8","3","144","267","4","4","148","271","10"
"9","2018","30","Otros","7","17","65","78","0","0","65","78","17.16666667"
"9","2018","30","Otros","16","20","104","203","0","0","104","203","3.076923077"
"9","2018","30","Otros","6","27","21","23","0","0","21","23","3.960088692"
"9","2018","30","Otros","12","35","71","177","84","176","155","353","3.5"
"9","2018","28","Otros","6","28","88","246","0","0","88","246","4.65"
"9","2018","30","Otros","6","28","355","692","6","14","361","706","4.65"
"9","2018","30","Hotel","8","34","134","308","23","30","157","338","2.571428571"
"9","2018","30","Hotel","16","20","1757","2325","7","15","1764","2340","1"
"9","2018","30","Hotel","2","6","166","504","0","0","166","504","2.2"
"9","2018","30","Hotel","7","27","50","750","0","0","50","750","4.166666667"
"9","2018","30","Hotel","10","23","4","32","0","0","4","32","4"
"9","2018","30","Hotel","9","26","46","74","16","24","62","98","1.5"
"9","2018","30","Otros","8","27","25","33","0","0","25","33","9.4"
"9","2018","30","Otros","10","27","49","49","1","1","50","50","4.84"
"9","2018","30","Otros","11","15","8","8","0","0","8","8","2.357142857"
"9","2018","30","Otros","16","20","67","114","0","0","67","114","3.076923077"
"9","2018","30","Otros","11","32","42","92","0","0","42","92","1"
"9","2018","30","Otros","16","27","87","87","0","0","87","87","13.81818182"
"9","2018","30","Otros","9","37","88","88","0","0","88","88","4.5"
"9","2018","30","Hotel","2","29","8","32","36","212","44","244","2"
"9","2018","30","Hotel","2","1","32","142","0","0","32","142","6.4"
"9","2018","30","Otros","5","8","11","11","2","2","13","13","5"
"9","2018","30","Otros","9","37","39","86","6","6","45","92","4.5"
"9","2018","30","Otros","7","38","190","353","0","0","190","353","2.75"
"9","2018","30","Otros","11","32","58","114","2","6","60","120","1"
"9","2018","30","Otros","4","39","66","66","0","0","66","66","2.222222222"
"9","2018","30","Hotel","11","36","57","132","10","22","67","154","2.375"
"9","2018","30","Otros","10","23","44","70","0","0","44","70","7"
"9","2018","30","Hotel","15","16","1169","3108","34","86","1203","3194","2"
"9","2018","30","Otros","2","29","37","60","53","73","90","133","3.28"
"9","2018","30","Hotel","6","12","680","861","40","50","720","911","1"
"9","2018","30","Hotel","11","15","25","204","0","0","25","204","1"
"9","2018","30","Otros","4","21","254","589","1","1","255","590","1"
"9","2018","30","Otros","16","19","56","131","0","0","56","131","10.26315789"
"9","2018","30","","9","37","310","350","6","12","316","362","1"
"9","2018","30","Otros","10","27","53","107","21","42","74","149","4.84"
"9","2018","30","Otros","11","15","45","45","0","0","45","45","2.357142857"
"9","2018","30","Hotel","2","29","54","162","46","140","100","302","2"
"9","2018","30","Hotel","10","27","178","264","59","138","237","402","1"
"9","2018","30","Hotel","11","36","76","276","0","0","76","276","2.375"
"9","2018","30","Hotel","9","37","69","116","6","8","75","124","3.4"
"9","2018","30","Otros","14","27","2","6","2","2","4","8","11.83333333"
"9","2018","30","Otros","7","38","155","407","0","0","155","407","1"
"9","2018","30","Hotel","2","1","15","150","0","0","15","150","6.4"
"9","2018","30","Otros","2","29","19","51","25","79","44","130","3.28"
"9","2018","30","Hotel","6","27","5","9","0","0","5","9","3"
"9","2018","30","Otros","5","9","14","75","0","0","14","75","4.045454545"
"9","2018","30","Hotel","2","1","14","30","0","0","14","30","6.4"
"9","2018","30","Hotel","3","7","9","23","17","23","26","46","1"
"9","2018","30","Otros","7","38","23","23","12","12","35","35","2.75"
"9","2018","30","Otros","7","17","19","33","0","0","19","33","17.16666667"
"9","2018","30","Otros","7","38","44","101","0","0","44","101","2.75"
"9","2018","30","Otros","4","21","13","13","0","0","13","13","4.833333333"
"9","2018","30","Otros","2","1","56","56","1","1","57","57","5.5"
"9","2018","30","Otros","12","35","47","71","2","2","49","73","3.5"
"9","2018","30","Otros","12","35","21","36","18","25","39","61","3.5"
"9","2018","30","Otros","4","21","54","62","2","4","56","66","4.833333333"
"9","2018","30","Otros","12","24","4","8","2","8","6","16","9.2"
"9","2018","30","Otros","16","19","6","8","0","0","6","8","10.26315789"
"9","2018","30","Otros","10","11","129","145","0","0","129","145","11.76470588"
"9","2018","30","Otros","16","19","63","94","0","0","63","94","10.26315789"
"9","2018","30","Hotel","2","27","91","256","1","3","92","259","1"
"9","2018","30","Otros","6","28","6","6","0","0","6","6","4.65"
"9","2018","30","Otros","10","18","170","466","14","50","184","516","10.25"
"9","2018","30","Otros","14","27","55","138","0","0","55","138","11.83333333"
"9","2018","30","Hotel","11","32","53","83","0","0","53","83","1"
"9","2018","30","Otros","8","27","8","8","2","2","10","10","9.4"
"9","2018","30","Hotel","12","35","34","83","7","14","41","97","1.727272727"
"9","2018","30","Otros","13","14","25","26","0","0","25","26","7.384615385"
"9","2018","30","Otros","11","36","35","71","0","0","35","71","5.19047619"
"9","2018","30","Otros","16","20","28","42","2","2","30","44","3.076923077"
"9","2018","30","Hotel","14","31","222","366","1351","1774","1573","2140","7.8"
"9","2018","30","Otros","2","27","199","316","11","11","210","327","3.2"
"9","2018","30","","16","40","206","705","0","0","206","705","3.055555556"
"9","2018","30","Hotel","11","36","83","109","2","4","85","113","2.375"
"9","2018","30","Hotel","9","22","45","59","0","0","45","59","2.555555556"
"9","2018","30","Otros","2","29","15","32","19","32","34","64","3.28"
"9","2018","30","Hotel","10","27","89","98","46","64","135","162","2.25"
"9","2018","30","Otros","10","27","4","6","0","0","4","6","4.84"
"9","2018","30","Hotel","16","19","23","34","0","0","23","34","4"
"9","2018","21","Otros","2","6","7","33","0","0","7","33","5"
"9","2018","30","Otros","7","27","91","175","0","0","91","175","4.833333333"
"9","2018","30","Hotel","2","6","101","758","0","0","101","758","5.5"
"9","2018","30","Hotel","6","28","2","2","4","4","6","6","2.4"
"9","2018","30","Otros","1","10","175","765","0","0","175","765","3.851851852"
"9","2018","30","Hotel","6","27","25","28","0","0","25","28","3"
"9","2018","30","Otros","5","5","24","45","1","1","25","46","3.65625"
"9","2018","21","Otros","12","24","34","46","10","12","44","58","9.2"
"9","2018","30","Hotel","8","2","78","212","14","36","92","248","3"
"9","2018","30","Hotel","11","32","14","40","2","3","16","43","1"
"9","2018","30","Otros","10","18","8","18","13","33","21","51","10.25"
"9","2018","30","Hotel","9","37","6","12","2","10","8","22","3.4"
"9","2018","30","Otros","5","9","12","21","1","1","13","22","4.045454545"
"9","2018","30","Otros","12","24","9","13","2","4","11","17","9.2"
"9","2018","30","Otros","9","22","30","49","0","0","30","49","7.642857143"
"9","2018","30","Otros","2","29","43","86","17","57","60","143","3.28"
"9","2018","30","Otros","10","23","22","82","0","0","22","82","7"
"9","2018","30","Otros","10","27","34","116","4","8","38","124","4.84"
"9","2018","30","Otros","10","11","50","50","0","0","50","50","11.76470588"
"9","2018","30","Otros","8","3","51","167","0","0","51","167","10"
"9","2018","30","Otros","14","31","136","189","277","491","413","680","20.2"
"9","2018","30","Otros","2","29","250","598","112","352","362","950","3.28"
"9","2018","0","Otros","1","25","0","0","0","0","0","0","1"
"9","2018","30","Hotel","15","16","25","49","0","0","25","49","7.8"
"9","2018","30","Hotel","15","27","159","260","26","64","185","324","1"
"9","2018","30","Otros","10","27","13","222","7","23","20","245","4.84"
"9","2018","30","Otros","10","23","44","44","0","0","44","44","7"
"9","2018","30","Otros","6","27","17","77","0","0","17","77","3.960088692"
"9","2018","30","Otros","16","40","82","95","0","0","82","95","28.14285714"
"9","2018","30","Otros","11","36","148","226","0","0","148","226","5.19047619"
"9","2018","30","Otros","8","34","83","105","0","0","83","105","5.75"
"9","2018","30","Otros","6","12","34","123","0","0","34","123","1.825657895"
"9","2018","30","Otros","1","10","163","282","0","0","163","282","3.851851852"
"9","2018","30","Hotel","4","21","146","207","0","0","146","207","3"
"9","2018","30","Hotel","11","36","68","181","11","31","79","212","2.375"
"9","2018","30","Otros","5","8","128","156","18","22","146","178","5"
"9","2018","30","Hotel","7","17","71","74","0","0","71","74","10"
"9","2018","22","Hotel","11","36","212","259","2","4","214","263","1"
"9","2018","30","Otros","9","30","57","87","0","0","57","87","2.333333333"
"9","2018","30","Hotel","12","35","81","154","86","171","167","325","1.727272727"
"9","2018","30","Otros","2","1","111","303","8","8","119","311","5.5"
"9","2018","30","Hotel","1","25","106","110","0","0","106","110","1"
"9","2018","30","Otros","5","5","4","120","0","0","4","120","3.65625"
"9","2018","30","Otros","2","29","27","88","58","145","85","233","3.28"
"9","2018","30","Hotel","2","6","19","30","7","12","26","42","5.5"
"9","2018","30","Otros","7","17","11","145","0","0","11","145","17.16666667"
"9","2018","30","Hotel","8","2","4","7","0","0","4","7","3"
"9","2018","30","Hotel","13","14","12","20","2","2","14","22","1"
"9","2018","30","Otros","7","38","42","152","0","0","42","152","2.75"
"9","2018","30","Hotel","14","31","4","7","61","209","65","216","24"
"9","2018","30","Hotel","5","5","36","45","4","6","40","51","2.142857143"
"9","2018","30","Otros","2","27","1","2","2","4","3","6","3.2"
"9","2018","30","Otros","5","8","15","15","1","1","16","16","5"
"9","2018","30","Otros","3","4","60","267","0","0","60","267","12.2"
"9","2018","30","Otros","13","14","6","6","0","0","6","6","7.384615385"
"9","2018","30","Otros","9","37","32","57","0","0","32","57","4.5"
"9","2018","30","Hotel","10","23","669","866","14","23","683","889","1"
"9","2018","30","Otros","11","32","9","9","0","0","9","9","2.285714286"
"9","2018","30","Otros","11","15","7","20","0","0","7","20","2.357142857"
"9","2018","30","Otros","8","3","31","78","0","0","31","78","10"
"9","2018","30","Otros","16","20","63","233","0","0","63","233","3.076923077"
"9","2018","30","Otros","8","3","33","66","0","0","33","66","10"
"9","2018","30","Otros","16","27","42","84","0","0","42","84","2"
"9","2018","30","Hotel","16","19","16","20","2","2","18","22","4"
"9","2018","30","Hotel","16","27","16","47","0","0","16","47","5.857142857"
"9","2018","30","Otros","9","26","20","41","0","0","20","41","3.888888889"
"9","2018","30","Otros","5","5","15","18","0","0","15","18","3.65625"
"9","2018","30","Otros","14","27","38","38","3","12","41","50","11.83333333"
"9","2018","30","Hotel","5","5","1","1","0","0","1","1","2.142857143"
"9","2018","30","Hotel","12","24","95","294","21","62","116","356","3"
"9","2018","30","Otros","16","27","17","72","1","8","18","80","13.81818182"
"9","2018","30","Hotel","14","31","3","3","128","342","131","345","1"
"9","2018","30","Otros","8","3","40","102","4","8","44","110","1"
"9","2018","30","Otros","13","27","156","189","0","0","156","189","12.2"
"9","2018","30","Hotel","16","40","27","28","8","12","35","40","16.33333333"
"9","2018","30","Otros","11","36","78","195","0","0","78","195","1"
"9","2018","30","Otros","10","27","8","37","2","4","10","41","4.84"
"9","2018","30","Otros","9","22","23","35","0","0","23","35","7.642857143"
"9","2018","30","Hotel","5","5","41","55","5","10","46","65","2.142857143"
"9","2018","30","Otros","2","29","64","213","53","151","117","364","3.28"
"9","2018","26","Otros","2","29","20","29","0","0","20","29","3.28"
"9","2018","30","Hotel","13","14","47","47","1","1","48","48","1"
"9","2018","30","Otros","1","25","6","6","0","0","6","6","2.384615385"
"9","2018","30","Otros","2","1","16","16","2","2","18","18","5.5"
"9","2018","30","Hotel","12","27","26","45","1","1","27","46","1"
"9","2018","30","Hotel","13","27","6","6","0","0","6","6","4.2"
"9","2018","30","Otros","6","12","99","263","6","18","105","281","1.825657895"
"9","2018","30","Otros","6","27","10","22","0","0","10","22","3.960088692"
"9","2018","30","Otros","1","25","12","16","0","0","12","16","2.384615385"
"9","2018","30","Hotel","6","28","20","56","2","2","22","58","2.583333333"
"9","2018","30","Otros","5","5","24","45","1","1","25","46","3.65625"
"9","2018","30","Otros","5","9","2","2","2","2","4","4","4.045454545"
"9","2018","30","Otros","5","8","5","7","0","0","5","7","5"
"9","2018","30","Hotel","2","29","205","559","75","183","280","742","1"
"9","2018","30","Otros","5","5","83","132","5","10","88","142","3.65625"
"9","2018","30","Hotel","9","26","8","16","0","0","8","16","1.5"
"9","2018","30","Otros","9","30","4","32","0","0","4","32","2.333333333"
"9","2018","30","Otros","11","15","29","33","0","0","29","33","2.357142857"
"9","2018","30","Hotel","16","27","4","4","0","0","4","4","5.857142857"
"9","2018","30","Otros","9","30","30","56","5","10","35","66","2.333333333"
"9","2018","30","Otros","2","29","45","115","19","64","64","179","3.28"
"9","2018","30","Otros","7","38","53","129","8","8","61","137","2.75"
"9","2018","30","Otros","4","21","31","122","0","0","31","122","4.833333333"
"9","2018","30","Otros","9","22","21","30","0","0","21","30","7.642857143"
"9","2018","30","Otros","9","22","76","118","0","0","76","118","7.642857143"
"9","2018","30","Otros","13","27","15","38","0","0","15","38","12.2"
"9","2018","30","Hotel","11","36","1681","1734","39","80","1720","1814","1"
"9","2018","30","Otros","13","33","32","73","0","0","32","73","5.125"
"9","2018","30","Otros","11","36","32","71","16","36","48","107","5.19047619"
"9","2018","30","Otros","12","35","42","114","37","105","79","219","3.5"
"9","2018","30","Otros","12","35","21","36","18","25","39","61","3.5"
"9","2018","30","Otros","10","11","22","31","4","4","26","35","11.76470588"
"9","2018","30","Otros","12","24","8","40","0","0","8","40","9.2"
"9","2018","30","Otros","16","20","34","92","0","0","34","92","3.076923077"
"9","2018","30","Hotel","7","27","120","154","0","0","120","154","1"
"9","2018","30","Otros","6","12","10","15","1","10","11","25","1.825657895"
"9","2018","30","Otros","11","32","56","140","21","53","77","193","2.285714286"
"9","2018","30","Otros","6","28","95","185","0","0","95","185","4.65"
"9","2018","30","Otros","8","34","1","1","0","0","1","1","5.75"
"9","2018","30","Otros","16","27","6","8","0","0","6","8","13.81818182"
"9","2018","30","Otros","10","11","6","6","0","0","6","6","11.76470588"
"9","2018","30","Otros","1","10","28","88","0","0","28","88","3.851851852"
"9","2018","30","Otros","8","3","75","298","1","2","76","300","10"
"9","2018","30","Hotel","16","20","106","170","11","18","117","188","1"
"9","2018","30","Hotel","11","32","27","46","9","13","36","59","1"
"9","2018","30","Otros","8","27","12","57","0","0","12","57","9.4"
"9","2018","30","Otros","12","27","21","89","2","2","23","91","3.428571429"
"9","2018","30","Otros","1","10","66","194","0","0","66","194","3.851851852"
"9","2018","26","Otros","1","10","18","75","0","0","18","75","3.851851852"
"9","2018","30","Otros","5","8","25","25","4","4","29","29","5"
"9","2018","30","Otros","5","8","12","12","2","2","14","14","5"
"9","2018","30","Hotel","9","26","42","50","6","9","48","59","1.5"
"9","2018","30","Hotel","13","14","7","13","0","0","7","13","1"
"9","2018","30","Otros","10","18","62","177","18","43","80","220","10.25"
"9","2018","30","Otros","8","2","38","41","9","10","47","51","6.428571429"
"9","2018","30","Otros","7","27","25","39","0","0","25","39","4.833333333"
"9","2018","30","Otros","2","29","21","30","11","15","32","45","3.28"
"9","2018","10","Otros","11","32","10","16","4","6","14","22","2.285714286"
"9","2018","30","Otros","9","30","27","45","0","0","27","45","2.333333333"
"9","2018","30","Otros","2","29","20","63","0","0","20","63","3.28"
"9","2018","30","Otros","5","5","9","15","0","0","9","15","3.65625"
"9","2018","30","Otros","11","15","9","9","0","0","9","9","2.357142857"
"9","2018","30","Otros","10","23","3","3","0","0","3","3","7"
"9","2018","30","Otros","11","36","70","117","5","5","75","122","5.19047619"
"9","2018","30","Hotel","3","7","49","98","56","91","105","189","1"
"9","2018","30","Otros","10","27","1","1","0","0","1","1","4.84"
"9","2018","30","Otros","2","27","6","6","0","0","6","6","3.2"
"9","2018","30","Otros","12","35","0","0","1","1","1","1","3.5"
"9","2018","30","Otros","10","27","18","34","2","2","20","36","4.84"
"9","2018","30","Otros","16","40","49","118","161","393","210","511","28.14285714"
"9","2018","30","Hotel","8","3","267","497","43","80","310","577","4.111111111"
"9","2018","30","Otros","9","22","58","93","0","0","58","93","7.642857143"
"9","2018","30","Otros","13","14","5","6","0","0","5","6","7.384615385"
"9","2018","30","Otros","5","9","9","13","0","0","9","13","4.045454545"
"9","2018","30","Otros","10","18","60","73","8","12","68","85","10.25"
"9","2018","30","Otros","1","25","247","435","0","0","247","435","2.384615385"
"9","2018","30","Otros","9","22","35","72","0","0","35","72","7.642857143"
"9","2018","30","Otros","10","27","14","149","0","0","14","149","4.84"
"9","2018","30","Otros","16","20","41","57","0","0","41","57","3.076923077"
"9","2018","30","Hotel","7","17","141","356","0","0","141","356","10"
"9","2018","30","Otros","15","27","23","23","0","0","23","23","1.422222222"
"9","2018","30","Otros","12","35","43","67","50","51","93","118","3.5"
"9","2018","30","Otros","12","35","37","43","52","91","89","134","3.5"
"9","2018","30","Otros","3","7","8","9","0","0","8","9","2"
"9","2018","30","Otros","10","11","4","6","2","2","6","8","11.76470588"
"9","2018","30","Otros","12","24","8","11","0","0","8","11","9.2"
"9","2018","30","Otros","10","23","13","14","0","0","13","14","7"
"9","2018","30","Otros","7","27","8","13","0","0","8","13","4.833333333"
"9","2018","30","","10","18","7","9","9","9","16","18","1"
"9","2018","30","Otros","16","27","0","0","1","1","1","1","13.81818182"
"9","2018","30","Hotel","2","29","17","61","7","35","24","96","1"
"9","2018","30","Otros","14","27","43","53","5","15","48","68","11.83333333"
"9","2018","30","Otros","11","32","89","143","0","0","89","143","2.285714286"
"9","2018","30","Otros","16","19","84","198","0","0","84","198","1"
"9","2018","30","Otros","16","27","30","59","0","0","30","59","13.81818182"
"9","2018","30","Otros","8","3","44","240","5","15","49","255","10"
"9","2018","30","Otros","16","27","66","194","0","0","66","194","13.81818182"
"9","2018","30","Otros","16","20","42","206","0","0","42","206","3.076923077"
"9","2018","30","Otros","16","40","150","305","20","37","170","342","28.14285714"
"9","2018","30","Hotel","11","36","56","157","1","1","57","158","2.375"
"9","2018","30","Otros","1","10","74","172","0","0","74","172","3.851851852"
"9","2018","30","Otros","7","38","126","373","5","15","131","388","2.75"
"9","2018","30","Otros","13","14","2","8","0","0","2","8","7.384615385"
"9","2018","30","Otros","9","30","37","40","0","0","37","40","2.333333333"
"9","2018","30","Otros","13","27","8","13","0","0","8","13","12.2"
"9","2018","30","Otros","10","27","80","80","0","0","80","80","4.84"
"9","2018","30","Otros","1","25","53","70","8","8","61","78","2.384615385"
"9","2018","30","Otros","9","26","19","189","0","0","19","189","3.888888889"
"9","2018","30","Otros","10","18","18","50","5","14","23","64","10.25"
"9","2018","30","Otros","2","29","54","146","8","20","62","166","3.28"
"9","2018","30","Otros","1","25","28","68","0","0","28","68","2.384615385"
"9","2018","30","Otros","5","9","6","180","0","0","6","180","4.045454545"
"9","2018","30","Otros","5","9","8","11","1","1","9","12","4.045454545"
"9","2018","30","Hotel","9","37","26","67","0","0","26","67","3.4"
"9","2018","30","Hotel","7","38","32","36","12","12","44","48","1"
"9","2018","30","Otros","7","27","41","52","0","0","41","52","4.833333333"
"9","2018","30","Otros","5","9","12","21","1","1","13","22","4.045454545"
"9","2018","30","Otros","10","27","3","3","7","7","10","10","4.84"
"9","2018","30","Otros","7","27","18","18","0","0","18","18","4.833333333"
"9","2018","30","Otros","16","40","64","89","2","4","66","93","28.14285714"
"9","2018","30","Otros","10","23","23","23","0","0","23","23","7"
"9","2018","30","Otros","15","16","82","232","13","27","95","259","9"
"9","2018","30","Otros","3","7","17","33","38","99","55","132","2"
"9","2018","30","Otros","7","17","22","51","0","0","22","51","17.16666667"
"9","2018","30","Otros","8","27","30","94","2","2","32","96","9.4"
"9","2018","30","Otros","9","22","79","178","0","0","79","178","7.642857143"
"9","2018","30","Otros","16","19","13","26","0","0","13","26","10.26315789"
"9","2018","0","","15","27","0","0","0","0","0","0","1"
"9","2018","30","Hotel","10","11","9","9","3","3","12","12","5.666666667"
"9","2018","30","Otros","2","27","14","159","7","7","21","166","3.2"
"9","2018","30","Otros","8","2","67","127","28","50","95","177","6.428571429"
"9","2018","30","Otros","5","5","5","6","0","0","5","6","3.65625"
"9","2018","30","Otros","12","35","1","1","0","0","1","1","3.5"
"9","2018","20","Otros","8","3","11","44","2","8","13","52","10"
"9","2018","30","Otros","12","24","33","66","21","36","54","102","9.2"
"9","2018","30","Otros","11","32","19","107","0","0","19","107","2.285714286"
"9","2018","30","Otros","10","27","55","112","27","69","82","181","4.84"
"9","2018","30","Otros","11","15","55","132","0","0","55","132","2.357142857"
"9","2018","30","Otros","5","8","16","30","0","0","16","30","5"
"9","2018","30","Otros","14","27","13","13","2","2","15","15","11.83333333"
"9","2018","30","Otros","13","27","135","176","3","6","138","182","12.2"
"9","2018","30","Hotel","10","18","64","66","121","121","185","187","3.2"
"9","2018","30","Otros","10","27","24","45","2","2","26","47","4.84"
"9","2018","30","Otros","11","32","33","40","0","0","33","40","1"
"9","2018","30","Otros","9","37","25","77","0","0","25","77","4.5"
"9","2018","30","Otros","12","35","18","18","26","26","44","44","3.5"
"9","2018","30","Otros","8","34","183","298","28","43","211","341","5.75"
"9","2018","30","Hotel","16","40","18","22","33","53","51","75","16.33333333"
"9","2018","30","Hotel","10","11","75","337","10","28","85","365","5.666666667"
"9","2018","30","Otros","7","27","17","45","0","0","17","45","4.833333333"
"9","2018","30","Hotel","7","38","10","20","0","0","10","20","1"
"9","2018","30","Otros","6","27","7","16","0","0","7","16","3.960088692"
"9","2018","30","Otros","1","10","34","100","0","0","34","100","3.851851852"
"9","2018","30","Otros","1","25","67","173","0","0","67","173","1"
"9","2018","30","Otros","1","25","14","22","3","6","17","28","2.384615385"
"9","2018","30","Otros","6","27","15","184","0","0","15","184","3.960088692"
"9","2018","30","Otros","6","27","68","168","0","0","68","168","3.960088692"
"9","2018","10","Otros","5","5","2","6","0","0","2","6","3.65625"
"9","2018","30","Otros","5","5","10","30","0","0","10","30","3.65625"
"9","2018","30","Otros","3","4","9","54","2","11","11","65","12.2"
"9","2018","30","Otros","10","23","2","2","0","0","2","2","7"
"9","2018","30","Otros","8","3","11","55","0","0","11","55","10"
"9","2018","30","Otros","5","5","11","24","0","0","11","24","3.65625"
"9","2018","30","Otros","5","8","15","15","0","0","15","15","5"
"9","2018","30","Otros","1","10","42","86","0","0","42","86","3.851851852"
"9","2018","30","Otros","16","19","19","80","0","0","19","80","10.26315789"
"9","2018","30","Otros","11","15","31","63","0","0","31","63","2.357142857"
"9","2018","30","Otros","7","38","44","57","0","0","44","57","2.75"
"9","2018","30","Otros","11","32","154","261","0","0","154","261","2.285714286"
"9","2018","30","Otros","8","2","45","141","0","0","45","141","6.428571429"
"9","2018","30","Otros","10","27","27","42","2","2","29","44","4.84"
"9","2018","30","Otros","6","27","12","24","0","0","12","24","3.960088692"
"9","2018","30","Otros","11","32","42","74","2","2","44","76","2.285714286"
"9","2018","30","Otros","8","34","6","7","0","0","6","7","5.75"
"9","2018","30","Otros","11","32","11","14","2","3","13","17","2.285714286"
"9","2018","30","Otros","10","11","10","31","0","0","10","31","11.76470588"
"9","2018","30","Otros","11","32","19","21","4","4","23","25","2.285714286"
"9","2018","30","Otros","14","31","0","0","5","7","5","7","20.2"
"9","2018","30","Hotel","14","31","144","223","1251","2491","1395","2714","17.4"
"9","2018","30","Otros","11","36","183","356","0","0","183","356","5.19047619"
"9","2018","30","Hotel","15","16","735","1563","151","318","886","1881","2"
"9","2018","30","Otros","15","27","31","69","3","9","34","78","1.422222222"
"9","2018","30","Otros","5","5","13","23","0","0","13","23","3.65625"
"9","2018","30","Otros","8","34","9","9","0","0","9","9","5.75"
"9","2018","30","Otros","7","27","30","83","0","0","30","83","4.833333333"
"9","2018","30","Otros","12","35","21","36","18","25","39","61","3.5"
"9","2018","30","Otros","5","5","48","77","0","0","48","77","3.65625"
"9","2018","30","Otros","10","11","3","3","0","0","3","3","11.76470588"
"9","2018","30","Otros","10","11","2","2","0","0","2","2","11.76470588"
"9","2018","30","Otros","9","30","6","90","0","0","6","90","2.333333333"
"9","2018","30","Otros","8","2","48","179","0","0","48","179","6.428571429"
"9","2018","30","Otros","10","27","74","140","2","2","76","142","4.84"
"9","2018","30","Otros","5","9","12","21","1","1","13","22","4.045454545"
"9","2018","30","Otros","6","27","10","30","0","0","10","30","3.960088692"
"9","2018","30","Otros","1","10","66","149","22","66","88","215","3.851851852"
"9","2018","30","Otros","1","10","49","159","0","0","49","159","3.851851852"
"9","2018","30","Otros","6","27","12","12","0","0","12","12","3.960088692"
"9","2018","30","Otros","6","12","4","30","0","0","4","30","1.825657895"
"9","2018","30","Otros","1","10","38","100","0","0","38","100","3.851851852"
"9","2018","5","Otros","1","10","15","35","0","0","15","35","3.851851852"
"9","2018","30","Otros","6","27","4","8","0","0","4","8","3.960088692"
"9","2018","30","Otros","6","12","106","150","0","0","106","150","1.825657895"
"9","2018","30","Otros","1","10","16","21","0","0","16","21","3.851851852"
"9","2018","30","Hotel","1","25","26","88","0","0","26","88","1"
"9","2018","3","Otros","6","27","1","3","0","0","1","3","3.960088692"
"9","2018","30","Otros","5","9","23","28","3","6","26","34","4.045454545"
"9","2018","30","Otros","5","5","20","45","1","2","21","47","3.65625"
"9","2018","30","Otros","5","5","39","39","1","1","40","40","3.65625"
"9","2018","30","Otros","5","5","26","49","2","4","28","53","3.65625"
"9","2018","30","Otros","11","36","103","188","6","26","109","214","5.19047619"
"9","2018","30","Hotel","1","10","653","1661","134","669","787","2330","1"
"9","2018","30","Otros","5","9","12","21","1","1","13","22","4.045454545"
"9","2018","30","Otros","5","8","35","35","17","20","52","55","5"
"9","2018","0","Hotel","15","27","0","0","0","0","0","0","1"
"9","2018","22","Hotel","14","31","2","29","100","1469","102","1498","1"
"9","2018","30","Hotel","3","4","226","1441","9","43","235","1484","3"
"9","2018","30","Otros","3","7","31","31","30","30","61","61","1"
"9","2018","30","Otros","7","38","77","222","0","0","77","222","2.75"
"9","2018","30","Hotel","10","27","38","46","25","38","63","84","1"
"9","2018","30","Hotel","12","35","1","1","27","33","28","34","1.727272727"
"9","2018","30","Hotel","10","27","3","13","0","0","3","13","2.25"
"9","2018","30","Hotel","7","17","433","845","36","72","469","917","4"
"9","2018","30","Hotel","16","19","10","12","0","0","10","12","4"
"9","2018","30","Hotel","2","6","383","785","0","0","383","785","2.2"
"9","2018","30","Otros","5","5","61","224","3","11","64","235","3.65625"
"9","2018","30","Otros","12","24","58","95","16","25","74","120","9.2"
"9","2018","30","Otros","5","8","24","36","12","32","36","68","5"
"9","2018","30","Otros","4","13","111","127","4","4","115","131","1"
"9","2018","30","Otros","10","11","72","72","0","0","72","72","11.76470588"
"9","2018","30","Otros","12","35","66","97","69","99","135","196","3.5"
"9","2018","30","Otros","10","23","61","61","2","2","63","63","7"
"9","2018","30","Otros","11","36","469","1058","43","80","512","1138","5.19047619"
"9","2018","30","Otros","12","35","39","64","8","9","47","73","3.5"
"9","2018","30","Otros","11","36","37","64","0","0","37","64","5.19047619"
"9","2018","30","Otros","8","2","79","227","0","0","79","227","6.428571429"
"9","2018","30","Otros","9","30","88","152","0","0","88","152","2.333333333"
"9","2018","30","Otros","11","36","8","240","0","0","8","240","5.19047619"
"9","2018","30","Otros","1","10","16","20","0","0","16","20","3.851851852"
"9","2018","30","Otros","10","18","8","30","3","9","11","39","10.25"
"9","2018","30","Otros","7","27","13","41","2","2","15","43","4.833333333"
"9","2018","30","Otros","16","20","27","84","0","0","27","84","1"
"9","2018","30","Otros","9","22","30","49","0","0","30","49","7.642857143"
"9","2018","30","Otros","5","5","131","254","2","2","133","256","3.65625"
"9","2018","30","Otros","12","35","21","35","18","23","39","58","3.5"
"9","2018","30","Otros","10","11","2","2","0","0","2","2","11.76470588"
"9","2018","30","Otros","10","11","3","33","0","0","3","33","11.76470588"
"9","2018","23","Otros","5","9","24","43","2","2","26","45","4.045454545"
"9","2018","30","Otros","5","5","5","100","0","0","5","100","3.65625"
"9","2018","30","Otros","12","35","0","0","3","3","3","3","3.5"
"9","2018","30","Otros","7","38","121","282","20","52","141","334","2.75"
"9","2018","30","Hotel","12","35","3","6","17","27","20","33","1.727272727"
"9","2018","30","Otros","13","14","19","31","0","0","19","31","1"
"9","2018","30","Otros","5","5","1","10","0","0","1","10","3.65625"
"9","2018","22","Hotel","14","31","10","149","284","4185","294","4334","1"
"9","2018","30","Hotel","14","31","4","58","254","3789","258","3847","1"
"9","2018","30","Hotel","9","26","7","16","0","0","7","16","1.5"
"9","2018","30","Hotel","16","19","15","103","0","0","15","103","1"
"9","2018","30","Otros","16","19","56","76","2","2","58","78","10.26315789"
"9","2018","30","Otros","9","30","20","26","0","0","20","26","2.333333333"
"9","2018","30","Otros","16","19","6","12","0","0","6","12","10.26315789"
"9","2018","30","Otros","16","19","63","158","0","0","63","158","10.26315789"
"9","2018","30","Otros","9","26","41","123","0","0","41","123","3.888888889"
"9","2018","30","Otros","16","40","5","7","0","0","5","7","28.14285714"
"9","2018","30","Hotel","16","27","12","28","0","0","12","28","5.857142857"
"9","2018","30","Otros","16","19","15","26","0","0","15","26","10.26315789"
"9","2018","30","Otros","16","19","84","177","0","0","84","177","10.26315789"
"9","2018","30","","9","30","98","294","6","10","104","304","1"
"9","2018","30","Otros","16","19","30","40","0","0","30","40","10.26315789"
"9","2018","30","Otros","10","11","3","3","0","0","3","3","11.76470588"
"9","2018","30","Otros","11","36","30","30","0","0","30","30","5.19047619"
"9","2018","30","Otros","16","19","16","38","0","0","16","38","10.26315789"
"9","2018","30","Otros","16","19","252","412","4","8","256","420","1.333333333"
"9","2018","30","Otros","16","19","34","48","0","0","34","48","10.26315789"
"9","2018","30","Otros","10","18","22","57","16","32","38","89","10.25"
"9","2018","30","Otros","16","19","15","23","0","0","15","23","10.26315789"
"9","2018","30","Otros","16","19","1","1","0","0","1","1","1.333333333"
"9","2018","30","","9","26","267","1304","0","0","267","1304","1"
"9","2018","30","Otros","16","19","12","18","0","0","12","18","10.26315789"
"9","2018","30","Otros","16","19","29","39","0","0","29","39","10.26315789"
"9","2018","30","Hotel","8","2","395","1379","221","1324","616","2703","1"
"9","2018","30","Otros","1","10","4","12","0","0","4","12","3.851851852"
"9","2018","30","Otros","6","12","33","57","0","0","33","57","1.825657895"
"9","2018","30","Hotel","16","19","49","110","13","30","62","140","1"
"9","2018","30","Otros","3","7","8","8","14","28","22","36","2"
"9","2018","30","Hotel","2","6","697","2427","38","86","735","2513","1"
"9","2018","30","Hotel","3","4","478","692","60","120","538","812","2.6"
"9","2018","30","Hotel","16","40","1879","2983","650","1011","2529","3994","1"
"9","2018","30","Otros","16","27","71","79","2","4","73","83","13.81818182"
"9","2018","26","Hotel","6","28","170","280","12","17","182","297","2.4"
"9","2018","30","Hotel","8","34","1620","2224","139","265","1759","2489","1"
"9","2018","30","Otros","9","30","3","30","0","0","3","30","2.333333333"
"9","2018","30","Hotel","10","18","346","346","389","389","735","735","1"
"9","2018","30","Hotel","9","30","100","421","34","321","134","742","1"
"9","2018","30","Hotel","15","27","19","19","0","0","19","19","1"
"9","2018","30","Hotel","9","22","46","378","0","0","46","378","2.555555556"
"9","2018","22","Hotel","1","10","192","441","18","88","210","529","1"
"9","2018","0","","11","15","0","0","0","0","0","0","1"
"9","2018","30","Otros","6","12","5","5","0","0","5","5","1.825657895"
"9","2018","30","Hotel","15","27","30","900","0","0","30","900","1"
"9","2018","30","Otros","15","27","68","95","0","0","68","95","1.422222222"
"9","2018","30","Otros","15","27","9","14","0","0","9","14","1.422222222"
"9","2018","30","Otros","2","1","14","14","11","11","25","25","1"
"9","2018","30","Otros","12","24","7","42","1","1","8","43","9.2"
"9","2018","30","Otros","5","5","3","4","0","0","3","4","3.65625"
"9","2018","30","Hotel","7","27","204","285","0","0","204","285","1"
"9","2018","30","Otros","16","20","16","23","0","0","16","23","3.076923077"
"9","2018","0","","10","11","0","0","0","0","0","0","1"
"9","2018","30","Hotel","16","40","25","29","18","18","43","47","16.33333333"
"9","2018","30","Otros","12","35","13","21","0","0","13","21","3.5"
"9","2018","30","Hotel","6","27","14","16","0","0","14","16","3"
"9","2018","30","Otros","5","5","7","7","0","0","7","7","3.65625"
"9","2018","30","Hotel","6","27","53","59","0","0","53","59","3"
"9","2018","30","Otros","1","25","39","65","0","0","39","65","2.384615385"
"9","2018","0","Hotel","15","27","0","0","0","0","0","0","1"
"9","2018","30","Otros","5","9","42","58","7","12","49","70","4.045454545"
"9","2018","30","Hotel","15","27","110","200","10","10","120","210","1"
"9","2018","30","Hotel","5","9","23","29","0","0","23","29","1"
"9","2018","30","Hotel","8","34","47","85","3","47","50","132","2.571428571"
"9","2018","0","Hotel","15","27","0","0","0","0","0","0","1"
"9","2018","30","Hotel","6","27","152","574","0","0","152","574","3"
"9","2018","30","Otros","6","27","52","148","0","0","52","148","1"
"9","2018","30","Otros","12","27","1","1","17","17","18","18","3.428571429"
"9","2018","30","Hotel","2","27","478","510","287","296","765","806","1"
"9","2018","30","Hotel","2","6","113","666","0","0","113","666","1"
"9","2018","30","Otros","2","6","48","48","0","0","48","48","1"
"9","2018","30","Hotel","4","39","127","127","0","0","127","127","1"
"9","2018","30","Hotel","1","10","416","497","38","45","454","542","1"
"9","2018","30","Otros","5","8","7","7","2","3","9","10","5"
"9","2018","0","Hotel","13","33","0","0","0","0","0","0","1"
"9","2018","30","Hotel","13","33","120","258","43","76","163","334","1"
"9","2018","30","Otros","11","32","176","431","5","8","181","439","2.285714286"
"9","2018","30","Hotel","9","26","411","1109","34","210","445","1319","1"
"9","2018","30","Hotel","16","20","23","29","4","9","27","38","1"
"9","2018","30","Otros","16","20","35","57","0","0","35","57","3.076923077"
"9","2018","30","","16","40","778","1680","0","0","778","1680","1"
"9","2018","30","Hotel","15","16","1347","3053","148","301","1495","3354","1"
"9","2018","30","Hotel","16","27","0","0","0","0","0","0","1"
"9","2018","30","Hotel","5","9","14","21","4","8","18","29","1"
"9","2018","30","Otros","7","38","71","124","0","0","71","124","2.75"
"9","2018","30","Otros","2","6","223","3007","0","0","223","3007","1"
"9","2018","30","Otros","2","6","124","776","0","0","124","776","1"
"9","2018","30","Hotel","15","27","232","1044","9","9","241","1053","1"
"9","2018","30","Otros","7","38","87","219","0","0","87","219","2.75"
"9","2018","30","Otros","2","1","61","61","67","75","128","136","1"
"9","2018","30","Otros","8","3","72","326","1","2","73","328","10"
"9","2018","30","Otros","11","36","22","28","0","0","22","28","5.19047619"
"9","2018","30","Otros","16","20","42","90","0","0","42","90","3.076923077"
"9","2018","30","Otros","8","3","296","504","2","2","298","506","1"
"9","2018","30","Otros","4","39","69","133","0","0","69","133","2.222222222"
"9","2018","30","Otros","5","5","96","162","4","4","100","166","3.65625"
"9","2018","30","Otros","12","27","0","0","9","9","9","9","3.428571429"
"9","2018","30","Otros","7","27","11","48","0","0","11","48","1"
"9","2018","30","Hotel","2","6","468","938","16","27","484","965","1"
"9","2018","30","Hotel","14","27","270","1457","7","7","277","1464","1"
"9","2018","30","Hotel","16","19","545","870","0","0","545","870","1"
"9","2018","30","","2","1","40","40","0","0","40","40","1"
"9","2018","30","Hotel","2","27","122","255","4","8","126","263","1"
"9","2018","30","Otros","16","20","12","20","0","0","12","20","1"
"9","2018","0","Otros","13","14","0","0","0","0","0","0","1"
"9","2018","30","Hotel","11","36","119","159","4","5","123","164","2.375"
"9","2018","30","Otros","13","14","8","24","0","0","8","24","7.384615385"
"9","2018","30","Otros","12","27","10","24","0","0","10","24","3.428571429"
"9","2018","30","Hotel","2","6","307","346","4","6","311","352","2.2"
"9","2018","30","Otros","2","6","421","2113","0","0","421","2113","1"
"9","2018","30","Otros","10","27","8","104","0","0","8","104","4.84"
"9","2018","30","Otros","12","27","7","7","1","1","8","8","3.428571429"
"9","2018","30","Otros","13","14","17","110","0","0","17","110","7.384615385"
"9","2018","30","Otros","6","12","157","241","20","33","177","274","1.825657895"
"9","2018","30","Otros","2","6","125","2500","0","0","125","2500","1"
"9","2018","30","Hotel","12","35","18","23","0","0","18","23","1.727272727"
"9","2018","30","Otros","5","5","26","78","4","12","30","90","3.65625"
"9","2018","30","Otros","9","30","8","120","3","90","11","210","2.333333333"
"9","2018","0","Hotel","8","2","0","0","0","0","0","0","1"
"9","2018","30","Otros","9","30","15","41","0","0","15","41","2.333333333"
"9","2018","30","Hotel","15","27","41","41","5","5","46","46","1"
"9","2018","30","Hotel","3","7","40","40","8","8","48","48","1"
"9","2018","30","Otros","6","12","444","700","0","0","444","700","1.825657895"
"9","2018","30","Otros","12","27","18","55","5","8","23","63","3.428571429"
"9","2018","25","Otros","2","6","7","18","0","0","7","18","5"
"9","2018","30","Otros","6","27","4","4","0","0","4","4","3.960088692"
"9","2018","0","Hotel","10","11","0","0","0","0","0","0","1"
"9","2018","30","Otros","2","1","17","44","0","0","17","44","1"
"9","2018","30","Otros","11","36","18","18","8","8","26","26","5.19047619"
"9","2018","30","Hotel","11","32","0","0","0","0","0","0","1"
"9","2018","30","Otros","2","27","19","36","0","0","19","36","1"
"9","2018","30","Otros","12","27","7","9","0","0","7","9","3.428571429"
"9","2018","30","Hotel","8","2","44","93","12","34","56","127","3"
"9","2018","30","Hotel","16","20","21","21","0","0","21","21","1"
"9","2018","30","Otros","12","35","18","24","19","43","37","67","3.5"
"9","2018","30","Otros","13","14","32","72","0","0","32","72","1"
"9","2018","30","Otros","2","27","6","66","0","0","6","66","3.2"
"9","2018","30","Hotel","6","27","11","11","0","0","11","11","3"
"9","2018","30","Hotel","8","3","56","56","9","16","65","72","4.111111111"
"9","2018","30","Hotel","15","27","42","80","16","16","58","96","1"
"9","2018","30","Otros","8","3","10","30","0","0","10","30","10"
"9","2018","0","Hotel","16","20","0","0","0","0","0","0","1"
"9","2018","30","Hotel","6","28","113","153","0","0","113","153","2.4"
"9","2018","15","Otros","2","1","35","72","0","0","35","72","5.5"
"9","2018","30","Hotel","11","36","119","267","42","72","161","339","2.375"
"9","2018","30","Otros","4","13","22","230","2","2","24","232","1"
"9","2018","30","Otros","2","6","191","1337","0","0","191","1337","1"
"9","2018","30","Otros","8","34","146","226","14","24","160","250","5.75"
"9","2018","30","Hotel","11","15","0","0","0","0","0","0","1"
"9","2018","30","Otros","15","27","4","4","0","0","4","4","1.422222222"
"9","2018","30","Hotel","13","14","116","176","0","0","116","176","1"
"9","2018","30","Hotel","13","14","215","394","48","51","263","445","1"
"9","2018","0","Hotel","9","30","0","0","0","0","0","0","1"
"9","2018","30","Hotel","4","13","314","474","24","58","338","532","5.4"
"9","2018","30","Otros","6","27","5","14","0","0","5","14","3.960088692"
"9","2018","0","Hotel","15","27","0","0","0","0","0","0","1"
"9","2018","30","Hotel","2","29","7","36","51","183","58","219","2"
"9","2018","30","Hotel","13","33","12","18","1","1","13","19","2"
"9","2018","30","Hotel","12","35","23","24","7","8","30","32","1.727272727"
"9","2018","30","Hotel","13","14","186","315","5","16","191","331","1"
"9","2018","30","Otros","1","25","23","66","0","0","23","66","2.384615385"
"9","2018","30","Hotel","8","2","25","54","1","1","26","55","3"
"9","2018","30","Otros","4","39","69","113","0","0","69","113","2.222222222"
"9","2018","30","Otros","6","12","182","265","8","10","190","275","1.825657895"
"9","2018","30","Otros","13","33","28","99","6","14","34","113","5.125"
"9","2018","30","Hotel","4","13","163","329","4","8","167","337","5.4"
"9","2018","30","Hotel","7","27","209","306","4","5","213","311","4.166666667"
"9","2018","30","Hotel","4","13","501","1790","80","1561","581","3351","1"
"9","2018","0","","5","8","0","0","0","0","0","0","1"
"9","2018","30","Otros","8","2","20","70","0","0","20","70","6.428571429"
"9","2018","30","Otros","2","6","19","133","0","0","19","133","1"
"9","2018","30","","1","10","66","106","0","0","66","106","1"
"9","2018","30","Hotel","2","29","10","18","16","32","26","50","2"
"9","2018","30","","14","31","147","200","326","1423","473","1623","1"
"9","2018","30","Hotel","16","27","4150","12450","0","0","4150","12450","1"
"9","2018","30","Hotel","12","35","89","186","36","68","125","254","1.727272727"
"9","2018","30","","12","35","221","270","608","678","829","948","1"
"9","2018","30","","9","26","152","273","21","66","173","339","1"
"9","2018","30","Otros","11","32","177","189","0","0","177","189","2.285714286"
"9","2018","30","Otros","12","24","21","62","8","11","29","73","9.2"
"9","2018","30","Hotel","1","25","31","33","0","0","31","33","1"
"9","2018","30","Otros","11","32","19","50","0","0","19","50","2.285714286"
"9","2018","30","Hotel","16","19","28","33","2","2","30","35","4"
"9","2018","30","Otros","13","33","17","24","0","0","17","24","5.125"
"9","2018","30","Otros","16","27","33","91","1","5","34","96","13.81818182"
"9","2018","30","Otros","6","12","41","54","1","3","42","57","1.825657895"
"9","2018","30","Otros","2","29","27","51","2","6","29","57","3.28"
"9","2018","30","Hotel","14","27","370","434","37","71","407","505","1"
"9","2018","30","Otros","2","1","150","2100","0","0","150","2100","1"
"9","2018","30","Otros","11","32","28","28","0","0","28","28","2.285714286"
"9","2018","30","Otros","2","27","53","92","7","7","60","99","1"
"9","2018","30","Hotel","2","29","137","274","17","40","154","314","1"
"9","2018","30","Hotel","4","13","56","669","0","0","56","669","3.2"
"9","2018","30","Hotel","4","21","23","35","4","11","27","46","3"
"9","2018","30","Otros","7","27","64","151","1","1","65","152","4.833333333"
"9","2018","30","","3","4","42","91","25","45","67","136","1"
"9","2018","30","Hotel","6","27","12","27","7","9","19","36","3"
"9","2018","30","Otros","16","19","4","7","0","0","4","7","10.26315789"
"9","2018","30","Otros","11","32","7","7","0","0","7","7","2.285714286"
"9","2018","30","Otros","3","7","31","37","26","36","57","73","2"
"9","2018","30","Otros","5","5","38","41","0","0","38","41","3.65625"
"9","2018","24","Otros","15","27","749","960","0","0","749","960","1.422222222"
"9","2018","30","Otros","1","25","38","84","0","0","38","84","2.384615385"
"9","2018","30","","10","27","13","15","0","0","13","15","1"
"9","2018","30","Otros","2","29","67","123","94","174","161","297","3.28"
"9","2018","10","Otros","12","35","0","0","5","7","5","7","3.5"
"9","2018","30","Otros","16","19","73","162","0","0","73","162","10.26315789"
"9","2018","30","Otros","9","26","30","36","0","0","30","36","3.888888889"
"9","2018","30","Hotel","13","33","29","29","0","0","29","29","2"
"9","2018","19","Otros","11","32","17","36","0","0","17","36","2.285714286"
"9","2018","30","Otros","9","22","14","26","0","0","14","26","7.642857143"
"9","2018","30","Otros","6","27","10","34","0","0","10","34","3.960088692"
"9","2018","30","Otros","15","27","5","10","0","0","5","10","1.422222222"
"9","2018","30","Otros","11","32","57","57","4","4","61","61","2.285714286"
"9","2018","30","Otros","11","15","32","39","0","0","32","39","2.357142857"
"9","2018","30","Otros","9","37","8","120","0","0","8","120","4.5"
"9","2018","30","Otros","5","9","21","30","0","0","21","30","4.045454545"
"9","2018","30","Hotel","10","27","8","25","0","0","8","25","2.25"
"9","2018","30","Otros","6","28","28","126","2","2","30","128","4.65"
"9","2018","30","Otros","4","13","17","29","0","0","17","29","3.4"
"9","2018","30","Otros","2","1","30","600","0","0","30","600","1"
"9","2018","30","Otros","2","29","40","107","36","93","76","200","3.28"
"9","2018","30","Hotel","8","3","14","38","0","0","14","38","4.111111111"
"9","2018","30","Otros","16","19","13","25","0","0","13","25","1.333333333"
"9","2018","30","Otros","12","35","49","78","43","64","92","142","3.5"
"9","2018","30","Hotel","12","35","8","22","17","29","25","51","1.727272727"
"9","2018","30","Otros","12","35","5","11","8","10","13","21","3.5"
"9","2018","30","Otros","2","29","72","172","50","89","122","261","3.28"
"9","2018","30","Hotel","7","27","102","148","2","2","104","150","1"
"9","2018","30","Hotel","9","22","44","50","0","0","44","50","2.555555556"
"9","2018","30","Hotel","12","35","40","68","36","68","76","136","1.727272727"
"9","2018","30","Otros","15","16","118","237","9","9","127","246","2"
"9","2018","30","Hotel","15","27","3","5","0","0","3","5","1"
"9","2018","30","Otros","4","13","50","60","26","27","76","87","3.4"
"9","2018","30","Hotel","8","34","59","110","0","0","59","110","2.571428571"
"9","2018","30","Hotel","16","20","22","48","0","0","22","48","1"
"9","2018","30","Hotel","6","28","153","205","27","48","180","253","2.4"
"9","2018","30","Hotel","15","27","69","259","16","57","85","316","1"
"9","2018","30","Otros","12","35","221","464","36","80","257","544","3.5"
"9","2018","30","Otros","11","15","30","92","0","0","30","92","2.357142857"
"9","2018","30","Otros","11","15","33","102","2","2","35","104","2.357142857"
"9","2018","30","Otros","11","36","86","179","28","45","114","224","5.19047619"
"9","2018","30","Hotel","11","36","61","94","2","4","63","98","2.375"
"9","2018","30","Hotel","6","12","84","136","0","0","84","136","5"
"9","2018","30","Otros","8","3","45","61","5","9","50","70","10"
"9","2018","30","Otros","10","27","5","9","3","9","8","18","4.84"
"9","2018","30","Otros","8","3","7","33","0","0","7","33","10"
"9","2018","30","Otros","1","25","34","51","0","0","34","51","2.384615385"
"9","2018","30","Hotel","2","27","67","160","3","10","70","170","1"
"9","2018","30","Hotel","10","18","16","44","47","141","63","185","3.2"
"9","2018","30","Otros","11","32","80","232","2","6","82","238","1"
"9","2018","30","Hotel","1","10","2147","2911","152","256","2299","3167","1"
"9","2018","30","Otros","11","32","84","106","4","4","88","110","2.285714286"
"9","2018","30","Otros","2","27","48","720","0","0","48","720","1"
"9","2018","31","","12","24","90","170","100","126","190","296","1"
"9","2018","30","Hotel","16","27","620","892","16","16","636","908","5.857142857"
"9","2018","30","Hotel","7","38","58","70","0","0","58","70","1"
"9","2018","30","Hotel","6","12","1266","1266","29","29","1295","1295","1"
"10","2018","31","Hotel","14","31","1563","2211","9554","10699","11117","12910","1"
"10","2018","31","Hotel","14","31","800","1400","2586","7434","3386","8834","1"
"10","2018","31","Hotel","14","31","252","466","1416","3465","1668","3931","1"
"10","2018","0","Hotel","11","32","0","0","0","0","0","0","1"
"10","2018","31","Hotel","14","27","4129","7556","845","1547","4974","9103","1"
"10","2018","31","Otros","11","32","67","250","15","54","82","304","2.285714286"
"10","2018","31","Hotel","14","31","584","740","4387","5943","4971","6683","5.4"
"10","2018","31","Hotel","15","16","852","2711","75","335","927","3046","1"
"10","2018","31","Hotel","14","31","1382","1870","3591","5511","4973","7381","5.4"
"10","2018","31","Hotel","12","24","3733","4812","532","732","4265","5544","1"
"10","2018","31","Hotel","16","40","1772","2481","729","897","2501","3378","1"
"10","2018","31","Hotel","6","12","1158","2847","64","293","1222","3140","1"
"10","2018","31","Hotel","10","23","1523","1857","116","218","1639","2075","1"
"10","2018","31","Hotel","14","31","2021","4665","412","955","2433","5620","5.4"
"10","2018","31","Hotel","3","4","1386","2809","153","260","1539","3069","1"
"10","2018","31","","11","32","502","954","57","124","559","1078","1"
"10","2018","31","Hotel","6","12","661","1037","42","126","703","1163","1"
"10","2018","31","Hotel","6","12","3217","4440","710","823","3927","5263","1"
"10","2018","31","Hotel","9","26","3479","6186","98","170","3577","6356","1"
"10","2018","31","Hotel","2","1","786","2739","34","270","820","3009","1"
"10","2018","31","Hotel","9","26","1256","2941","204","1295","1460","4236","1"
"10","2018","31","Hotel","6","12","651","1216","61","230","712","1446","1"
"10","2018","31","Hotel","14","31","71","90","4425","8022","4496","8112","5.4"
"10","2018","31","Hotel","11","32","239","464","13","21","252","485","1"
"10","2018","31","Hotel","2","6","1690","2404","56","203","1746","2607","1"
"10","2018","31","Hotel","16","40","1849","3222","980","1452","2829","4674","1"
"10","2018","31","Hotel","14","27","319","529","2172","3603","2491","4132","1"
"10","2018","31","Otros","11","36","102","344","0","0","102","344","1"
"10","2018","31","Hotel","10","23","2210","2913","523","652","2733","3565","1"
"10","2018","31","Hotel","14","31","424","1430","707","3415","1131","4845","7.8"
"10","2018","31","Hotel","7","17","362","768","104","241","466","1009","1"
"10","2018","31","Hotel","2","1","2574","3695","0","0","2574","3695","2"
"10","2018","31","Hotel","2","1","1837","3096","226","571","2063","3667","2"
"10","2018","31","Hotel","4","13","1143","1923","82","133","1225","2056","1"
"10","2018","31","Hotel","2","1","1246","2560","135","409","1381","2969","2"
"10","2018","31","Hotel","10","27","1956","4435","623","1038","2579","5473","1"
"10","2018","31","Hotel","14","27","1610","2067","1336","1679","2946","3746","1"
"10","2018","31","Hotel","14","27","2172","2919","900","1977","3072","4896","1"
"10","2018","31","Hotel","6","12","2416","2468","112","250","2528","2718","1"
"10","2018","31","Hotel","6","12","2131","2789","759","853","2890","3642","1"
"10","2018","31","Hotel","13","27","2021","3888","0","0","2021","3888","1"
"10","2018","31","Hotel","14","31","112","632","723","2621","835","3253","7.8"
"10","2018","31","Hotel","6","12","1992","3458","407","708","2399","4166","1"
"10","2018","31","Hotel","16","27","1931","3642","64","118","1995","3760","1"
"10","2018","31","","10","27","27","31","2","2","29","33","1"
"10","2018","31","Hotel","10","18","1063","1500","774","1276","1837","2776","1"
"10","2018","31","Hotel","9","37","1873","2741","293","622","2166","3363","1"
"10","2018","31","Hotel","16","27","756","3022","0","0","756","3022","1"
"10","2018","31","Hotel","15","16","1359","2976","65","148","1424","3124","2"
"10","2018","31","Hotel","2","1","1442","2381","297","488","1739","2869","2"
"10","2018","31","Hotel","3","4","855","1887","160","226","1015","2113","1"
"10","2018","31","Hotel","16","40","1720","2523","985","1315","2705","3838","1"
"10","2018","31","Hotel","7","17","4154","4774","440","493","4594","5267","1"
"10","2018","31","Hotel","12","24","1215","2155","1244","1633","2459","3788","1"
"10","2018","31","Hotel","12","35","617","1020","1476","3272","2093","4292","1"
"10","2018","31","Hotel","2","6","468","2601","2","60","470","2661","1"
"10","2018","31","Hotel","13","33","1302","2057","95","151","1397","2208","1"
"10","2018","31","Hotel","10","27","1430","2204","317","466","1747","2670","1"
"10","2018","31","Hotel","10","23","1569","2918","322","597","1891","3515","1"
"10","2018","31","Hotel","11","36","1259","2501","101","238","1360","2739","1"
"10","2018","31","Hotel","8","34","1244","1906","162","239","1406","2145","1"
"10","2018","31","Hotel","2","6","786","1356","80","300","866","1656","1"
"10","2018","31","Hotel","14","31","943","1436","1394","1732","2337","3168","7.8"
"10","2018","31","Hotel","11","36","1924","2725","327","398","2251","3123","1"
"10","2018","31","","10","27","885","2257","74","311","959","2568","1"
"10","2018","31","Hotel","14","31","1439","2375","2327","6313","3766","8688","5.4"
"10","2018","31","Hotel","4","13","2626","2640","6","10","2632","2650","1"
"10","2018","31","Hotel","6","28","1547","1741","138","203","1685","1944","1"
"10","2018","31","Otros","14","31","7","10","3","6","10","16","2.8"
"10","2018","31","Otros","16","27","48","97","0","0","48","97","2"
"10","2018","31","Hotel","2","1","1507","1715","109","120","1616","1835","2"
"10","2018","31","Hotel","10","18","1213","1592","653","857","1866","2449","1"
"10","2018","31","Hotel","7","17","1265","1858","131","193","1396","2051","1"
"10","2018","31","Hotel","12","24","416","1098","266","1657","682","2755","1"
"10","2018","31","Hotel","10","18","1493","2517","433","659","1926","3176","1"
"10","2018","31","Hotel","2","1","2341","3158","13","20","2354","3178","1"
"10","2018","31","Hotel","10","18","631","1216","484","978","1115","2194","1"
"10","2018","31","Hotel","6","28","1619","2007","1027","1172","2646","3179","1"
"10","2018","31","Hotel","5","5","605","1888","64","158","669","2046","1"
"10","2018","31","Hotel","4","13","499","891","19","30","518","921","1"
"10","2018","31","Hotel","10","18","947","1528","467","752","1414","2280","1"
"10","2018","31","Hotel","16","40","1065","1502","96","119","1161","1621","1"
"10","2018","31","Hotel","8","3","1716","3218","465","916","2181","4134","1"
"10","2018","31","Hotel","15","16","1128","1594","119","184","1247","1778","2"
"10","2018","31","Hotel","14","31","151","310","343","1247","494","1557","7.8"
"10","2018","31","Hotel","13","33","797","1356","55","158","852","1514","1"
"10","2018","31","Hotel","15","16","421","1163","137","394","558","1557","2"
"10","2018","31","Otros","4","21","713","1125","0","0","713","1125","1"
"10","2018","31","Hotel","1","10","1031","1766","15","53","1046","1819","1"
"10","2018","31","Hotel","16","19","199","251","15","15","214","266","1"
"10","2018","31","Hotel","16","27","689","1516","5","11","694","1527","1"
"10","2018","31","Hotel","10","11","1041","1802","96","153","1137","1955","1"
"10","2018","31","Otros","10","23","477","993","1","2","478","995","1"
"10","2018","31","Hotel","12","35","128","286","236","500","364","786","1"
"10","2018","31","Hotel","11","36","887","1462","93","137","980","1599","1"
"10","2018","31","Hotel","14","31","93","98","1329","1684","1422","1782","17.4"
"10","2018","31","Hotel","10","18","359","640","731","2260","1090","2900","3.2"
"10","2018","31","Hotel","4","13","334","660","10","10","344","670","1"
"10","2018","31","Hotel","6","12","848","1703","59","119","907","1822","5"
"10","2018","31","Hotel","1","10","586","1236","27","34","613","1270","1"
"10","2018","31","Otros","5","5","229","411","21","42","250","453","3.65625"
"10","2018","31","Hotel","12","24","949","1052","858","1039","1807","2091","1"
"10","2018","31","Hotel","8","3","1180","2173","232","457","1412","2630","1"
"10","2018","31","Hotel","13","27","749","1042","0","0","749","1042","2.75"
"10","2018","31","Hotel","15","16","60","540","38","195","98","735","4"
"10","2018","31","Otros","15","16","249","759","112","451","361","1210","2"
"10","2018","31","Otros","16","20","230","323","0","0","230","323","1"
"10","2018","31","Hotel","3","4","799","1366","136","136","935","1502","1"
"10","2018","31","Hotel","11","36","112","121","0","0","112","121","1"
"10","2018","31","Hotel","2","6","273","1557","27","190","300","1747","1"
"10","2018","31","Hotel","8","34","872","1739","178","355","1050","2094","1"
"10","2018","31","Hotel","4","13","15","29","0","0","15","29","3.2"
"10","2018","31","Hotel","13","27","986","2112","0","0","986","2112","2.75"
"10","2018","31","Hotel","2","29","579","818","1627","2483","2206","3301","1"
"10","2018","31","Otros","11","36","78","209","3","7","81","216","1"
"10","2018","31","","10","11","10","10","2","2","12","12","1"
"10","2018","31","Hotel","4","13","992","1506","71","250","1063","1756","1"
"10","2018","31","Hotel","16","40","1932","2901","701","1052","2633","3953","5.666666667"
"10","2018","31","Hotel","10","23","707","1113","458","1223","1165","2336","2.8"
"10","2018","31","Hotel","8","34","521","676","112","170","633","846","1"
"10","2018","31","Hotel","5","5","584","1345","146","337","730","1682","1"
"10","2018","31","Hotel","3","4","73","153","56","105","129","258","3"
"10","2018","31","Hotel","9","26","66","475","33","101","99","576","1"
"10","2018","31","Hotel","8","34","629","676","65","85","694","761","1"
"10","2018","31","Hotel","7","17","388","660","90","209","478","869","4"
"10","2018","31","Hotel","4","13","257","462","26","65","283","527","3.2"
"10","2018","31","Hotel","12","35","17","70","426","1615","443","1685","1"
"10","2018","31","Hotel","16","40","3355","8125","483","872","3838","8997","1"
"10","2018","31","Hotel","9","26","547","1107","97","406","644","1513","1"
"10","2018","31","","6","27","249","525","108","109","357","634","1"
"10","2018","31","Hotel","9","26","408","690","0","0","408","690","1"
"10","2018","31","Hotel","4","13","61","87","14","18","75","105","3.2"
"10","2018","31","Hotel","6","28","488","599","21","21","509","620","1"
"10","2018","31","","2","29","80","168","796","2352","876","2520","1"
"10","2018","31","Hotel","13","33","1360","1648","137","157","1497","1805","1"
"10","2018","31","Hotel","8","3","1344","2692","84","161","1428","2853","1"
"10","2018","31","Hotel","14","27","1907","3448","568","625","2475","4073","1"
"10","2018","31","Hotel","16","40","453","906","10","20","463","926","5.666666667"
"10","2018","31","Hotel","12","24","324","521","135","218","459","739","1"
"10","2018","31","Hotel","10","18","693","1654","134","389","827","2043","3.2"
"10","2018","31","Otros","15","16","128","128","8","8","136","136","9"
"10","2018","31","Hotel","1","10","655","726","0","0","655","726","1"
"10","2018","31","Hotel","10","11","662","1223","109","275","771","1498","1"
"10","2018","31","Otros","1","10","84","420","0","0","84","420","3.851851852"
"10","2018","31","Otros","10","23","76","180","0","0","76","180","1"
"10","2018","31","Hotel","10","23","400","682","172","469","572","1151","2.8"
"10","2018","31","Hotel","6","12","322","900","4","16","326","916","5"
"10","2018","31","Hotel","6","27","93","226","12","32","105","258","3"
"10","2018","31","Hotel","10","23","572","995","193","432","765","1427","2.8"
"10","2018","31","","4","39","156","268","0","0","156","268","1"
"10","2018","31","Hotel","8","34","225","333","13","13","238","346","1"
"10","2018","31","Hotel","8","34","402","644","38","78","440","722","1"
"10","2018","31","Otros","4","39","29","53","0","0","29","53","2.222222222"
"10","2018","31","Otros","13","14","260","572","0","0","260","572","1"
"10","2018","31","Hotel","10","23","235","359","5","7","240","366","2.8"
"10","2018","31","Otros","13","14","596","2004","0","0","596","2004","1"
"10","2018","31","Hotel","12","24","356","381","545","552","901","933","1"
"10","2018","31","","1","25","0","0","0","0","0","0","1"
"10","2018","31","Hotel","15","27","480","713","40","48","520","761","1"
"10","2018","31","Hotel","12","35","102","188","322","629","424","817","1"
"10","2018","31","Hotel","16","40","297","659","136","463","433","1122","1"
"10","2018","31","Hotel","16","27","87","161","15","30","102","191","1"
"10","2018","31","Hotel","9","30","165","505","0","0","165","505","1"
"10","2018","31","Hotel","4","13","513","906","32","56","545","962","3.2"
"10","2018","31","Hotel","2","29","123","364","377","949","500","1313","1"
"10","2018","31","Hotel","16","20","28","47","147","261","175","308","1"
"10","2018","31","Hotel","5","5","539","808","34","62","573","870","1"
"10","2018","31","Hotel","13","33","573","906","62","125","635","1031","1"
"10","2018","31","Otros","16","19","157","183","0","0","157","183","1.333333333"
"10","2018","31","Hotel","12","24","206","469","126","331","332","800","1"
"10","2018","31","","8","2","400","615","10","24","410","639","1"
"10","2018","31","Hotel","12","35","18","174","187","1377","205","1551","1"
"10","2018","31","Hotel","16","27","29","29","53","55","82","84","2.5"
"10","2018","31","Otros","16","27","441","928","16","57","457","985","2"
"10","2018","31","Hotel","8","34","403","666","36","55","439","721","1"
"10","2018","31","Otros","8","3","294","1024","0","0","294","1024","1"
"10","2018","31","Hotel","7","27","261","424","119","162","380","586","1"
"10","2018","31","Hotel","4","39","96","175","0","0","96","175","1"
"10","2018","31","Hotel","15","16","278","576","19","40","297","616","4"
"10","2018","31","Hotel","4","39","14","27","0","0","14","27","1"
"10","2018","31","Hotel","4","39","216","394","22","67","238","461","1"
"10","2018","31","Hotel","15","16","163","656","58","116","221","772","4"
"10","2018","31","Hotel","14","31","105","259","313","1074","418","1333","17.4"
"10","2018","31","Hotel","8","34","536","926","18","28","554","954","1"
"10","2018","31","Hotel","6","28","274","378","26","31","300","409","1"
"10","2018","31","Hotel","7","17","821","1216","65","110","886","1326","4"
"10","2018","31","Otros","7","27","21","21","0","0","21","21","1"
"10","2018","31","Hotel","11","36","1493","1619","33","51","1526","1670","1"
"10","2018","31","Otros","4","21","330","622","123","224","453","846","1"
"10","2018","31","Otros","15","16","96","112","36","39","132","151","2"
"10","2018","31","Otros","7","17","280","620","0","0","280","620","3"
"10","2018","31","Hotel","7","38","72","93","1","1","73","94","1"
"10","2018","31","Hotel","16","27","808","1738","35","93","843","1831","2.5"
"10","2018","31","Hotel","2","6","94","115","13","13","107","128","2.2"
"10","2018","31","Hotel","11","36","330","487","65","102","395","589","1"
"10","2018","31","Hotel","6","28","20","20","0","0","20","20","1"
"10","2018","31","Hotel","6","12","123","260","0","0","123","260","5"
"10","2018","31","Otros","9","22","111","180","0","0","111","180","1"
"10","2018","31","","13","14","137","183","1","1","138","184","2"
"10","2018","31","Hotel","2","29","204","398","558","823","762","1221","1"
"10","2018","31","Hotel","2","29","44","83","150","398","194","481","1"
"10","2018","31","Otros","4","13","412","439","20","20","432","459","1"
"10","2018","31","Hotel","15","16","64","200","42","104","106","304","4"
"10","2018","31","Hotel","2","1","171","426","7","38","178","464","6.4"
"10","2018","31","Otros","7","27","67","119","0","0","67","119","1"
"10","2018","31","Otros","13","33","47","49","0","0","47","49","5.125"
"10","2018","31","","4","21","482","564","8","14","490","578","1"
"10","2018","31","Hotel","1","10","358","358","4","4","362","362","1"
"10","2018","31","Hotel","11","36","183","509","9","30","192","539","1"
"10","2018","31","Otros","14","31","1068","1068","0","0","1068","1068","2.8"
"10","2018","31","Hotel","7","27","275","433","5","35","280","468","1"
"10","2018","31","Otros","1","10","22","682","0","0","22","682","3.851851852"
"10","2018","31","Hotel","4","39","7","9","16","18","23","27","2.6"
"10","2018","31","Otros","8","2","40","77","38","83","78","160","6.428571429"
"10","2018","31","Otros","11","36","53","127","6","14","59","141","5.19047619"
"10","2018","31","Hotel","13","33","185","185","20","20","205","205","1"
"10","2018","31","","3","4","80","115","47","65","127","180","1"
"10","2018","31","Hotel","7","17","289","664","36","112","325","776","4"
"10","2018","31","Hotel","8","2","155","174","12","16","167","190","1"
"10","2018","31","Otros","15","16","166","219","13","13","179","232","2"
"10","2018","31","Hotel","10","11","299","420","7","17","306","437","1"
"10","2018","31","Hotel","16","19","266","313","0","0","266","313","1"
"10","2018","31","Hotel","10","23","201","263","49","59","250","322","4"
"10","2018","31","","7","38","276","448","70","105","346","553","1"
"10","2018","31","Hotel","7","27","509","816","17","31","526","847","1"
"10","2018","31","Hotel","11","36","93","334","8","36","101","370","1"
"10","2018","31","Hotel","16","40","166","252","10","18","176","270","16.33333333"
"10","2018","31","Hotel","16","19","89","113","3","3","92","116","1"
"10","2018","9","Hotel","16","19","0","0","0","0","0","0","1"
"10","2018","0","Hotel","16","20","0","0","0","0","0","0","1"
"10","2018","31","Hotel","10","11","239","356","23","27","262","383","1"
"10","2018","31","Otros","7","27","65","135","0","0","65","135","4.833333333"
"10","2018","31","Otros","7","27","68","91","0","0","68","91","1"
"10","2018","31","Hotel","7","27","45","49","0","0","45","49","4.166666667"
"10","2018","31","Otros","13","14","42","56","0","0","42","56","1"
"10","2018","31","Otros","11","15","61","61","0","0","61","61","2.357142857"
"10","2018","31","Otros","10","27","31","62","1","4","32","66","4.84"
"10","2018","31","Otros","14","31","954","954","1922","1922","2876","2876","2.8"
"10","2018","31","Otros","11","36","9","16","0","0","9","16","5.19047619"
"10","2018","31","Hotel","16","19","74","96","4","6","78","102","1"
"10","2018","31","","14","27","498","580","0","0","498","580","2.666666667"
"10","2018","31","Hotel","16","40","144","168","4","4","148","172","5.666666667"
"10","2018","31","Hotel","10","27","10","40","0","0","10","40","2.25"
"10","2018","31","Otros","2","29","93","186","282","647","375","833","3.28"
"10","2018","31","Hotel","13","27","10","20","11","17","21","37","1"
"10","2018","31","Otros","9","22","35","41","0","0","35","41","1"
"10","2018","31","Hotel","2","27","116","171","23","23","139","194","1"
"10","2018","31","Hotel","8","34","554","1070","27","48","581","1118","1"
"10","2018","31","Hotel","7","27","439","652","1","2","440","654","1"
"10","2018","31","Hotel","15","16","339","790","14","35","353","825","4"
"10","2018","31","Hotel","16","20","25","46","3","3","28","49","1"
"10","2018","31","Otros","4","13","101","424","0","0","101","424","1"
"10","2018","31","Hotel","2","1","207","546","2","4","209","550","6.4"
"10","2018","31","Otros","11","32","13","35","0","0","13","35","2.285714286"
"10","2018","31","Hotel","2","29","20","108","98","1045","118","1153","1"
"10","2018","31","Hotel","16","27","195","200","80","95","275","295","2.5"
"10","2018","31","Hotel","10","18","127","918","76","232","203","1150","3.2"
"10","2018","31","Otros","11","36","318","441","0","0","318","441","1"
"10","2018","31","Otros","13","14","67","108","0","0","67","108","1"
"10","2018","0","Hotel","7","27","0","0","0","0","0","0","1"
"10","2018","31","Otros","7","17","63","119","0","0","63","119","3"
"10","2018","31","Otros","14","31","316","566","106","283","422","849","2.8"
"10","2018","31","Hotel","2","29","469","1308","74","236","543","1544","1"
"10","2018","31","Hotel","8","3","35","64","47","94","82","158","1"
"10","2018","31","Hotel","8","34","378","492","48","80","426","572","2.571428571"
"10","2018","31","Hotel","8","34","179","206","37","73","216","279","2.571428571"
"10","2018","31","Hotel","12","35","341","525","101","146","442","671","1"
"10","2018","31","Hotel","11","32","64","145","12","29","76","174","1"
"10","2018","31","Hotel","13","33","138","240","4","5","142","245","2"
"10","2018","31","Hotel","10","23","206","282","38","59","244","341","2.8"
"10","2018","31","Hotel","12","35","218","833","30","38","248","871","1"
"10","2018","31","","16","40","333","465","17","23","350","488","3.055555556"
"10","2018","31","Otros","16","19","14","27","0","0","14","27","1.333333333"
"10","2018","0","Otros","16","20","0","0","0","0","0","0","1"
"10","2018","31","Hotel","6","12","176","347","8","14","184","361","5"
"10","2018","31","Hotel","16","19","169","201","0","0","169","201","4"
"10","2018","31","Hotel","12","24","224","333","171","203","395","536","1"
"10","2018","31","Hotel","12","24","183","325","133","203","316","528","3"
"10","2018","31","Hotel","8","3","70","630","0","0","70","630","1"
"10","2018","31","Hotel","5","9","10","20","0","0","10","20","1"
"10","2018","31","Hotel","16","27","387","647","2","8","389","655","2.5"
"10","2018","31","Otros","10","23","50","50","0","0","50","50","7"
"10","2018","31","Otros","13","14","51","64","0","0","51","64","7.384615385"
"10","2018","31","Otros","2","6","31","78","6","10","37","88","1"
"10","2018","5","Hotel","15","16","0","0","4","4","4","4","7.8"
"10","2018","31","Hotel","8","3","121","308","0","0","121","308","1"
"10","2018","31","Hotel","8","34","577","731","30","38","607","769","1"
"10","2018","31","Hotel","8","3","38","72","19","41","57","113","1"
"10","2018","31","","2","29","79","183","66","266","145","449","1"
"10","2018","31","Hotel","2","1","494","710","28","36","522","746","6.4"
"10","2018","31","Hotel","7","17","82","312","0","0","82","312","4"
"10","2018","31","Otros","7","17","256","646","0","0","256","646","3"
"10","2018","31","Hotel","16","40","252","402","50","83","302","485","5.666666667"
"10","2018","31","Hotel","12","24","203","481","144","176","347","657","1"
"10","2018","31","Hotel","14","31","182","416","172","768","354","1184","17.4"
"10","2018","0","Hotel","9","26","0","0","0","0","0","0","1"
"10","2018","31","Hotel","6","12","33","34","0","0","33","34","5"
"10","2018","31","Otros","5","9","24","24","1","1","25","25","4.045454545"
"10","2018","31","Otros","5","9","5","5","0","0","5","5","4.045454545"
"10","2018","31","Otros","15","27","55","57","0","0","55","57","1.422222222"
"10","2018","31","Hotel","8","34","8","8","2","2","10","10","2.571428571"
"10","2018","31","Hotel","10","18","348","656","120","240","468","896","7.75"
"10","2018","31","Hotel","15","16","377","715","32","62","409","777","7.8"
"10","2018","31","Hotel","2","29","87","255","391","1240","478","1495","1"
"10","2018","31","Hotel","4","39","80","144","9","53","89","197","2.6"
"10","2018","31","Otros","4","39","83","103","1","1","84","104","2.222222222"
"10","2018","31","Hotel","4","13","159","216","17","82","176","298","5.4"
"10","2018","31","Otros","10","23","37","37","1","1","38","38","7"
"10","2018","31","Otros","14","31","125","180","433","898","558","1078","20.2"
"10","2018","31","Hotel","3","4","44","62","2","2","46","64","2.6"
"10","2018","31","Hotel","10","23","84","96","10","17","94","113","4"
"10","2018","31","Otros","9","22","396","1581","0","0","396","1581","1"
"10","2018","31","Hotel","12","24","190","466","138","286","328","752","3"
"10","2018","16","Hotel","13","14","10","16","0","0","10","16","1"
"10","2018","31","Hotel","12","35","93","142","43","73","136","215","1.727272727"
"10","2018","31","Hotel","6","28","301","498","0","0","301","498","1"
"10","2018","31","","6","28","42","376","0","0","42","376","1"
"10","2018","31","Hotel","12","24","190","469","46","62","236","531","3"
"10","2018","31","Otros","5","9","6","9","2","2","8","11","4.045454545"
"10","2018","31","Hotel","16","20","37","44","0","0","37","44","1"
"10","2018","31","Hotel","4","21","206","292","42","50","248","342","3"
"10","2018","31","Otros","10","11","27","51","11","16","38","67","11.76470588"
"10","2018","31","Otros","13","14","26","54","0","0","26","54","7.384615385"
"10","2018","31","Otros","16","27","25","39","0","0","25","39","13.81818182"
"10","2018","30","Hotel","9","26","270","546","0","0","270","546","1"
"10","2018","31","Hotel","16","27","605","631","287","300","892","931","2.5"
"10","2018","31","Hotel","3","4","904","1499","142","232","1046","1731","3"
"10","2018","31","Otros","16","27","47","94","0","0","47","94","2"
"10","2018","31","Otros","16","19","624","989","0","0","624","989","1.333333333"
"10","2018","31","Hotel","6","12","519","731","3","5","522","736","5"
"10","2018","31","Hotel","2","1","259","409","12","13","271","422","6.4"
"10","2018","31","Hotel","10","11","421","727","30","85","451","812","1"
"10","2018","31","Otros","10","23","56","56","0","0","56","56","1"
"10","2018","31","Otros","10","27","393","439","18","23","411","462","4.84"
"10","2018","31","Hotel","16","27","161","204","7","13","168","217","2.5"
"10","2018","31","Hotel","6","28","112","122","2","2","114","124","1"
"10","2018","31","Hotel","4","13","36","46","0","0","36","46","5.4"
"10","2018","31","Hotel","14","27","543","665","19","37","562","702","8.5"
"10","2018","31","Hotel","10","27","191","272","79","121","270","393","1"
"10","2018","31","Hotel","13","27","289","358","74","114","363","472","4.2"
"10","2018","31","Hotel","3","4","729","955","21","62","750","1017","3"
"10","2018","31","Otros","4","13","76","325","0","0","76","325","3.4"
"10","2018","31","Otros","11","15","1","1","0","0","1","1","2.357142857"
"10","2018","31","Otros","1","10","135","286","0","0","135","286","3.851851852"
"10","2018","31","Otros","2","1","39","54","11","16","50","70","1"
"10","2018","31","","6","12","52","118","0","0","52","118","1"
"10","2018","31","Otros","10","23","298","785","12","56","310","841","1"
"10","2018","31","Hotel","16","19","164","197","0","0","164","197","4"
"10","2018","31","Hotel","10","11","47","282","0","0","47","282","5.666666667"
"10","2018","31","Hotel","10","23","66","76","5","7","71","83","4"
"10","2018","31","Otros","14","31","16","47","128","313","144","360","2.8"
"10","2018","31","Otros","13","27","2","2","0","0","2","2","12.2"
"10","2018","31","Hotel","2","1","185","722","0","0","185","722","6.4"
"10","2018","10","Hotel","16","19","30","54","0","0","30","54","4"
"10","2018","31","Otros","12","35","36","61","4","4","40","65","3.5"
"10","2018","31","Otros","15","16","106","299","44","88","150","387","2"
"10","2018","31","Otros","9","22","211","422","6","12","217","434","1"
"10","2018","31","Hotel","10","27","375","634","76","102","451","736","1"
"10","2018","31","Hotel","2","27","73","89","6","10","79","99","3.6"
"10","2018","31","Hotel","16","20","37","78","1","1","38","79","1"
"10","2018","31","Hotel","10","18","131","231","87","154","218","385","7.75"
"10","2018","31","Hotel","6","12","251","251","0","0","251","251","5"
"10","2018","31","Hotel","2","27","61","203","2","32","63","235","3.6"
"10","2018","31","Hotel","15","16","213","401","0","0","213","401","7.8"
"10","2018","31","Hotel","10","23","51","51","0","0","51","51","4"
"10","2018","31","Hotel","11","32","9","13","4","4","13","17","1"
"10","2018","31","Hotel","14","27","115","305","52","118","167","423","8.5"
"10","2018","31","Otros","10","11","17","38","5","14","22","52","11.76470588"
"10","2018","31","Hotel","2","27","76","107","7","10","83","117","3.6"
"10","2018","31","Otros","13","14","111","214","6","12","117","226","7.384615385"
"10","2018","31","Hotel","2","1","202","238","9","16","211","254","6.4"
"10","2018","31","Otros","7","17","275","673","0","0","275","673","17.16666667"
"10","2018","31","Otros","10","23","32","136","0","0","32","136","7"
"10","2018","31","Hotel","13","27","141","141","0","0","141","141","2.75"
"10","2018","31","Otros","10","18","22","226","4","6","26","232","10.25"
"10","2018","31","Otros","5","9","15","25","0","0","15","25","4.045454545"
"10","2018","31","Hotel","4","39","151","275","0","0","151","275","2.6"
"10","2018","31","Otros","16","27","98","201","14","32","112","233","13.81818182"
"10","2018","31","Hotel","14","27","23","28","38","78","61","106","8.5"
"10","2018","31","Hotel","10","11","280","500","34","69","314","569","5.666666667"
"10","2018","31","Hotel","10","18","117","220","135","226","252","446","7.75"
"10","2018","31","Otros","14","31","148","191","125","226","273","417","20.2"
"10","2018","31","Otros","11","32","6","8","0","0","6","8","2.285714286"
"10","2018","31","Otros","5","5","92","170","0","0","92","170","3.65625"
"10","2018","31","Otros","1","25","24","71","0","0","24","71","2.384615385"
"10","2018","31","Hotel","3","4","52","129","17","18","69","147","2.6"
"10","2018","31","Otros","7","27","99","160","1","2","100","162","4.833333333"
"10","2018","31","Otros","2","29","33","62","178","299","211","361","3.28"
"10","2018","31","Hotel","2","29","60","150","254","883","314","1033","1"
"10","2018","31","Otros","4","21","156","424","18","44","174","468","1"
"10","2018","31","Hotel","7","27","266","334","5","5","271","339","4.166666667"
"10","2018","31","Otros","5","5","6","50","2","2","8","52","3.65625"
"10","2018","31","Otros","11","36","40","67","9","14","49","81","5.19047619"
"10","2018","31","Hotel","7","27","341","341","0","0","341","341","4.166666667"
"10","2018","0","Hotel","16","20","0","0","0","0","0","0","1"
"10","2018","31","Hotel","12","24","305","388","41","75","346","463","3"
"10","2018","31","Hotel","9","26","202","471","11","18","213","489","1.5"
"10","2018","31","Hotel","7","17","438","902","0","0","438","902","10"
"10","2018","31","Hotel","9","37","273","417","31","88","304","505","3.4"
"10","2018","31","Hotel","5","5","327","594","15","25","342","619","2.142857143"
"10","2018","31","Otros","6","27","135","270","2","8","137","278","3.960088692"
"10","2018","31","Hotel","9","37","46","83","12","44","58","127","3.4"
"10","2018","31","Otros","10","27","53","53","36","36","89","89","4.84"
"10","2018","31","Otros","8","3","20","68","0","0","20","68","10"
"10","2018","31","Otros","16","20","33","35","0","0","33","35","3.076923077"
"10","2018","31","Otros","9","22","4","6","0","0","4","6","7.642857143"
"10","2018","31","Otros","10","27","245","311","35","35","280","346","4.84"
"10","2018","31","Otros","10","23","28","36","1","1","29","37","7"
"10","2018","31","Otros","2","6","408","408","78","78","486","486","1"
"10","2018","31","Otros","4","39","8","11","0","0","8","11","2.222222222"
"10","2018","31","Hotel","2","27","28","34","8","9","36","43","1"
"10","2018","31","Hotel","14","31","60","174","80","565","140","739","24"
"10","2018","31","Otros","2","29","122","289","90","195","212","484","3.28"
"10","2018","31","Otros","8","3","352","1760","0","0","352","1760","10"
"10","2018","31","","13","14","35","41","8","8","43","49","1"
"10","2018","31","Hotel","1","10","162","279","7","7","169","286","6.6"
"10","2018","31","Hotel","8","34","78","106","16","23","94","129","2.571428571"
"10","2018","31","Hotel","9","22","266","1019","0","0","266","1019","2.555555556"
"10","2018","31","Hotel","2","6","144","424","26","26","170","450","2.2"
"10","2018","31","Hotel","10","27","131","243","34","62","165","305","2.25"
"10","2018","31","Otros","14","27","101","101","0","0","101","101","11.83333333"
"10","2018","31","Otros","6","12","343","555","6","49","349","604","1.825657895"
"10","2018","31","Hotel","6","27","216","312","0","0","216","312","3"
"10","2018","31","Hotel","5","5","29","66","12","25","41","91","2.142857143"
"10","2018","31","Hotel","5","5","95","124","1","2","96","126","2.142857143"
"10","2018","31","Hotel","13","27","238","238","0","0","238","238","4.2"
"10","2018","31","Hotel","2","27","180","438","0","0","180","438","3.6"
"10","2018","31","Hotel","8","3","255","255","25","25","280","280","4.111111111"
"10","2018","31","Otros","11","36","62","65","0","0","62","65","5.19047619"
"10","2018","31","Otros","9","30","176","363","0","0","176","363","2.333333333"
"10","2018","31","Otros","16","19","17","17","0","0","17","17","10.26315789"
"10","2018","31","Hotel","14","31","144","272","339","665","483","937","17.4"
"10","2018","31","Hotel","2","1","238","296","8","12","246","308","6.4"
"10","2018","31","Hotel","16","40","865","1509","344","427","1209","1936","5.666666667"
"10","2018","31","Otros","7","17","201","449","12","12","213","461","17.16666667"
"10","2018","31","Hotel","13","27","309","383","87","131","396","514","2.75"
"10","2018","31","Hotel","14","31","192","243","295","676","487","919","24"
"10","2018","31","Otros","3","4","22","99","3","11","25","110","12.2"
"10","2018","31","Otros","8","34","200","272","30","44","230","316","5.75"
"10","2018","31","Hotel","9","22","110","152","1","1","111","153","2.555555556"
"10","2018","31","Hotel","4","21","42","77","2","2","44","79","3"
"10","2018","31","Hotel","6","27","101","149","0","0","101","149","3"
"10","2018","31","Hotel","12","35","118","205","189","319","307","524","1.727272727"
"10","2018","31","Hotel","2","29","35","91","153","311","188","402","2"
"10","2018","31","Otros","10","11","135","214","1","1","136","215","11.76470588"
"10","2018","31","Hotel","1","10","21","74","0","0","21","74","6.6"
"10","2018","31","Hotel","13","14","37","38","3","3","40","41","2"
"10","2018","9","Otros","16","27","95","108","0","0","95","108","13.81818182"
"10","2018","31","Otros","6","27","26","33","0","0","26","33","3.960088692"
"10","2018","31","Hotel","16","40","333","664","156","334","489","998","5.666666667"
"10","2018","31","Otros","1","10","37","59","0","0","37","59","3.851851852"
"10","2018","31","Otros","10","23","30","57","16","26","46","83","7"
"10","2018","31","Hotel","6","28","249","300","6","6","255","306","1"
"10","2018","31","Otros","7","38","152","272","14","20","166","292","2.75"
"10","2018","31","Hotel","6","12","203","309","0","0","203","309","5"
"10","2018","31","Hotel","13","27","190","333","7","56","197","389","4.2"
"10","2018","31","Otros","4","21","14","38","0","0","14","38","4.833333333"
"10","2018","31","Hotel","16","27","75","174","0","0","75","174","5.857142857"
"10","2018","31","Hotel","5","5","291","454","24","46","315","500","2.142857143"
"10","2018","31","Otros","12","24","50","96","29","50","79","146","9.2"
"10","2018","31","Otros","15","16","59","94","27","61","86","155","9"
"10","2018","31","Hotel","8","27","147","147","1","1","148","148","4.5"
"10","2018","31","Hotel","9","22","6","13","0","0","6","13","2.555555556"
"10","2018","31","Hotel","10","11","96","160","28","45","124","205","5.666666667"
"10","2018","31","Hotel","8","3","29","43","8","20","37","63","4.111111111"
"10","2018","31","Hotel","1","10","347","516","0","0","347","516","6.6"
"10","2018","31","Otros","9","26","73","214","1","1","74","215","3.888888889"
"10","2018","31","Hotel","4","39","141","246","12","24","153","270","2.6"
"10","2018","31","Otros","6","27","27","73","0","0","27","73","3.960088692"
"10","2018","31","Otros","6","12","164","228","0","0","164","228","1.825657895"
"10","2018","31","Hotel","6","27","97","191","1","3","98","194","3"
"10","2018","31","Otros","5","9","45","57","14","19","59","76","4.045454545"
"10","2018","31","Hotel","2","27","95","95","16","16","111","111","3.6"
"10","2018","31","Hotel","2","29","107","321","180","534","287","855","1"
"10","2018","31","Hotel","4","13","166","350","3","3","169","353","5.4"
"10","2018","31","","11","15","47","78","0","0","47","78","1"
"10","2018","31","Hotel","1","10","479","540","20","24","499","564","6.6"
"10","2018","31","Otros","6","12","42","74","0","0","42","74","1.825657895"
"10","2018","31","Otros","10","18","53","53","0","0","53","53","10.25"
"10","2018","31","Otros","9","22","186","285","0","0","186","285","7.642857143"
"10","2018","31","","14","27","340","369","95","113","435","482","1"
"10","2018","31","Hotel","16","27","93","270","6","12","99","282","5.857142857"
"10","2018","31","Otros","2","29","33","70","31","79","64","149","3.28"
"10","2018","31","Otros","13","33","34","50","0","0","34","50","5.125"
"10","2018","31","Otros","13","33","0","0","5","5","5","5","5.125"
"10","2018","31","Otros","1","10","111","552","0","0","111","552","3.851851852"
"10","2018","31","Hotel","10","18","58","97","34","51","92","148","7.75"
"10","2018","31","Hotel","14","31","86","139","70","255","156","394","24"
"10","2018","31","Hotel","4","21","80","80","7","7","87","87","3"
"10","2018","31","Hotel","3","4","102","368","0","0","102","368","2.6"
"10","2018","31","Otros","8","27","7","7","0","0","7","7","1"
"10","2018","31","Otros","6","27","34","88","0","0","34","88","3.960088692"
"10","2018","31","Hotel","1","25","185","719","0","0","185","719","1"
"10","2018","31","Otros","6","12","175","477","7","7","182","484","1.825657895"
"10","2018","31","Hotel","6","27","43","122","0","0","43","122","3"
"10","2018","31","Otros","6","27","280","440","0","0","280","440","3.960088692"
"10","2018","31","Otros","1","10","57","108","0","0","57","108","3.851851852"
"10","2018","31","Otros","6","12","78","150","0","0","78","150","1.825657895"
"10","2018","31","Otros","5","5","29","50","2","3","31","53","3.65625"
"10","2018","31","Hotel","12","24","98","595","5","14","103","609","3"
"10","2018","31","Hotel","15","16","82","150","0","0","82","150","7.8"
"10","2018","31","Otros","4","13","66","133","0","0","66","133","3.4"
"10","2018","31","Hotel","2","29","282","859","75","240","357","1099","1"
"10","2018","31","Hotel","4","21","7","15","0","0","7","15","3"
"10","2018","31","Hotel","10","27","200","329","154","207","354","536","2.25"
"10","2018","31","Hotel","8","3","325","404","34","47","359","451","4.111111111"
"10","2018","31","Hotel","12","27","86","138","30","40","116","178","1"
"10","2018","31","Otros","5","5","95","189","15","36","110","225","3.65625"
"10","2018","31","Otros","13","14","16","19","0","0","16","19","7.384615385"
"10","2018","31","Otros","10","11","248","446","0","0","248","446","11.76470588"
"10","2018","31","Otros","16","40","371","526","7","10","378","536","28.14285714"
"10","2018","31","Hotel","11","36","261","496","0","0","261","496","1"
"10","2018","31","Otros","8","34","46","58","14","23","60","81","5.75"
"10","2018","31","Hotel","7","17","80","112","1","3","81","115","10"
"10","2018","31","Otros","12","35","160","309","2","2","162","311","3.5"
"10","2018","31","Otros","5","9","38","79","17","30","55","109","4.045454545"
"10","2018","31","Hotel","9","22","59","79","0","0","59","79","2.555555556"
"10","2018","31","Otros","2","29","33","51","30","59","63","110","3.28"
"10","2018","31","Otros","2","29","93","283","76","211","169","494","3.28"
"10","2018","31","Hotel","10","27","121","191","51","67","172","258","2.25"
"10","2018","31","Hotel","16","19","56","124","10","17","66","141","4"
"10","2018","31","Hotel","16","40","114","372","0","0","114","372","16.33333333"
"10","2018","31","Hotel","8","27","211","325","19","36","230","361","4.5"
"10","2018","31","Otros","13","14","6","12","0","0","6","12","7.384615385"
"10","2018","31","Hotel","7","27","63","85","0","0","63","85","4.166666667"
"10","2018","31","Otros","2","6","59","742","0","0","59","742","5"
"10","2018","31","Hotel","7","17","309","643","9","54","318","697","10"
"10","2018","31","Hotel","3","4","114","248","46","68","160","316","2.6"
"10","2018","31","Otros","6","12","12","108","0","0","12","108","1.825657895"
"10","2018","31","Otros","1","10","6","6","0","0","6","6","3.851851852"
"10","2018","31","Hotel","16","40","92","122","33","74","125","196","16.33333333"
"10","2018","31","Otros","4","39","34","68","0","0","34","68","2.222222222"
"10","2018","31","Otros","13","14","7","12","0","0","7","12","7.384615385"
"10","2018","31","Otros","7","38","97","123","11","18","108","141","2.75"
"10","2018","31","Hotel","11","32","174","310","15","21","189","331","1"
"10","2018","31","Otros","11","36","103","222","5","10","108","232","5.19047619"
"10","2018","31","Hotel","4","21","39","55","6","8","45","63","3"
"10","2018","31","Otros","3","4","4","10","2","2","6","12","12.2"
"10","2018","31","Otros","5","9","93","117","17","17","110","134","4.045454545"
"10","2018","31","Hotel","8","27","88","111","8","15","96","126","4.5"
"10","2018","31","","7","17","89","200","0","0","89","200","1"
"10","2018","31","Otros","16","20","119","141","0","0","119","141","3.076923077"
"10","2018","31","Otros","4","21","36","172","3","16","39","188","4.833333333"
"10","2018","31","Otros","13","33","49","63","7","14","56","77","5.125"
"10","2018","31","","12","35","44","61","929","1421","973","1482","1"
"10","2018","31","Hotel","13","33","13","13","0","0","13","13","2"
"10","2018","31","Otros","4","39","5","8","0","0","5","8","2.222222222"
"10","2018","31","Otros","10","18","27","80","4","12","31","92","10.25"
"10","2018","31","Otros","6","27","103","137","2","8","105","145","3.960088692"
"10","2018","31","Hotel","4","39","64","196","0","0","64","196","2.6"
"10","2018","31","Otros","14","31","240","411","107","326","347","737","20.2"
"10","2018","31","Hotel","2","29","106","241","220","479","326","720","2"
"10","2018","31","Hotel","9","26","176","337","63","175","239","512","1.5"
"10","2018","31","Otros","12","35","2","3","0","0","2","3","3.5"
"10","2018","31","Hotel","14","27","84","104","12","21","96","125","8.5"
"10","2018","31","Otros","11","36","10","18","0","0","10","18","5.19047619"
"10","2018","31","Otros","16","20","161","354","7","19","168","373","3.076923077"
"10","2018","31","Otros","4","39","1","5","0","0","1","5","2.222222222"
"10","2018","31","Otros","7","27","89","93","3","3","92","96","4.833333333"
"10","2018","31","Otros","6","27","85","117","0","0","85","117","3.960088692"
"10","2018","31","Otros","5","8","7","217","5","5","12","222","5"
"10","2018","31","Otros","9","37","204","314","8","20","212","334","4.5"
"10","2018","31","Hotel","2","6","62","233","0","0","62","233","5.5"
"10","2018","31","Hotel","10","27","137","148","26","46","163","194","2.25"
"10","2018","31","Hotel","9","30","200","400","40","96","240","496","1"
"10","2018","31","Otros","4","13","1","1","0","0","1","1","3.4"
"10","2018","31","Hotel","5","5","289","289","8","8","297","297","1"
"10","2018","31","Otros","7","38","201","356","2","2","203","358","2.75"
"10","2018","31","Hotel","13","14","11","19","0","0","11","19","1"
"10","2018","31","Otros","5","9","37","81","0","0","37","81","4.045454545"
"10","2018","31","Otros","5","8","7","14","0","0","7","14","5"
"10","2018","31","Otros","10","27","16","496","0","0","16","496","4.84"
"10","2018","31","Hotel","13","14","11","23","2","2","13","25","1"
"10","2018","31","Otros","11","15","4","10","0","0","4","10","2.357142857"
"10","2018","31","Hotel","9","22","216","442","0","0","216","442","2.555555556"
"10","2018","31","Otros","11","36","231","356","18","22","249","378","5.19047619"
"10","2018","31","Hotel","10","18","624","1229","1248","2626","1872","3855","1"
"10","2018","31","Hotel","6","12","195","349","0","0","195","349","5"
"10","2018","31","","2","29","447","1007","845","1942","1292","2949","1"
"10","2018","31","Hotel","16","27","866","2598","178","534","1044","3132","1"
"10","2018","31","","14","31","311","836","201","1024","512","1860","1"
"10","2018","31","Hotel","8","3","10","28","0","0","10","28","4.111111111"
"10","2018","31","Otros","13","33","18","21","0","0","18","21","5.125"
"10","2018","31","","14","27","330","471","16","22","346","493","2.666666667"
"10","2018","31","Otros","9","22","94","500","0","0","94","500","7.642857143"
"10","2018","31","Hotel","10","11","17","25","4","8","21","33","5.666666667"
"10","2018","31","Otros","6","12","13","13","1","1","14","14","1.825657895"
"10","2018","31","Hotel","8","3","86","127","9","9","95","136","4.111111111"
"10","2018","31","Otros","6","12","120","200","0","0","120","200","1.825657895"
"10","2018","31","Hotel","8","27","37","38","0","0","37","38","4.5"
"10","2018","31","Hotel","6","28","217","268","0","0","217","268","2.4"
"10","2018","31","Otros","1","25","26","108","0","0","26","108","2.384615385"
"10","2018","31","Otros","1","25","6","6","0","0","6","6","2.384615385"
"10","2018","31","Hotel","11","36","1006","2043","0","0","1006","2043","1"
"10","2018","31","Otros","2","6","28","102","139","353","167","455","5"
"10","2018","31","Hotel","14","31","120","259","60","186","180","445","24"
"10","2018","31","Otros","4","21","17","22","0","0","17","22","4.833333333"
"10","2018","31","Otros","7","38","23","33","0","0","23","33","2.75"
"10","2018","31","Otros","13","14","33","33","0","0","33","33","7.384615385"
"10","2018","31","Otros","2","29","45","130","54","86","99","216","3.28"
"10","2018","31","Otros","3","4","76","76","16","16","92","92","12.2"
"10","2018","31","Hotel","3","4","408","800","20","33","428","833","3"
"10","2018","31","Otros","7","27","51","778","0","0","51","778","1"
"10","2018","31","Otros","7","17","151","158","0","0","151","158","3"
"10","2018","27","Hotel","12","27","277","436","37","37","314","473","1"
"10","2018","31","Otros","5","5","32","54","6","6","38","60","3.65625"
"10","2018","31","Hotel","1","10","322","470","0","0","322","470","6.6"
"10","2018","31","Otros","10","18","2","2","0","0","2","2","10.25"
"10","2018","31","Otros","8","27","36","53","0","0","36","53","9.4"
"10","2018","31","Otros","8","3","8","17","2","2","10","19","10"
"10","2018","31","Hotel","16","27","99","153","1","1","100","154","5.857142857"
"10","2018","31","Otros","1","10","39","96","0","0","39","96","3.851851852"
"10","2018","31","Hotel","2","6","38","52","7","7","45","59","5.5"
"10","2018","31","Hotel","8","3","4","7","0","0","4","7","4.111111111"
"10","2018","31","Otros","10","11","35","76","1","2","36","78","11.76470588"
"10","2018","31","Otros","6","27","30","270","0","0","30","270","3.960088692"
"10","2018","31","Otros","15","16","1","2","0","0","1","2","9"
"10","2018","31","Otros","5","5","5","5","14","18","19","23","3.65625"
"10","2018","31","Otros","10","27","143","265","11","18","154","283","4.84"
"10","2018","31","Hotel","7","38","75","111","14","14","89","125","1"
"10","2018","31","Hotel","13","27","6","111","0","0","6","111","4.2"
"10","2018","31","Hotel","16","20","141","236","0","0","141","236","1"
"10","2018","31","Otros","10","27","59","73","16","18","75","91","4.84"
"10","2018","31","Hotel","3","7","121","163","49","73","170","236","1"
"10","2018","31","Otros","2","29","94","165","18","40","112","205","3.28"
"10","2018","31","Otros","10","18","2","2","0","0","2","2","10.25"
"10","2018","31","Otros","9","22","178","344","0","0","178","344","7.642857143"
"10","2018","31","Otros","15","27","56","56","0","0","56","56","1.422222222"
"10","2018","31","Otros","11","36","7","9","0","0","7","9","5.19047619"
"10","2018","31","Otros","5","5","3","4","0","0","3","4","3.65625"
"10","2018","31","Otros","2","29","13","39","12","33","25","72","3.28"
"10","2018","31","Hotel","9","22","143","143","4","4","147","147","2.555555556"
"10","2018","31","Otros","11","32","2","15","0","0","2","15","2.285714286"
"10","2018","31","Hotel","10","27","378","605","49","58","427","663","1"
"10","2018","31","Otros","16","27","143","227","0","0","143","227","2"
"10","2018","31","Hotel","16","20","27","64","0","0","27","64","1"
"10","2018","31","Otros","11","15","24","58","2","4","26","62","2.357142857"
"10","2018","31","Otros","7","17","96","436","0","0","96","436","3"
"10","2018","31","Otros","5","8","28","32","6","8","34","40","5"
"10","2018","30","Hotel","13","33","79","118","0","0","79","118","2"
"10","2018","31","Otros","5","9","28","61","5","10","33","71","4.045454545"
"10","2018","31","Otros","10","27","75","117","8","9","83","126","4.84"
"10","2018","31","Otros","9","22","35","75","0","0","35","75","7.642857143"
"10","2018","31","Otros","16","40","55","132","6","10","61","142","28.14285714"
"10","2018","31","Hotel","16","40","82","82","4","8","86","90","1"
"10","2018","31","Otros","15","16","23","59","0","0","23","59","9"
"10","2018","31","Hotel","8","2","31","38","3","4","34","42","3"
"10","2018","31","Otros","8","3","79","95","3","6","82","101","10"
"10","2018","31","Otros","7","17","35","80","0","0","35","80","17.16666667"
"10","2018","31","Otros","16","20","59","87","0","0","59","87","3.076923077"
"10","2018","31","Otros","6","27","29","35","0","0","29","35","3.960088692"
"10","2018","31","Otros","12","35","112","204","160","254","272","458","3.5"
"10","2018","31","Otros","6","28","113","445","7","12","120","457","4.65"
"10","2018","31","Otros","6","28","381","1206","5","10","386","1216","4.65"
"10","2018","31","Hotel","8","34","185","468","36","70","221","538","2.571428571"
"10","2018","31","Hotel","16","20","1938","2395","10","23","1948","2418","1"
"10","2018","31","Hotel","2","6","54","82","4","10","58","92","2.2"
"10","2018","31","Hotel","7","27","50","775","0","0","50","775","4.166666667"
"10","2018","31","Hotel","10","23","15","30","0","0","15","30","4"
"10","2018","31","Hotel","9","26","82","125","2","4","84","129","1.5"
"10","2018","31","Otros","8","27","23","23","0","0","23","23","9.4"
"10","2018","31","Otros","10","27","40","40","4","4","44","44","4.84"
"10","2018","31","Otros","11","15","16","41","1","1","17","42","2.357142857"
"10","2018","31","Otros","16","20","12","17","0","0","12","17","3.076923077"
"10","2018","31","Otros","11","32","87","219","0","0","87","219","1"
"10","2018","31","Otros","16","27","84","84","0","0","84","84","13.81818182"
"10","2018","31","Otros","9","37","59","59","0","0","59","59","4.5"
"10","2018","31","Hotel","2","29","31","58","48","172","79","230","2"
"10","2018","31","Hotel","2","1","86","981","0","0","86","981","6.4"
"10","2018","31","Otros","5","8","1","1","0","0","1","1","5"
"10","2018","31","Otros","9","37","47","60","19","31","66","91","4.5"
"10","2018","31","Otros","7","38","172","366","0","0","172","366","2.75"
"10","2018","31","Otros","11","32","48","58","2","2","50","60","1"
"10","2018","31","Otros","4","39","69","81","4","4","73","85","2.222222222"
"10","2018","31","Hotel","11","36","87","148","8","16","95","164","2.375"
"10","2018","31","Otros","10","23","76","146","0","0","76","146","7"
"10","2018","31","Hotel","15","16","1090","1842","18","40","1108","1882","2"
"10","2018","31","Otros","2","29","59","113","73","94","132","207","3.28"
"10","2018","31","Hotel","6","12","1336","1989","46","69","1382","2058","1"
"10","2018","31","Hotel","11","15","147","322","0","0","147","322","1"
"10","2018","31","Otros","4","21","140","214","0","0","140","214","1"
"10","2018","31","Otros","16","19","67","157","0","0","67","157","10.26315789"
"10","2018","31","","9","37","461","757","12","28","473","785","1"
"10","2018","31","Otros","10","27","53","121","28","50","81","171","4.84"
"10","2018","31","Otros","11","15","37","37","19","185","56","222","2.357142857"
"10","2018","31","Hotel","2","29","66","192","119","384","185","576","2"
"10","2018","31","Hotel","10","27","219","346","53","116","272","462","1"
"10","2018","31","Hotel","11","36","111","535","0","0","111","535","2.375"
"10","2018","31","Hotel","9","37","65","77","16","23","81","100","3.4"
"10","2018","30","Otros","14","27","2","6","4","6","6","12","11.83333333"
"10","2018","31","Otros","7","38","72","169","0","0","72","169","1"
"10","2018","31","Hotel","2","1","8","19","0","0","8","19","6.4"
"10","2018","31","Otros","2","29","38","87","64","165","102","252","3.28"
"10","2018","31","Hotel","6","27","1","1","0","0","1","1","3"
"10","2018","31","Otros","5","9","27","108","1","1","28","109","4.045454545"
"10","2018","31","Hotel","2","1","17","36","0","0","17","36","6.4"
"10","2018","31","Hotel","3","7","25","66","67","101","92","167","1"
"10","2018","31","Otros","7","38","26","35","18","18","44","53","2.75"
"10","2018","31","Otros","7","17","17","48","2","2","19","50","17.16666667"
"10","2018","31","Otros","7","38","17","30","2","6","19","36","2.75"
"10","2018","31","Otros","4","21","4","4","0","0","4","4","4.833333333"
"10","2018","31","Otros","2","1","51","51","2","2","53","53","5.5"
"10","2018","31","Otros","12","35","49","77","26","60","75","137","3.5"
"10","2018","31","Otros","12","35","30","45","60","62","90","107","3.5"
"10","2018","31","Otros","4","21","127","160","8","12","135","172","4.833333333"
"10","2018","31","Otros","12","24","3","5","4","5","7","10","9.2"
"10","2018","31","Otros","16","19","3","3","0","0","3","3","10.26315789"
"10","2018","31","Otros","10","11","176","271","3","3","179","274","11.76470588"
"10","2018","31","Otros","16","19","40","62","0","0","40","62","10.26315789"
"10","2018","31","Hotel","2","27","45","120","1","1","46","121","1"
"10","2018","31","Otros","6","28","21","44","0","0","21","44","4.65"
"10","2018","31","Otros","10","18","184","606","46","148","230","754","10.25"
"10","2018","31","Otros","14","27","71","139","0","0","71","139","11.83333333"
"10","2018","31","Hotel","11","32","45","64","2","2","47","66","1"
"10","2018","31","Otros","8","27","4","40","0","0","4","40","9.4"
"10","2018","31","Hotel","12","35","70","141","10","17","80","158","1.727272727"
"10","2018","31","Otros","13","14","14","28","0","0","14","28","7.384615385"
"10","2018","31","Otros","11","36","18","53","0","0","18","53","5.19047619"
"10","2018","31","Otros","16","20","12","18","0","0","12","18","3.076923077"
"10","2018","31","Hotel","14","31","188","289","1330","1973","1518","2262","7.8"
"10","2018","31","Otros","2","27","108","185","7","13","115","198","3.2"
"10","2018","31","","16","40","299","553","0","0","299","553","3.055555556"
"10","2018","31","Hotel","11","36","103","148","0","0","103","148","2.375"
"10","2018","31","Hotel","9","22","22","28","0","0","22","28","2.555555556"
"10","2018","31","Otros","2","29","20","42","15","27","35","69","3.28"
"10","2018","31","Hotel","10","27","81","112","28","33","109","145","2.25"
"10","2018","31","Otros","10","27","21","61","0","0","21","61","4.84"
"10","2018","31","Hotel","16","19","4","6","0","0","4","6","4"
"10","2018","26","Otros","2","6","6","35","0","0","6","35","5"
"10","2018","31","Otros","7","27","105","153","0","0","105","153","4.833333333"
"10","2018","31","Hotel","2","6","104","806","0","0","104","806","5.5"
"10","2018","31","Hotel","6","28","5","5","0","0","5","5","2.4"
"10","2018","31","Otros","1","10","91","382","0","0","91","382","3.851851852"
"10","2018","31","Hotel","6","27","32","37","1","1","33","38","3"
"10","2018","31","Otros","5","5","30","48","1","2","31","50","3.65625"
"10","2018","31","Otros","12","24","54","193","7","8","61","201","9.2"
"10","2018","31","Hotel","8","2","59","109","5","8","64","117","3"
"10","2018","31","Hotel","11","32","25","60","3","6","28","66","1"
"10","2018","31","Otros","10","18","27","54","9","27","36","81","10.25"
"10","2018","31","Hotel","9","37","16","30","0","0","16","30","3.4"
"10","2018","31","Otros","5","9","115","209","37","54","152","263","4.045454545"
"10","2018","31","Otros","12","24","25","45","14","20","39","65","9.2"
"10","2018","31","Otros","9","22","15","18","0","0","15","18","7.642857143"
"10","2018","31","Otros","2","29","26","60","24","59","50","119","3.28"
"10","2018","31","Otros","10","23","7","131","1","30","8","161","7"
"10","2018","31","Otros","10","27","40","42","0","0","40","42","4.84"
"10","2018","31","Otros","10","11","231","231","0","0","231","231","11.76470588"
"10","2018","4","Otros","8","3","6","8","0","0","6","8","10"
"10","2018","31","Otros","14","31","172","308","296","476","468","784","20.2"
"10","2018","31","Otros","2","29","226","508","220","590","446","1098","3.28"
"10","2018","0","Otros","1","25","0","0","0","0","0","0","1"
"10","2018","31","Hotel","15","16","31","59","0","0","31","59","7.8"
"10","2018","31","Hotel","15","27","61","95","51","73","112","168","1"
"10","2018","31","Otros","10","27","20","162","7","14","27","176","4.84"
"10","2018","31","Otros","10","23","31","31","0","0","31","31","7"
"10","2018","31","Otros","6","27","28","64","0","0","28","64","3.960088692"
"10","2018","31","Otros","16","40","131","198","1","2","132","200","28.14285714"
"10","2018","31","Otros","11","36","113","154","0","0","113","154","5.19047619"
"10","2018","31","Otros","8","34","32","38","0","0","32","38","5.75"
"10","2018","31","Otros","6","12","47","210","0","0","47","210","1.825657895"
"10","2018","31","Otros","1","10","23","23","0","0","23","23","3.851851852"
"10","2018","31","Hotel","4","21","150","251","0","0","150","251","3"
"10","2018","31","Hotel","11","36","113","241","6","22","119","263","2.375"
"10","2018","31","Otros","5","8","89","119","29","31","118","150","5"
"10","2018","31","Hotel","7","17","87","158","0","0","87","158","10"
"10","2018","27","Hotel","11","36","309","401","6","6","315","407","1"
"10","2018","31","Otros","9","30","19","57","1","1","20","58","2.333333333"
"10","2018","31","Hotel","12","35","38","52","60","116","98","168","1.727272727"
"10","2018","31","Otros","2","1","107","294","28","60","135","354","5.5"
"10","2018","31","Hotel","1","25","100","109","1","1","101","110","1"
"10","2018","31","Otros","5","5","4","124","0","0","4","124","3.65625"
"10","2018","31","Otros","2","29","23","54","86","246","109","300","3.28"
"10","2018","31","Hotel","2","6","15","15","13","20","28","35","5.5"
"10","2018","31","Otros","7","17","16","86","2","4","18","90","17.16666667"
"10","2018","31","Hotel","8","2","1","1","0","0","1","1","3"
"10","2018","31","Hotel","13","14","14","14","0","0","14","14","1"
"10","2018","31","Otros","7","38","43","99","0","0","43","99","2.75"
"10","2018","31","Hotel","14","31","7","10","136","346","143","356","24"
"10","2018","31","Hotel","5","5","57","79","17","19","74","98","2.142857143"
"10","2018","31","Otros","2","27","2","2","5","6","7","8","3.2"
"10","2018","31","Otros","5","8","12","12","14","14","26","26","5"
"10","2018","31","Otros","3","4","28","72","0","0","28","72","12.2"
"10","2018","31","Otros","13","14","3","3","0","0","3","3","7.384615385"
"10","2018","31","Otros","9","37","38","171","0","0","38","171","4.5"
"10","2018","31","Hotel","10","23","780","992","31","46","811","1038","1"
"10","2018","31","Otros","11","32","4","4","2","2","6","6","2.285714286"
"10","2018","31","Otros","11","15","5","8","0","0","5","8","2.357142857"
"10","2018","31","Otros","8","3","2","28","4","4","6","32","10"
"10","2018","31","Otros","16","20","35","91","0","0","35","91","3.076923077"
"10","2018","31","Otros","8","3","23","82","0","0","23","82","10"
"10","2018","31","Otros","16","27","41","83","0","0","41","83","2"
"10","2018","31","Hotel","16","19","22","24","0","0","22","24","4"
"10","2018","31","Hotel","16","27","35","91","0","0","35","91","5.857142857"
"10","2018","31","Otros","9","26","27","95","0","0","27","95","3.888888889"
"10","2018","31","Otros","5","5","8","8","1","1","9","9","3.65625"
"10","2018","31","Otros","14","27","22","26","3","3","25","29","11.83333333"
"10","2018","31","Hotel","5","5","14","84","0","0","14","84","2.142857143"
"10","2018","31","Hotel","12","24","101","397","23","66","124","463","3"
"10","2018","31","Otros","16","27","17","43","0","0","17","43","13.81818182"
"10","2018","31","Otros","8","3","20","51","7","13","27","64","1"
"10","2018","31","Otros","13","27","132","225","0","0","132","225","12.2"
"10","2018","31","Hotel","16","40","38","53","21","38","59","91","16.33333333"
"10","2018","31","Otros","11","36","46","242","0","0","46","242","1"
"10","2018","31","Otros","10","27","43","79","2","2","45","81","4.84"
"10","2018","31","Otros","9","22","14","20","0","0","14","20","7.642857143"
"10","2018","31","Hotel","5","5","43","72","21","30","64","102","2.142857143"
"10","2018","31","Otros","2","29","36","88","92","228","128","316","3.28"
"10","2018","31","Otros","2","29","0","0","9","15","9","15","3.28"
"10","2018","31","Hotel","13","14","6","6","3","3","9","9","1"
"10","2018","31","Otros","1","25","2","5","0","0","2","5","2.384615385"
"10","2018","31","Otros","2","1","18","18","6","6","24","24","5.5"
"10","2018","31","Hotel","12","27","41","50","30","46","71","96","1"
"10","2018","31","Hotel","13","27","10","10","0","0","10","10","4.2"
"10","2018","31","Otros","6","12","133","373","0","0","133","373","1.825657895"
"10","2018","31","Otros","6","27","15","15","3","3","18","18","3.960088692"
"10","2018","31","Otros","1","25","7","11","0","0","7","11","2.384615385"
"10","2018","31","Hotel","6","28","20","60","0","0","20","60","2.583333333"
"10","2018","31","Otros","5","5","1","1","0","0","1","1","3.65625"
"10","2018","31","Otros","5","9","5","5","1","1","6","6","4.045454545"
"10","2018","31","Otros","5","8","10","20","0","0","10","20","5"
"10","2018","31","Hotel","2","29","108","271","117","308","225","579","1"
"10","2018","31","Otros","5","5","111","164","24","47","135","211","3.65625"
"10","2018","31","Hotel","9","26","10","10","1","1","11","11","1.5"
"10","2018","31","Otros","9","30","8","16","0","0","8","16","2.333333333"
"10","2018","31","Otros","11","15","22","44","0","0","22","44","2.357142857"
"10","2018","31","Hotel","16","27","4","4","0","0","4","4","5.857142857"
"10","2018","31","Otros","9","30","41","60","0","0","41","60","2.333333333"
"10","2018","31","Otros","2","29","9","16","8","21","17","37","3.28"
"10","2018","31","Otros","7","38","15","34","8","11","23","45","2.75"
"10","2018","31","Otros","4","21","45","168","4","12","49","180","4.833333333"
"10","2018","31","Otros","9","22","19","31","2","2","21","33","7.642857143"
"10","2018","31","Otros","9","22","79","125","0","0","79","125","7.642857143"
"10","2018","4","Otros","13","27","13","26","0","0","13","26","12.2"
"10","2018","31","Hotel","11","36","1486","1559","67","137","1553","1696","1"
"10","2018","31","Otros","13","33","24","37","0","0","24","37","5.125"
"10","2018","31","Otros","11","36","49","106","24","56","73","162","5.19047619"
"10","2018","31","Otros","12","35","33","64","112","217","145","281","3.5"
"10","2018","31","Otros","12","35","5","8","6","6","11","14","3.5"
"10","2018","31","Otros","10","11","39","108","6","20","45","128","11.76470588"
"10","2018","31","Otros","12","24","17","41","15","26","32","67","9.2"
"10","2018","31","Otros","16","20","48","108","0","0","48","108","3.076923077"
"10","2018","31","Hotel","7","27","176","226","10","22","186","248","1"
"10","2018","31","Otros","6","12","11","13","1","31","12","44","1.825657895"
"10","2018","31","Otros","11","32","53","112","5","12","58","124","2.285714286"
"10","2018","31","Otros","6","28","43","62","4","4","47","66","4.65"
"10","2018","31","Otros","8","34","1","1","0","0","1","1","5.75"
"10","2018","31","Otros","16","27","23","50","0","0","23","50","13.81818182"
"10","2018","31","Otros","10","11","6","7","0","0","6","7","11.76470588"
"10","2018","31","Otros","1","10","2","20","0","0","2","20","3.851851852"
"10","2018","31","Otros","8","3","2","2","0","0","2","2","10"
"10","2018","31","Hotel","16","20","93","155","32","55","125","210","1"
"10","2018","31","Hotel","11","32","29","42","5","9","34","51","1"
"10","2018","31","Otros","8","27","44","153","0","0","44","153","9.4"
"10","2018","31","Otros","12","27","52","151","8","8","60","159","3.428571429"
"10","2018","31","Otros","1","10","32","41","0","0","32","41","3.851851852"
"10","2018","31","Otros","1","10","17","68","0","0","17","68","3.851851852"
"10","2018","31","Otros","5","8","21","38","12","93","33","131","5"
"10","2018","31","Otros","5","8","10","11","9","11","19","22","5"
"10","2018","31","Hotel","9","26","57","65","14","51","71","116","1.5"
"10","2018","31","Hotel","13","14","8","28","2","4","10","32","1"
"10","2018","31","Otros","10","18","36","84","24","46","60","130","10.25"
"10","2018","31","Otros","8","2","32","37","11","15","43","52","6.428571429"
"10","2018","31","Otros","7","27","10","16","2","2","12","18","4.833333333"
"10","2018","31","Otros","2","29","20","64","14","46","34","110","3.28"
"10","2018","31","Otros","11","32","24","38","2","2","26","40","2.285714286"
"10","2018","31","Otros","9","30","24","44","4","4","28","48","2.333333333"
"10","2018","31","Otros","2","29","8","28","8","28","16","56","3.28"
"10","2018","31","Otros","5","5","6","18","0","0","6","18","3.65625"
"10","2018","31","Otros","11","15","25","26","0","0","25","26","2.357142857"
"10","2018","31","Otros","10","23","3","3","0","0","3","3","7"
"10","2018","31","Otros","11","36","107","217","9","13","116","230","5.19047619"
"10","2018","31","Hotel","3","7","54","108","62","110","116","218","1"
"10","2018","31","Otros","10","27","3","3","2","2","5","5","4.84"
"10","2018","31","Otros","2","27","6","6","0","0","6","6","3.2"
"10","2018","31","Otros","12","35","15","42","15","28","30","70","3.5"
"10","2018","31","Otros","10","27","6","6","0","0","6","6","4.84"
"10","2018","31","Otros","16","40","49","105","157","308","206","413","28.14285714"
"10","2018","31","Hotel","8","3","155","278","46","90","201","368","4.111111111"
"10","2018","31","Otros","9","22","77","140","0","0","77","140","7.642857143"
"10","2018","31","Otros","13","14","14","27","0","0","14","27","7.384615385"
"10","2018","31","Otros","5","9","12","20","0","0","12","20","4.045454545"
"10","2018","31","Otros","10","18","43","99","0","0","43","99","10.25"
"10","2018","31","Otros","1","25","265","516","0","0","265","516","2.384615385"
"10","2018","31","Otros","9","22","16","48","0","0","16","48","7.642857143"
"10","2018","31","Otros","10","27","31","221","0","0","31","221","4.84"
"10","2018","31","Otros","16","20","26","43","0","0","26","43","3.076923077"
"10","2018","31","Hotel","7","17","119","207","0","0","119","207","10"
"10","2018","31","Otros","15","27","42","64","0","0","42","64","1.422222222"
"10","2018","31","Otros","12","35","0","0","8","12","8","12","3.5"
"10","2018","31","Otros","12","35","9","13","98","161","107","174","3.5"
"10","2018","31","Otros","3","7","10","10","0","0","10","10","2"
"10","2018","31","Otros","10","11","5","5","1","1","6","6","11.76470588"
"10","2018","31","Otros","12","24","0","0","2","2","2","2","9.2"
"10","2018","31","Otros","10","23","25","51","0","0","25","51","7"
"10","2018","31","Otros","7","27","21","38","0","0","21","38","4.833333333"
"10","2018","31","","10","18","15","19","0","0","15","19","1"
"10","2018","31","Otros","16","27","0","0","2","2","2","2","13.81818182"
"10","2018","31","Hotel","2","29","18","26","19","63","37","89","1"
"10","2018","31","Otros","14","27","22","24","7","14","29","38","11.83333333"
"10","2018","31","Otros","11","32","85","92","0","0","85","92","2.285714286"
"10","2018","31","Otros","16","19","14","32","0","0","14","32","1"
"10","2018","31","Otros","16","27","17","33","0","0","17","33","13.81818182"
"10","2018","31","Otros","8","3","47","104","4","12","51","116","10"
"10","2018","31","Otros","16","27","62","88","0","0","62","88","13.81818182"
"10","2018","31","Otros","16","20","35","55","2","2","37","57","3.076923077"
"10","2018","31","Otros","16","40","20","40","0","0","20","40","28.14285714"
"10","2018","31","Hotel","11","36","47","88","13","33","60","121","2.375"
"10","2018","31","Otros","1","10","40","79","0","0","40","79","3.851851852"
"10","2018","31","Otros","7","38","87","321","10","27","97","348","2.75"
"10","2018","31","Otros","13","14","22","44","0","0","22","44","7.384615385"
"10","2018","31","Otros","9","30","43","53","0","0","43","53","2.333333333"
"10","2018","31","Otros","13","27","28","103","0","0","28","103","12.2"
"10","2018","31","Otros","10","27","80","80","0","0","80","80","4.84"
"10","2018","31","Otros","1","25","31","38","13","16","44","54","2.384615385"
"10","2018","31","Otros","9","26","28","179","0","0","28","179","3.888888889"
"10","2018","31","Otros","10","18","14","33","4","14","18","47","10.25"
"10","2018","31","Otros","2","29","36","78","17","45","53","123","3.28"
"10","2018","31","Otros","1","25","10","25","0","0","10","25","2.384615385"
"10","2018","31","Otros","5","9","18","558","0","0","18","558","4.045454545"
"10","2018","31","Otros","5","9","13","35","2","3","15","38","4.045454545"
"10","2018","31","Hotel","9","37","39","74","4","12","43","86","3.4"
"10","2018","31","Hotel","7","38","75","125","7","9","82","134","1"
"10","2018","31","Otros","7","27","61","79","0","0","61","79","4.833333333"
"10","2018","31","Otros","5","9","16","26","1","1","17","27","4.045454545"
"10","2018","31","Otros","10","27","11","11","6","6","17","17","4.84"
"10","2018","31","Otros","7","27","35","150","0","0","35","150","4.833333333"
"10","2018","31","Otros","16","40","54","73","20","47","74","120","28.14285714"
"10","2018","31","Otros","10","23","28","28","2","2","30","30","7"
"10","2018","31","Otros","15","16","59","131","6","16","65","147","9"
"10","2018","31","Otros","3","7","16","28","67","150","83","178","2"
"10","2018","31","Otros","7","17","20","48","0","0","20","48","17.16666667"
"10","2018","31","Otros","8","27","33","161","1","1","34","162","9.4"
"10","2018","31","Otros","9","22","23","76","0","0","23","76","7.642857143"
"10","2018","31","Otros","16","19","14","18","0","0","14","18","10.26315789"
"10","2018","31","","15","27","1","1","0","0","1","1","1"
"10","2018","31","Hotel","10","11","7","7","3","3","10","10","5.666666667"
"10","2018","31","Otros","2","27","25","153","5","11","30","164","3.2"
"10","2018","31","Otros","8","2","29","50","18","44","47","94","6.428571429"
"10","2018","31","Otros","5","5","5","6","0","0","5","6","3.65625"
"10","2018","31","Otros","12","35","7","12","11","12","18","24","3.5"
"10","2018","31","Otros","8","3","6","6","17","55","23","61","10"
"10","2018","31","Otros","12","24","0","0","23","29","23","29","9.2"
"10","2018","31","Otros","11","32","21","64","0","0","21","64","2.285714286"
"10","2018","31","Otros","10","27","29","48","37","58","66","106","4.84"
"10","2018","31","Otros","11","15","15","60","0","0","15","60","2.357142857"
"10","2018","31","Otros","5","8","16","30","0","0","16","30","5"
"10","2018","31","Otros","14","27","11","11","3","3","14","14","11.83333333"
"10","2018","31","Otros","13","27","155","208","0","0","155","208","12.2"
"10","2018","31","Hotel","10","18","39","39","134","137","173","176","3.2"
"10","2018","31","Otros","10","27","27","30","0","0","27","30","4.84"
"10","2018","31","Otros","11","32","33","40","0","0","33","40","1"
"10","2018","31","Otros","9","37","16","100","0","0","16","100","4.5"
"10","2018","31","Otros","12","35","8","8","30","30","38","38","3.5"
"10","2018","31","Otros","8","34","207","362","39","58","246","420","5.75"
"10","2018","31","Hotel","16","40","2","2","44","81","46","83","16.33333333"
"10","2018","31","Hotel","10","11","196","208","22","49","218","257","5.666666667"
"10","2018","31","Otros","7","27","20","20","0","0","20","20","4.833333333"
"10","2018","31","Hotel","7","38","0","0","0","0","0","0","1"
"10","2018","31","Otros","6","27","23","46","0","0","23","46","3.960088692"
"10","2018","31","Otros","1","10","52","119","0","0","52","119","3.851851852"
"10","2018","31","Otros","1","25","78","125","0","0","78","125","1"
"10","2018","31","Otros","1","25","4","4","0","0","4","4","2.384615385"
"10","2018","31","Otros","6","27","11","171","0","0","11","171","3.960088692"
"10","2018","31","Otros","6","27","70","172","0","0","70","172","3.960088692"
"10","2018","31","Otros","5","5","8","14","2","2","10","16","3.65625"
"10","2018","31","Otros","5","5","19","35","0","0","19","35","3.65625"
"10","2018","31","Otros","3","4","11","341","0","0","11","341","12.2"
"10","2018","31","Otros","10","23","8","28","0","0","8","28","7"
"10","2018","31","Otros","8","3","1","1","0","0","1","1","10"
"10","2018","31","Otros","5","5","4","21","0","0","4","21","3.65625"
"10","2018","31","Otros","5","8","24","37","1","1","25","38","5"
"10","2018","31","Otros","1","10","26","72","0","0","26","72","3.851851852"
"10","2018","31","Otros","16","19","18","48","0","0","18","48","10.26315789"
"10","2018","31","Otros","11","15","48","124","0","0","48","124","2.357142857"
"10","2018","31","Otros","7","38","28","34","0","0","28","34","2.75"
"10","2018","31","Otros","11","32","92","161","24","312","116","473","2.285714286"
"10","2018","31","Otros","8","2","68","186","0","0","68","186","6.428571429"
"10","2018","31","Otros","10","27","27","30","1","2","28","32","4.84"
"10","2018","31","Otros","6","27","7","15","0","0","7","15","3.960088692"
"10","2018","31","Otros","11","32","31","46","10","14","41","60","2.285714286"
"10","2018","31","Otros","8","34","8","10","1","1","9","11","5.75"
"10","2018","31","Otros","11","32","10","10","0","0","10","10","2.285714286"
"10","2018","31","Otros","10","11","7","34","2","6","9","40","11.76470588"
"10","2018","31","Otros","11","32","18","31","1","1","19","32","2.285714286"
"10","2018","31","Otros","14","31","0","0","12","21","12","21","20.2"
"10","2018","31","Hotel","14","31","279","369","1128","2075","1407","2444","17.4"
"10","2018","31","Otros","11","36","120","363","0","0","120","363","5.19047619"
"10","2018","31","Hotel","15","16","1053","2745","217","579","1270","3324","2"
"10","2018","31","Otros","15","27","13","39","1","2","14","41","1.422222222"
"10","2018","31","Otros","5","5","11","13","2","2","13","15","3.65625"
"10","2018","31","Otros","8","34","15","17","2","4","17","21","5.75"
"10","2018","31","Otros","7","27","13","13","0","0","13","13","4.833333333"
"10","2018","31","Otros","12","35","15","21","17","17","32","38","3.5"
"10","2018","31","Otros","5","5","61","137","0","0","61","137","3.65625"
"10","2018","31","Otros","10","11","4","4","0","0","4","4","11.76470588"
"10","2018","31","Otros","10","11","4","4","0","0","4","4","11.76470588"
"10","2018","31","Otros","9","30","12","244","0","0","12","244","2.333333333"
"10","2018","31","Otros","8","2","2","4","0","0","2","4","6.428571429"
"10","2018","31","Otros","10","27","54","148","3","3","57","151","4.84"
"10","2018","31","Otros","5","9","2","2","0","0","2","2","4.045454545"
"10","2018","31","Otros","6","27","2","4","0","0","2","4","3.960088692"
"10","2018","31","Otros","1","10","74","110","15","23","89","133","3.851851852"
"10","2018","31","Otros","1","10","35","64","0","0","35","64","3.851851852"
"10","2018","31","Otros","6","27","36","36","0","0","36","36","3.960088692"
"10","2018","31","Otros","6","12","5","44","0","0","5","44","1.825657895"
"10","2018","31","Otros","1","10","39","70","0","0","39","70","3.851851852"
"10","2018","31","Otros","1","10","17","26","0","0","17","26","3.851851852"
"10","2018","31","Otros","6","27","9","10","0","0","9","10","3.960088692"
"10","2018","31","Otros","6","12","87","96","0","0","87","96","1.825657895"
"10","2018","31","Otros","1","10","2","2","0","0","2","2","3.851851852"
"10","2018","31","Hotel","1","25","40","68","0","0","40","68","1"
"10","2018","2","Otros","6","27","4","4","0","0","4","4","3.960088692"
"10","2018","31","Otros","5","9","13","47","12","22","25","69","4.045454545"
"10","2018","31","Otros","5","5","58","164","5","36","63","200","3.65625"
"10","2018","31","Otros","5","5","36","36","25","25","61","61","3.65625"
"10","2018","31","Otros","5","5","46","89","2","4","48","93","3.65625"
"10","2018","31","Otros","11","36","104","314","4","12","108","326","5.19047619"
"10","2018","0","Hotel","1","10","0","0","0","0","0","0","1"
"10","2018","31","Otros","5","9","16","26","1","1","17","27","4.045454545"
"10","2018","31","Otros","5","8","52","108","36","42","88","150","5"
"10","2018","0","Hotel","15","27","0","0","0","0","0","0","1"
"10","2018","31","Hotel","3","4","242","1584","13","52","255","1636","3"
"10","2018","31","Otros","3","7","39","39","29","29","68","68","1"
"10","2018","31","Otros","7","38","79","97","2","4","81","101","2.75"
"10","2018","31","Hotel","10","27","31","50","21","34","52","84","1"
"10","2018","4","Hotel","12","35","0","0","9","17","9","17","1.727272727"
"10","2018","31","Hotel","10","27","4","15","0","0","4","15","2.25"
"10","2018","31","Hotel","7","17","557","889","65","140","622","1029","4"
"10","2018","31","Hotel","16","19","7","7","0","0","7","7","4"
"10","2018","31","Hotel","2","6","62","582","0","0","62","582","2.2"
"10","2018","31","Otros","5","5","55","213","12","69","67","282","3.65625"
"10","2018","31","Otros","12","24","113","153","54","90","167","243","9.2"
"10","2018","31","Otros","5","8","22","30","4","6","26","36","5"
"10","2018","31","Otros","4","13","150","171","15","15","165","186","1"
"10","2018","31","Otros","10","11","80","80","0","0","80","80","11.76470588"
"10","2018","31","Otros","12","35","107","152","189","285","296","437","3.5"
"10","2018","31","Otros","10","23","88","91","8","8","96","99","7"
"10","2018","31","Otros","11","36","181","271","63","75","244","346","5.19047619"
"10","2018","31","Otros","12","35","10","22","75","85","85","107","3.5"
"10","2018","31","Otros","11","36","26","64","4","12","30","76","5.19047619"
"10","2018","31","Otros","8","2","33","57","0","0","33","57","6.428571429"
"10","2018","31","Otros","9","30","18","38","0","0","18","38","2.333333333"
"10","2018","31","Otros","11","36","8","248","0","0","8","248","5.19047619"
"10","2018","31","Otros","1","10","7","7","0","0","7","7","3.851851852"
"10","2018","31","Otros","10","18","12","24","0","0","12","24","10.25"
"10","2018","31","Otros","7","27","2","20","1","1","3","21","4.833333333"
"10","2018","31","Otros","16","20","25","100","0","0","25","100","1"
"10","2018","31","Otros","9","22","26","44","0","0","26","44","7.642857143"
"10","2018","31","Otros","5","5","211","389","8","20","219","409","3.65625"
"10","2018","31","Otros","12","35","30","45","59","62","89","107","3.5"
"10","2018","31","Otros","10","11","18","20","2","3","20","23","11.76470588"
"10","2018","31","Otros","10","11","7","131","0","0","7","131","11.76470588"
"10","2018","25","Otros","5","9","33","74","7","7","40","81","4.045454545"
"10","2018","31","Otros","5","5","5","100","0","0","5","100","3.65625"
"10","2018","31","Otros","12","35","5","6","10","10","15","16","3.5"
"10","2018","31","Otros","7","38","89","229","22","50","111","279","2.75"
"10","2018","31","Hotel","12","35","12","14","186","268","198","282","1.727272727"
"10","2018","31","Otros","13","14","29","39","0","0","29","39","1"
"10","2018","31","Otros","5","5","7","16","5","10","12","26","3.65625"
"10","2018","31","Hotel","9","26","13","78","0","0","13","78","1.5"
"10","2018","31","Hotel","16","19","13","40","0","0","13","40","1"
"10","2018","31","Otros","16","19","54","58","4","4","58","62","10.26315789"
"10","2018","31","Otros","9","30","36","38","0","0","36","38","2.333333333"
"10","2018","31","Otros","16","19","5","5","0","0","5","5","10.26315789"
"10","2018","31","Otros","16","19","49","145","0","0","49","145","10.26315789"
"10","2018","31","Otros","9","26","32","107","0","0","32","107","3.888888889"
"10","2018","31","Otros","16","40","1","1","0","0","1","1","28.14285714"
"10","2018","31","Hotel","16","27","20","74","0","0","20","74","5.857142857"
"10","2018","31","Otros","16","19","13","18","0","0","13","18","10.26315789"
"10","2018","31","Otros","16","19","59","107","2","4","61","111","10.26315789"
"10","2018","31","","9","30","154","256","0","0","154","256","1"
"10","2018","31","Otros","16","19","6","8","0","0","6","8","10.26315789"
"10","2018","31","Otros","10","11","1","1","0","0","1","1","11.76470588"
"10","2018","31","Otros","11","36","20","20","0","0","20","20","5.19047619"
"10","2018","31","Otros","16","19","16","22","0","0","16","22","10.26315789"
"10","2018","31","Otros","16","19","167","208","0","0","167","208","1.333333333"
"10","2018","31","Otros","16","19","26","48","0","0","26","48","10.26315789"
"10","2018","31","Otros","10","18","32","75","30","70","62","145","10.25"
"10","2018","31","Otros","16","19","23","42","0","0","23","42","10.26315789"
"10","2018","31","Otros","16","19","1","1","0","0","1","1","1.333333333"
"10","2018","31","","9","26","279","2013","0","0","279","2013","1"
"10","2018","31","Otros","16","19","16","22","0","0","16","22","10.26315789"
"10","2018","4","Otros","16","19","6","6","2","2","8","8","10.26315789"
"10","2018","31","Hotel","8","2","642","1274","82","240","724","1514","1"
"10","2018","31","Otros","1","10","8","8","0","0","8","8","3.851851852"
"10","2018","31","Otros","6","12","51","62","0","0","51","62","1.825657895"
"10","2018","31","Hotel","16","19","41","78","5","5","46","83","1"
"10","2018","31","Otros","3","7","30","30","58","58","88","88","2"
"10","2018","31","Hotel","2","6","864","2982","65","402","929","3384","1"
"10","2018","31","Hotel","3","4","356","600","74","148","430","748","2.6"
"10","2018","31","Hotel","16","40","2479","3618","1109","1590","3588","5208","1"
"10","2018","31","Otros","16","27","71","131","0","0","71","131","13.81818182"
"10","2018","31","Hotel","6","28","180","476","18","32","198","508","2.4"
"10","2018","31","Hotel","8","34","1381","2918","103","352","1484","3270","1"
"10","2018","31","Otros","9","30","9","30","0","0","9","30","2.333333333"
"10","2018","31","Hotel","10","18","318","318","336","336","654","654","1"
"10","2018","31","Hotel","9","30","54","416","91","1472","145","1888","1"
"10","2018","31","Hotel","15","27","6","6","0","0","6","6","1"
"10","2018","31","Hotel","9","22","32","128","0","0","32","128","2.555555556"
"10","2018","0","","11","15","0","0","0","0","0","0","1"
"10","2018","31","Otros","6","12","12","15","0","0","12","15","1.825657895"
"10","2018","31","Hotel","15","27","30","910","0","0","30","910","1"
"10","2018","31","Otros","15","27","4","4","0","0","4","4","1.422222222"
"10","2018","31","Otros","15","27","5","5","0","0","5","5","1.422222222"
"10","2018","31","Otros","2","1","17","17","12","12","29","29","1"
"10","2018","31","Otros","12","24","6","9","0","0","6","9","9.2"
"10","2018","31","Otros","5","5","13","33","7","7","20","40","3.65625"
"10","2018","31","Hotel","7","27","260","369","1","1","261","370","1"
"10","2018","31","Otros","16","20","40","52","0","0","40","52","3.076923077"
"10","2018","0","","10","11","0","0","0","0","0","0","1"
"10","2018","31","Hotel","16","40","39","45","2","2","41","47","16.33333333"
"10","2018","31","Otros","12","35","10","11","0","0","10","11","3.5"
"10","2018","31","Hotel","6","27","14","20","0","0","14","20","3"
"10","2018","31","Otros","5","5","6","14","0","0","6","14","3.65625"
"10","2018","31","Hotel","6","27","37","41","0","0","37","41","3"
"10","2018","31","Otros","1","25","22","33","0","0","22","33","2.384615385"
"10","2018","0","Hotel","15","27","0","0","0","0","0","0","1"
"10","2018","31","Otros","5","9","30","35","12","12","42","47","4.045454545"
"10","2018","31","Hotel","15","27","110","200","4","4","114","204","1"
"10","2018","31","Hotel","5","9","32","40","4","4","36","44","1"
"10","2018","31","Hotel","8","34","57","111","7","75","64","186","2.571428571"
"10","2018","0","Hotel","15","27","0","0","0","0","0","0","1"
"10","2018","31","Hotel","6","27","260","560","0","0","260","560","3"
"10","2018","31","Otros","6","27","52","164","0","0","52","164","1"
"10","2018","31","Otros","12","27","1","1","61","61","62","62","3.428571429"
"10","2018","31","Hotel","2","27","569","620","288","300","857","920","1"
"10","2018","31","Hotel","2","6","122","527","0","0","122","527","1"
"10","2018","31","Otros","2","6","46","46","0","0","46","46","1"
"10","2018","31","Hotel","4","39","113","113","0","0","113","113","1"
"10","2018","31","Hotel","1","10","303","371","14","18","317","389","1"
"10","2018","31","Otros","5","8","4","7","10","17","14","24","5"
"10","2018","0","Hotel","13","33","0","0","0","0","0","0","1"
"10","2018","31","Hotel","13","33","144","288","43","86","187","374","1"
"10","2018","31","Otros","11","32","83","171","12","27","95","198","2.285714286"
"10","2018","31","Hotel","9","26","373","1525","171","802","544","2327","1"
"10","2018","31","Hotel","16","20","31","32","1","1","32","33","1"
"10","2018","31","Otros","16","20","16","16","0","0","16","16","3.076923077"
"10","2018","31","","16","40","545","873","0","0","545","873","1"
"10","2018","31","Hotel","15","16","1827","3811","162","310","1989","4121","1"
"10","2018","31","Hotel","5","9","4","8","13","25","17","33","1"
"10","2018","31","Otros","7","38","47","88","0","0","47","88","2.75"
"10","2018","31","Otros","2","6","256","3069","0","0","256","3069","1"
"10","2018","31","Otros","2","6","142","967","0","0","142","967","1"
"10","2018","31","Hotel","15","27","275","1229","15","42","290","1271","1"
"10","2018","31","Otros","7","38","47","79","2","4","49","83","2.75"
"10","2018","31","Otros","2","1","32","32","58","58","90","90","1"
"10","2018","31","Otros","8","3","49","150","2","3","51","153","10"
"10","2018","31","Otros","11","36","7","8","0","0","7","8","5.19047619"
"10","2018","31","Otros","16","20","92","153","0","0","92","153","3.076923077"
"10","2018","31","Otros","8","3","258","324","6","6","264","330","1"
"10","2018","31","Otros","4","39","95","139","4","4","99","143","2.222222222"
"10","2018","31","Otros","5","5","252","333","4","4","256","337","3.65625"
"10","2018","31","Otros","12","27","1","2","27","27","28","29","3.428571429"
"10","2018","31","Otros","7","27","36","484","0","0","36","484","1"
"10","2018","31","Hotel","2","6","341","619","18","30","359","649","1"
"10","2018","31","Hotel","14","27","656","1935","3","5","659","1940","1"
"10","2018","31","Hotel","16","19","506","801","0","0","506","801","1"
"10","2018","31","","2","1","70","70","0","0","70","70","1"
"10","2018","31","Hotel","2","27","59","130","9","16","68","146","1"
"10","2018","31","Otros","16","20","0","0","0","0","0","0","1"
"10","2018","0","Otros","13","14","0","0","0","0","0","0","1"
"10","2018","31","Hotel","11","36","60","81","2","2","62","83","2.375"
"10","2018","31","Otros","13","14","9","31","0","0","9","31","7.384615385"
"10","2018","31","Otros","12","27","9","13","2","2","11","15","3.428571429"
"10","2018","31","Hotel","2","6","354","474","7","9","361","483","2.2"
"10","2018","31","Otros","2","6","630","2769","0","0","630","2769","1"
"10","2018","31","Otros","10","27","6","12","0","0","6","12","4.84"
"10","2018","31","Otros","12","27","18","23","4","4","22","27","3.428571429"
"10","2018","31","Otros","13","14","44","88","0","0","44","88","7.384615385"
"10","2018","31","Otros","6","12","213","362","23","31","236","393","1.825657895"
"10","2018","31","Otros","2","6","127","3810","0","0","127","3810","1"
"10","2018","31","Hotel","12","35","28","47","0","0","28","47","1.727272727"
"10","2018","31","Otros","5","5","44","92","5","5","49","97","3.65625"
"10","2018","31","Otros","9","30","8","176","3","93","11","269","2.333333333"
"10","2018","0","Hotel","8","2","0","0","0","0","0","0","1"
"10","2018","31","Otros","9","30","22","83","0","0","22","83","2.333333333"
"10","2018","31","Hotel","15","27","69","287","0","0","69","287","1"
"10","2018","31","Hotel","3","7","16","16","4","4","20","20","1"
"10","2018","31","Otros","6","12","445","708","0","0","445","708","1.825657895"
"10","2018","31","Otros","12","27","21","44","12","12","33","56","3.428571429"
"10","2018","31","Otros","2","6","27","117","0","0","27","117","5"
"10","2018","31","Otros","6","27","7","21","0","0","7","21","3.960088692"
"10","2018","0","Hotel","10","11","0","0","0","0","0","0","1"
"10","2018","31","Otros","2","1","29","92","0","0","29","92","1"
"10","2018","31","Otros","11","36","17","22","0","0","17","22","5.19047619"
"10","2018","31","Hotel","11","32","0","0","0","0","0","0","1"
"10","2018","31","Otros","2","27","2","40","0","0","2","40","1"
"10","2018","31","Otros","12","27","6","72","0","0","6","72","3.428571429"
"10","2018","31","Hotel","8","2","22","22","0","0","22","22","3"
"10","2018","31","Hotel","16","20","8","8","0","0","8","8","1"
"10","2018","31","Otros","12","35","30","46","0","0","30","46","3.5"
"10","2018","31","Otros","13","14","18","31","0","0","18","31","1"
"10","2018","31","Otros","2","27","10","210","0","0","10","210","3.2"
"10","2018","31","Hotel","6","27","13","13","0","0","13","13","3"
"10","2018","31","Hotel","8","3","14","26","14","26","28","52","4.111111111"
"10","2018","31","Hotel","15","27","43","62","24","40","67","102","1"
"10","2018","31","Otros","8","3","54","156","2","3","56","159","10"
"10","2018","31","Hotel","16","20","7","7","0","0","7","7","1"
"10","2018","31","Hotel","6","28","64","145","4","7","68","152","2.4"
"10","2018","31","Otros","2","1","111","235","7","13","118","248","5.5"
"10","2018","31","Hotel","11","36","101","199","79","124","180","323","2.375"
"10","2018","31","Otros","4","13","28","179","0","0","28","179","1"
"10","2018","31","Otros","2","6","211","1477","0","0","211","1477","1"
"10","2018","31","Otros","8","34","95","122","17","96","112","218","5.75"
"10","2018","31","Hotel","11","15","4","8","0","0","4","8","1"
"10","2018","31","Otros","15","27","3","4","0","0","3","4","1.422222222"
"10","2018","31","Hotel","13","14","94","160","0","0","94","160","1"
"10","2018","31","Hotel","13","14","171","265","35","45","206","310","1"
"10","2018","0","Hotel","9","30","0","0","0","0","0","0","1"
"10","2018","31","Hotel","4","13","306","522","59","80","365","602","5.4"
"10","2018","31","Otros","6","27","14","46","0","0","14","46","3.960088692"
"10","2018","0","Hotel","15","27","0","0","0","0","0","0","1"
"10","2018","31","Hotel","2","29","9","48","62","259","71","307","2"
"10","2018","31","Hotel","13","33","8","13","0","0","8","13","2"
"10","2018","31","Hotel","12","35","21","174","15","59","36","233","1.727272727"
"10","2018","31","Hotel","13","14","352","452","10","22","362","474","1"
"10","2018","31","Otros","1","25","35","61","0","0","35","61","2.384615385"
"10","2018","31","Hotel","8","2","25","49","4","8","29","57","3"
"10","2018","31","Otros","4","39","75","123","0","0","75","123","2.222222222"
"10","2018","31","Otros","6","12","161","224","4","6","165","230","1.825657895"
"10","2018","31","Otros","13","33","46","71","18","40","64","111","5.125"
"10","2018","31","Hotel","4","13","60","123","0","0","60","123","5.4"
"10","2018","31","Hotel","7","27","175","235","10","11","185","246","4.166666667"
"10","2018","31","Hotel","4","13","614","1755","109","1675","723","3430","1"
"10","2018","0","","5","8","0","0","0","0","0","0","1"
"10","2018","31","Otros","8","2","6","6","0","0","6","6","6.428571429"
"10","2018","31","Otros","2","6","16","148","0","0","16","148","1"
"10","2018","31","","1","10","62","82","0","0","62","82","1"
"10","2018","31","Hotel","2","29","12","28","0","0","12","28","2"
"10","2018","31","","14","31","184","359","306","1501","490","1860","1"
"10","2018","31","Hotel","16","27","3663","10991","0","0","3663","10991","1"
"10","2018","31","Hotel","12","35","109","170","135","185","244","355","1.727272727"
"10","2018","31","","12","35","735","980","2386","2563","3121","3543","1"
"10","2018","31","","9","26","145","201","3","3","148","204","1"
"10","2018","31","Otros","11","32","95","166","0","0","95","166","2.285714286"
"10","2018","31","Otros","12","24","37","60","23","33","60","93","9.2"
"10","2018","31","Hotel","1","25","26","33","0","0","26","33","1"
"10","2018","31","Otros","11","32","14","38","0","0","14","38","2.285714286"
"10","2018","31","Hotel","16","19","56","64","3","3","59","67","4"
"10","2018","31","Otros","13","33","16","18","1","1","17","19","5.125"
"10","2018","31","Otros","16","27","50","136","1","6","51","142","13.81818182"
"10","2018","31","Otros","6","12","81","186","5","16","86","202","1.825657895"
"10","2018","31","Otros","2","29","18","58","6","18","24","76","3.28"
"10","2018","31","Hotel","14","27","332","415","63","78","395","493","1"
"10","2018","31","Otros","2","1","80","1120","0","0","80","1120","1"
"10","2018","31","Otros","11","32","33","38","0","0","33","38","2.285714286"
"10","2018","31","Otros","2","27","51","51","8","12","59","63","1"
"10","2018","31","Hotel","2","29","132","276","28","80","160","356","1"
"10","2018","30","Hotel","4","13","58","719","0","0","58","719","3.2"
"10","2018","31","Hotel","4","21","17","36","0","0","17","36","3"
"10","2018","31","Otros","7","27","99","270","1","1","100","271","4.833333333"
"10","2018","31","","3","4","27","62","9","9","36","71","1"
"10","2018","31","Hotel","6","27","8","8","4","4","12","12","3"
"10","2018","31","Otros","16","19","38","45","0","0","38","45","10.26315789"
"10","2018","31","Otros","11","32","1","1","0","0","1","1","2.285714286"
"10","2018","31","Otros","3","7","27","35","21","40","48","75","2"
"10","2018","31","Otros","5","5","24","26","7","10","31","36","3.65625"
"10","2018","24","Otros","15","27","512","824","0","0","512","824","1.422222222"
"10","2018","31","Otros","1","25","41","82","0","0","41","82","2.384615385"
"10","2018","31","","10","27","2","4","0","0","2","4","1"
"10","2018","31","Otros","2","29","28","64","63","112","91","176","3.28"
"10","2018","31","Otros","12","35","0","0","15","26","15","26","3.5"
"10","2018","31","Otros","16","19","68","119","4","4","72","123","10.26315789"
"10","2018","31","Otros","9","26","32","32","3","7","35","39","3.888888889"
"10","2018","31","Hotel","13","33","46","78","0","0","46","78","2"
"10","2018","13","Otros","11","32","5","10","2","4","7","14","2.285714286"
"10","2018","31","Otros","9","22","4","8","0","0","4","8","7.642857143"
"10","2018","31","Otros","6","27","41","146","0","0","41","146","3.960088692"
"10","2018","31","Otros","15","27","13","26","0","0","13","26","1.422222222"
"10","2018","31","Otros","11","32","102","104","1","1","103","105","2.285714286"
"10","2018","31","Otros","11","15","21","27","0","0","21","27","2.357142857"
"10","2018","31","Otros","9","37","12","240","0","0","12","240","4.5"
"10","2018","31","Otros","5","9","17","37","0","0","17","37","4.045454545"
"10","2018","31","Hotel","10","27","14","27","0","0","14","27","2.25"
"10","2018","31","Otros","6","28","16","140","0","0","16","140","4.65"
"10","2018","31","Otros","4","13","23","42","0","0","23","42","3.4"
"10","2018","31","Otros","2","1","35","700","0","0","35","700","1"
"10","2018","31","Otros","2","29","36","50","13","22","49","72","3.28"
"10","2018","31","Hotel","8","3","12","23","2","4","14","27","4.111111111"
"10","2018","31","Otros","16","19","20","37","0","0","20","37","1.333333333"
"10","2018","31","Otros","12","35","49","71","88","125","137","196","3.5"
"10","2018","31","Hotel","12","35","7","24","63","92","70","116","1.727272727"
"10","2018","31","Otros","12","35","58","85","77","117","135","202","3.5"
"10","2018","31","Otros","2","29","66","138","58","108","124","246","3.28"
"10","2018","31","Hotel","7","27","61","73","8","8","69","81","1"
"10","2018","31","Hotel","9","22","36","48","2","2","38","50","2.555555556"
"10","2018","31","Hotel","12","35","39","70","145","250","184","320","1.727272727"
"10","2018","31","Otros","15","16","110","189","10","31","120","220","2"
"10","2018","31","Hotel","15","27","6","6","0","0","6","6","1"
"10","2018","31","Otros","4","13","84","94","11","11","95","105","3.4"
"10","2018","31","Hotel","8","34","94","140","5","5","99","145","2.571428571"
"10","2018","31","Hotel","16","20","50","50","0","0","50","50","1"
"10","2018","31","Hotel","6","28","160","213","57","94","217","307","2.4"
"10","2018","31","Hotel","15","27","130","345","8","10","138","355","1"
"10","2018","31","Otros","12","35","223","507","30","67","253","574","3.5"
"10","2018","31","Otros","11","15","30","90","0","0","30","90","2.357142857"
"10","2018","31","Otros","11","15","18","26","0","0","18","26","2.357142857"
"10","2018","31","Otros","11","36","40","81","34","48","74","129","5.19047619"
"10","2018","31","Hotel","11","36","58","82","2","2","60","84","2.375"
"10","2018","31","Hotel","6","12","109","226","0","0","109","226","5"
"10","2018","31","Otros","8","3","23","52","4","4","27","56","10"
"10","2018","31","Otros","10","27","9","24","2","62","11","86","4.84"
"10","2018","31","Otros","8","3","7","11","1","2","8","13","10"
"10","2018","31","Otros","1","25","3","7","0","0","3","7","2.384615385"
"10","2018","31","Hotel","2","27","102","239","0","0","102","239","1"
"10","2018","31","Hotel","10","18","9","52","81","243","90","295","3.2"
"10","2018","31","Otros","11","32","59","125","13","20","72","145","1"
"10","2018","31","Hotel","1","10","2220","3159","158","330","2378","3489","1"
"10","2018","31","Otros","11","32","45","60","0","0","45","60","2.285714286"
"10","2018","31","Otros","2","27","44","698","0","0","44","698","1"
"10","2018","31","","12","24","81","198","334","811","415","1009","1"
"10","2018","31","Hotel","16","27","643","981","4","4","647","985","5.857142857"
"10","2018","31","Hotel","7","38","19","31","1","1","20","32","1"
"10","2018","31","Hotel","6","12","2610","2610","6","6","2616","2616","1"
